anime_id,watching,completed,on_hold,dropped,plan_to_watch,total,load_date
87,607,30801,297,200,8708,40613,2022-03-11 19:07:53.053047
51,885,34021,783,1374,8965,46028,2022-03-11 19:07:53.238239
22,13342,85223,14078,13707,36020,162370,2022-03-11 19:07:53.410554
715,176,2672,109,119,1838,4914,2022-03-12 17:20:07.944414
718,303,3331,203,266,2567,6670,2022-03-12 17:20:08.148389
719,767,26085,397,687,6615,34551,2022-03-12 17:20:08.313402
731,877,50547,423,334,13116,65297,2022-03-12 17:20:09.673448
743,1668,75747,795,476,28124,106810,2022-03-12 17:20:10.800026
759,4364,151881,1795,741,84694,243475,2022-03-12 17:20:13.04526
767,202,4490,134,116,2860,7802,2022-03-12 17:20:14.2555
780,481,51552,216,251,3422,55922,2022-03-12 17:20:15.501496
789,1487,23369,1513,1835,15582,43786,2022-03-12 17:20:16.617406
796,54,960,28,66,723,1831,2022-03-12 17:20:22.283016
797,181,6893,144,122,1867,9207,2022-03-12 17:20:24.959014
798,518,4804,421,445,6735,12923,2022-03-12 17:20:25.228022
799,239,2289,271,425,2740,5964,2022-03-12 17:20:25.486049
800,1348,11005,1214,1320,16813,31700,2022-03-12 17:20:28.867212
801,7925,123186,5943,2353,68695,208102,2022-03-12 17:20:29.042211
807,494,32546,432,232,9836,43540,2022-03-12 17:20:32.82841
808,215,3528,158,162,2020,6083,2022-03-12 17:20:33.193412
810,143,1249,165,264,1361,3182,2022-03-12 17:20:36.470692
811,736,15470,623,575,7058,24462,2022-03-12 17:20:36.645687
812,1079,12428,1106,1624,12215,28452,2022-03-12 17:20:39.61487
813,41672,924169,23228,27969,53518,1070556,2022-03-12 17:20:39.787999
814,164,11631,94,136,2282,14307,2022-03-12 17:20:40.142999
817,467,4704,400,524,3397,9492,2022-03-12 17:20:51.064571
819,735,30873,335,467,7902,40312,2022-03-12 17:20:55.259402
820,29519,61669,17196,6969,157772,273125,2022-03-12 17:20:55.446406
821,565,25077,272,287,6250,32451,2022-03-12 17:20:55.605402
833,581,6010,511,633,4504,12239,2022-03-12 17:20:56.555679
840,770,9332,609,686,6176,17573,2022-03-12 17:20:57.675681
850,2715,38987,2314,4017,14194,62227,2022-03-12 17:20:58.882758
858,254,1427,231,400,2058,4370,2022-03-12 17:21:03.094535
860,1562,24302,1812,2539,11117,41332,2022-03-12 17:21:10.500525
863,1484,17056,1317,2184,12086,34127,2022-03-12 17:21:11.123523
864,199,7987,142,167,3060,11555,2022-03-12 17:21:11.305523
868,249,13416,212,122,4092,18091,2022-03-12 17:21:11.944851
869,268,13861,214,124,4087,18554,2022-03-12 17:21:14.636992
870,351,14016,207,228,4074,18876,2022-03-12 17:21:18.08033
872,1591,6740,1513,1332,16148,27324,2022-03-12 17:21:18.24833
873,2389,43780,3048,3750,17401,70368,2022-03-12 17:21:18.419333
879,1777,12422,1829,2236,20731,38995,2022-03-12 17:21:19.341329
887,72,3211,41,65,1078,4467,2022-03-12 17:21:20.584082
895,590,93895,331,282,5433,100531,2022-03-12 17:21:21.814083
903,774,108688,364,294,5876,115996,2022-03-12 17:21:23.016699
907,2330,36885,2210,3330,15047,59802,2022-03-12 17:21:24.125855
915,484,9019,487,573,3309,13872,2022-03-12 17:21:25.321606
925,176,2127,156,200,926,3585,2022-03-12 17:21:26.561606
934,43647,410525,36832,34065,198036,723105,2022-03-12 17:21:27.819584
942,920,7315,762,909,7346,17252,2022-03-12 17:21:29.057734
4651,260,964,223,234,1624,3305,2022-03-12 18:37:41.034202
953,2102,38702,1709,1980,22888,67381,2022-03-12 17:21:30.213728
962,3782,32086,2927,1650,30793,71238,2022-03-12 17:21:31.340916
970,257,2457,285,295,2187,5481,2022-03-12 17:21:36.009226
971,856,12168,1177,1785,4319,20305,2022-03-12 17:21:40.920512
973,527,3848,539,834,5419,11167,2022-03-12 17:21:45.27494
974,1498,46728,670,578,33163,82637,2022-03-12 17:21:48.326894
975,1120,15062,501,283,15580,32546,2022-03-12 17:21:48.515918
976,483,9824,240,142,6295,16984,2022-03-12 17:21:48.681919
978,636,6325,410,345,5400,13116,2022-03-12 17:21:49.952405
979,158,12443,93,87,1927,14708,2022-03-12 17:21:50.173534
984,509,38194,305,299,5421,44728,2022-03-12 17:21:50.921152
992,511,10597,463,538,4314,16423,2022-03-12 17:21:52.165567
1000,2142,10799,2051,1231,16043,32266,2022-03-12 17:21:53.51157
1007,661,22546,489,331,5265,29292,2022-03-12 17:21:54.614896
1015,723,55795,495,262,10811,68086,2022-03-12 17:21:55.898506
1019,914,9827,803,1255,8742,21541,2022-03-12 17:21:56.971756
1020,255,5549,182,231,3715,9932,2022-03-12 17:22:00.541351
1022,301,4194,313,367,3638,8813,2022-03-12 17:22:03.500469
1023,1008,43026,727,481,14924,60166,2022-03-12 17:22:07.814879
1024,102,3592,71,83,1448,5296,2022-03-12 17:22:08.148879
1025,1258,8582,1053,1069,16045,28007,2022-03-12 17:22:08.316879
1026,129,1777,72,89,1882,3949,2022-03-12 17:22:08.499877
1031,56,1523,32,69,857,2537,2022-03-12 17:22:11.63249
1032,133,3953,83,71,2725,6965,2022-03-12 17:22:11.84849
1033,3098,85147,1404,580,62190,152419,2022-03-12 17:22:12.018493
1040,296,1122,247,285,2062,4012,2022-03-12 17:22:12.915941
1047,441,21557,172,105,8014,30289,2022-03-12 17:22:14.008942
1056,133,4549,68,84,1477,6311,2022-03-12 17:22:15.242649
1066,496,25577,545,430,6623,33671,2022-03-12 17:22:16.440796
1072,1219,18516,1426,852,13672,35685,2022-03-12 17:22:17.649772
1082,756,5495,660,1022,5634,13567,2022-03-12 17:22:19.03196
1089,947,25448,431,292,14178,41296,2022-03-12 17:22:20.130992
1097,599,4004,357,619,4234,9813,2022-03-12 17:22:28.03615
1098,431,5043,451,766,2797,9488,2022-03-12 17:22:32.190863
1099,56,1116,31,78,780,2061,2022-03-12 17:22:34.183057
1100,176,1462,119,131,2600,4488,2022-03-12 17:22:34.349179
1101,249,11138,168,118,2901,14574,2022-03-12 17:22:34.514695
1102,103,2086,69,132,1265,3655,2022-03-12 17:22:34.688719
1108,631,8466,644,845,5390,15976,2022-03-12 17:22:38.268524
1109,161,6109,132,195,3328,9925,2022-03-12 17:22:41.934413
1111,157,4534,107,125,2194,7117,2022-03-12 17:22:46.414194
1112,155,4637,106,123,2122,7143,2022-03-12 17:22:46.613168
1115,93,2083,46,59,1328,3609,2022-03-12 17:22:46.778172
1121,361,81871,246,248,4039,86765,2022-03-12 17:22:47.67717
1128,317,5792,239,207,2388,8943,2022-03-12 17:22:49.084195
1136,661,4704,770,839,6394,13368,2022-03-12 17:22:50.050682
1144,270,10954,192,113,3464,14993,2022-03-12 17:22:51.306956
1152,356,5674,257,175,3215,9677,2022-03-12 17:22:52.50321
1160,138,1883,68,90,1430,3609,2022-03-12 17:22:53.744215
1168,357,4747,352,210,2807,8473,2022-03-12 17:22:54.950502
1183,202,2117,116,155,1677,4267,2022-03-12 17:23:00.343158
1185,179,2828,161,232,1972,5372,2022-03-12 17:23:07.824041
1186,348,3952,340,507,3283,8430,2022-03-12 17:23:08.02706
1187,193,9119,199,115,2313,11939,2022-03-12 17:23:08.36506
1188,107,1056,75,140,1065,2443,2022-03-12 17:23:08.532151
1193,254,2041,235,325,2113,4968,2022-03-12 17:23:17.210087
1194,857,9667,1028,1335,6314,19201,2022-03-12 17:23:17.409114
1195,22185,560993,12220,20814,120355,736567,2022-03-12 17:23:17.577087
1196,323,3973,290,353,3666,8605,2022-03-12 17:23:17.738088
1206,155,2963,98,84,3666,6966,2022-03-12 17:23:27.199884
1207,134,2279,83,78,2453,5027,2022-03-12 17:23:27.413881
1208,81,1844,47,87,1548,3607,2022-03-12 17:23:27.581882
1215,363,15934,322,257,4580,21456,2022-03-12 17:23:28.496575
1223,85,6662,57,84,1790,8678,2022-03-12 17:23:29.729549
1231,351,9623,415,418,2639,13446,2022-03-12 17:23:30.821309
1237,422,21417,318,220,5793,28170,2022-03-12 17:23:32.177822
1245,264,4524,109,88,3527,8512,2022-03-12 17:23:33.245965
1253,838,37531,576,411,5672,45028,2022-03-12 17:23:34.450962
1261,462,5934,832,1253,3545,12026,2022-03-12 17:23:35.682092
1270,345,8088,133,105,4910,13581,2022-03-12 17:23:36.905789
1283,79,2412,76,87,1162,3816,2022-03-12 17:23:38.114789
1292,8926,224895,5732,6497,80036,326086,2022-03-12 17:23:39.341994
1301,387,8931,220,179,7517,17234,2022-03-12 17:23:40.695549
1314,103,702,83,134,955,1977,2022-03-12 17:23:44.010857
1316,545,10850,305,596,2278,14574,2022-03-12 17:23:47.810068
1324,298,4836,261,371,3986,9752,2022-03-12 17:23:51.652711
1325,243,1932,323,474,2945,5917,2022-03-12 17:23:51.923738
1327,727,7137,652,732,3643,12891,2022-03-12 17:23:52.241715
1343,152,5077,80,120,2135,7564,2022-03-12 17:23:54.258211
1349,449,5129,356,557,4002,10493,2022-03-12 17:23:58.725893
1350,604,6198,263,219,8071,15355,2022-03-12 17:24:01.863363
1351,735,6892,357,459,7466,15909,2022-03-12 17:24:05.236561
1355,41,384,27,39,446,937,2022-03-12 17:24:07.666109
1356,974,15221,758,484,9872,27309,2022-03-12 17:24:08.028109
1357,451,7299,258,235,4842,13085,2022-03-12 17:24:11.290042
1358,308,14360,188,139,4037,19032,2022-03-12 17:24:13.885524
1361,328,63663,166,298,3517,67972,2022-03-12 17:24:14.227524
1363,610,49809,246,288,3852,54805,2022-03-12 17:24:18.009924
1366,459,41407,216,227,3422,45731,2022-03-12 17:24:23.973825
1368,162,11989,129,119,2259,14658,2022-03-12 17:24:29.461752
1369,230,15687,130,139,2285,18471,2022-03-12 17:24:32.001584
1370,70,5586,42,76,1639,7413,2022-03-12 17:24:32.296593
1372,1972,10020,1743,1245,11771,26751,2022-03-12 17:24:37.587918
1373,125,2900,134,124,1836,5119,2022-03-12 17:24:39.853918
1375,608,7345,502,496,5228,14179,2022-03-12 17:24:43.004515
1378,121,3006,72,83,1496,4778,2022-03-12 17:24:58.874637
1379,1062,31032,585,269,18536,51484,2022-03-12 17:25:02.296514
1381,67,2038,54,89,1237,3485,2022-03-12 17:25:05.058306
1382,275,4803,186,215,3276,8755,2022-03-12 17:25:05.34047
1384,635,10022,467,418,7460,19002,2022-03-12 17:25:10.205275
1391,396,2326,269,244,3230,6465,2022-03-12 17:25:13.609637
1392,68,1439,37,74,704,2322,2022-03-12 17:25:16.014195
1393,64,1436,39,74,730,2343,2022-03-12 17:25:16.268194
1394,75,1272,49,66,786,2248,2022-03-12 17:25:19.137733
1395,76,1286,44,73,773,2252,2022-03-12 17:25:21.239239
1397,1375,12980,1348,1282,10356,27341,2022-03-12 17:25:23.973374
1398,300,6873,245,173,4676,12267,2022-03-12 17:25:26.397477
1399,167,5619,152,122,2356,8416,2022-03-12 17:25:28.723868
1409,116,2227,101,129,1369,3942,2022-03-12 17:25:33.257923
1410,264,7123,231,206,2381,10205,2022-03-12 17:25:33.574924
1412,6269,32642,4934,3035,42906,89786,2022-03-12 17:25:38.509873
1413,129,3971,103,93,2415,6711,2022-03-12 17:25:41.232106
1414,105,3485,95,87,2168,5940,2022-03-12 17:25:41.553104
1416,195,6035,142,122,3486,9980,2022-03-12 17:25:44.464702
1417,128,4545,102,95,2431,7301,2022-03-12 17:25:48.518144
1418,178,6022,120,115,3008,9443,2022-03-12 17:25:51.038772
1419,172,6637,127,124,2872,9932,2022-03-12 17:25:51.977895
1420,121,3485,99,87,2034,5826,2022-03-12 17:25:53.70001
1421,104,3626,84,83,2010,5907,2022-03-12 17:25:55.209068
1422,117,3626,95,103,2315,6256,2022-03-12 17:25:57.629768
1423,101,3259,93,88,2036,5577,2022-03-12 17:25:59.102773
1424,112,3474,101,96,2273,6056,2022-03-12 17:26:00.819001
1426,853,7387,672,430,9276,18618,2022-03-12 17:26:03.471459
1427,86,3022,87,94,1906,5195,2022-03-12 17:26:05.223937
1429,103,3075,90,88,2069,5425,2022-03-12 17:26:08.596024
1431,128,3727,96,101,2303,6355,2022-03-12 17:26:13.439365
1432,155,6205,113,111,2945,9529,2022-03-12 17:26:13.798386
1433,138,4809,113,112,2367,7539,2022-03-12 17:26:15.997379
1437,107,4177,103,100,2393,6880,2022-03-12 17:26:22.834061
1439,137,4441,116,104,2551,7349,2022-03-12 17:26:25.903001
1440,91,1637,54,77,960,2819,2022-03-12 17:26:27.711142
1441,408,9111,253,209,10000,19981,2022-03-12 17:26:28.036116
1443,186,2694,109,126,2538,5653,2022-03-12 17:26:28.789115
1445,591,7519,860,1525,2847,13342,2022-03-12 17:26:31.613741
1448,545,6378,673,950,2604,11150,2022-03-12 17:26:35.25465
1450,535,3327,522,505,6644,11533,2022-03-12 17:26:35.594927
1451,108,2585,50,96,1236,4075,2022-03-12 17:26:35.853926
1452,62,1326,22,46,672,2128,2022-03-12 17:26:37.678655
1453,4589,16983,3554,2460,33101,60687,2022-03-12 17:26:37.942653
1454,3138,20682,2421,2410,38155,66806,2022-03-12 17:26:41.009085
1455,143,4091,106,153,1890,6383,2022-03-12 17:26:43.189043
1462,3803,45398,1718,680,47831,99430,2022-03-12 17:26:55.530605
1465,196,2916,152,215,1897,5376,2022-03-12 17:26:55.900609
1470,5535,23177,3664,2340,32053,66769,2022-03-12 17:27:05.451091
1471,1176,12669,664,414,7711,22634,2022-03-12 17:27:08.627019
1473,617,10122,377,314,7159,18589,2022-03-12 17:27:19.450812
1474,180,4647,124,97,2185,7233,2022-03-12 17:27:22.127521
1475,160,4312,121,92,2176,6861,2022-03-12 17:27:24.509657
1477,172,4037,120,93,2692,7114,2022-03-12 17:27:29.142722
1480,110,5125,82,74,1553,6944,2022-03-12 17:27:31.568742
1482,58036,282142,57934,45813,187413,631338,2022-03-12 17:27:37.345633
1483,1398,5041,1058,704,14442,22643,2022-03-12 17:27:40.979758
1484,240,4311,110,150,3136,7947,2022-03-12 17:27:43.35005
1486,4535,26509,5422,3951,17950,58367,2022-03-12 17:27:46.948288
1488,472,6854,329,243,7688,15586,2022-03-12 17:27:53.011981
1489,182,4713,131,81,1760,6867,2022-03-12 17:27:53.316981
1490,546,3380,593,609,5716,10844,2022-03-12 17:27:53.995161
1491,2580,5765,2368,1380,18168,30261,2022-03-12 17:27:58.07912
1494,194,5223,129,124,3345,9015,2022-03-12 17:27:59.59612
1496,212,7761,144,170,2850,11137,2022-03-12 17:28:05.487133
1497,69,2223,52,87,1456,3887,2022-03-12 17:28:07.781133
1500,442,4918,266,317,3628,9571,2022-03-12 17:28:13.073648
1501,97,4696,74,94,1692,6653,2022-03-12 17:28:15.386783
1505,430,39323,214,222,3536,43725,2022-03-12 17:28:20.46029
1506,608,43753,255,283,4339,49238,2022-03-12 17:28:23.070392
1508,411,2404,386,629,4187,8017,2022-03-12 17:28:26.437378
1509,782,15646,759,1156,4565,22908,2022-03-12 17:28:29.143476
1514,169,4349,146,135,1938,6737,2022-03-12 17:28:31.392246
1515,133,1735,78,74,1303,3323,2022-03-12 17:28:33.319332
1516,2530,12606,3017,4147,6096,28396,2022-03-12 17:28:35.760962
1517,536,5490,598,666,5608,12898,2022-03-12 17:28:38.08397
1519,11448,351685,6842,3300,71822,445097,2022-03-12 17:28:41.008244
1520,2776,12488,1740,1296,16506,34806,2022-03-12 17:28:41.340244
1521,175,7987,152,106,2962,11382,2022-03-12 17:28:44.583705
1524,771,4077,812,632,10067,16359,2022-03-12 17:28:46.888901
1525,175,18607,172,181,3137,22272,2022-03-12 17:28:49.557028
1528,68,886,50,76,769,1849,2022-03-12 17:28:56.612452
1529,85,1313,67,104,1134,2703,2022-03-12 17:28:56.906458
1530,7970,158820,7343,6624,70858,251615,2022-03-12 17:29:00.18592
1531,486,24509,389,208,7907,33499,2022-03-12 17:29:00.507125
1532,1681,30180,1379,2327,11212,46779,2022-03-12 17:29:03.302724
1534,567,6203,562,524,3668,11524,2022-03-12 17:29:06.533518
1535,162340,2747152,94958,101345,205405,3311200,2022-03-12 17:29:07.865542
1537,110,728,89,158,852,1937,2022-03-12 17:29:13.77167
1538,1856,19216,1945,2350,13303,38670,2022-03-12 17:29:16.698022
1539,62,1976,45,86,802,2971,2022-03-12 17:29:19.357101
1541,705,4096,459,531,5034,10825,2022-03-12 17:29:24.819402
1542,446,2911,426,626,4582,8991,2022-03-12 17:29:25.123437
1543,1883,19889,1275,1344,13058,37449,2022-03-12 17:29:27.717637
1544,119,2190,89,104,1277,3779,2022-03-12 17:29:29.798763
1546,4539,44848,4047,5126,27315,85875,2022-03-12 17:29:32.433972
1547,30,214,31,140,260,675,2022-03-12 17:29:33.579969
1549,103,1766,89,109,2048,4115,2022-03-12 17:29:36.376203
1550,417,3914,436,662,2526,7955,2022-03-12 17:29:38.932701
1553,242,3023,208,153,2931,6557,2022-03-12 17:29:42.922
1554,730,11969,895,974,8409,22977,2022-03-12 17:29:45.613301
1556,734,8299,467,439,9130,19069,2022-03-12 17:29:50.968678
1559,14537,183640,8766,7518,57951,272412,2022-03-12 17:29:53.978826
1560,173,1740,93,112,1412,3530,2022-03-12 17:29:55.985071
1561,357,3438,345,655,3123,7918,2022-03-12 17:29:58.272692
1562,6802,95375,5730,7262,32128,147297,2022-03-12 17:30:01.236068
1565,3928,101278,3943,6799,8953,124901,2022-03-12 17:30:10.194038
1566,1693,60391,960,407,28541,91992,2022-03-12 17:30:14.171996
1567,877,8913,986,804,6097,17677,2022-03-12 17:30:16.256882
1569,2616,32304,1863,2452,19934,59169,2022-03-12 17:30:22.22959
1570,1485,19923,1255,1968,9531,34162,2022-03-12 17:30:25.239991
1572,285,3308,429,612,2306,6940,2022-03-12 17:30:28.459153
32797,12,37,3,56,55,163,2022-03-12 19:27:21.097692
1575,90250,1459716,52008,38049,298263,1938286,2022-03-12 17:30:34.945187
1576,2461,12920,2716,2313,16543,36953,2022-03-12 17:30:37.798966
1577,887,8933,471,297,10333,20921,2022-03-12 17:30:40.714085
1578,561,4875,353,482,4507,10778,2022-03-12 17:30:43.204864
1579,3492,61974,2912,3956,19993,92327,2022-03-12 17:30:45.917006
1581,1174,17795,903,1369,8863,30104,2022-03-12 17:30:50.892299
1582,100,1535,56,83,942,2716,2022-03-12 17:30:52.873444
1583,961,7466,816,1426,8090,18759,2022-03-12 17:30:53.142451
1584,68,1575,62,54,917,2676,2022-03-12 17:30:55.072976
1585,96,1023,40,101,896,2156,2022-03-12 17:30:57.542898
1588,1700,12666,1428,1631,7886,25311,2022-03-12 17:31:07.02308
1589,4362,27674,4552,4987,38591,80166,2022-03-12 17:31:09.6626
1590,173,1059,142,234,1106,2714,2022-03-12 17:31:11.759016
1591,549,5933,630,795,5141,13048,2022-03-12 17:31:13.714421
1592,1032,8334,890,1132,11720,23108,2022-03-12 17:31:16.298206
1593,270,23125,238,189,5431,29253,2022-03-12 17:31:19.140069
1594,6864,81878,5709,4226,49981,148658,2022-03-12 17:31:21.959486
1596,267,2852,191,368,2642,6320,2022-03-12 17:31:24.444807
1597,252,2208,341,509,1765,5075,2022-03-12 17:31:26.484412
1598,213,4047,162,196,3057,7675,2022-03-12 17:31:28.547117
1599,205,2781,180,226,1883,5275,2022-03-12 17:31:31.034851
1601,2064,11077,2120,2448,24149,41858,2022-03-12 17:31:35.543439
1602,807,11077,579,703,8011,21177,2022-03-12 17:31:36.114416
1603,350,3389,357,449,2697,7242,2022-03-12 17:31:36.704413
1604,49917,255865,39033,38772,128071,511658,2022-03-12 17:31:39.350282
1607,1260,13758,1330,1968,9743,28059,2022-03-12 17:31:42.21897
1608,481,3440,324,404,4158,8807,2022-03-12 17:31:42.49597
1613,44,1865,22,57,589,2577,2022-03-12 17:31:44.684157
1617,132,1219,99,108,1908,3466,2022-03-12 17:31:51.036351
1618,249,1218,247,245,2754,4713,2022-03-12 17:31:53.847139
1619,374,13605,266,185,4597,19027,2022-03-12 17:31:57.302011
1620,107,977,70,110,925,2189,2022-03-12 17:31:59.373016
1621,47,1113,48,52,691,1951,2022-03-12 17:32:00.868015
1622,125,4600,77,130,2364,7296,2022-03-12 17:32:02.860143
1623,218,1838,178,273,1749,4256,2022-03-12 17:32:04.7839
1624,95,1857,83,73,1520,3628,2022-03-12 17:32:06.748522
1625,78,1575,56,66,938,2713,2022-03-12 17:32:08.461905
1628,422,4144,307,459,3821,9153,2022-03-12 17:32:11.993713
1629,1160,6630,835,1082,11746,21453,2022-03-12 17:32:14.341832
1630,82,2234,77,99,1262,3754,2022-03-12 17:32:16.0184
1637,231,8630,115,174,4058,13208,2022-03-12 17:32:18.798418
1638,140,2388,165,217,1151,4061,2022-03-12 17:32:21.29154
1640,366,13767,293,773,4385,19584,2022-03-12 17:32:21.549083
1641,94,1318,45,49,935,2441,2022-03-12 17:32:23.934255
1643,63,906,32,63,624,1688,2022-03-12 17:32:27.50217
1644,76,981,43,62,812,1974,2022-03-12 17:32:27.825173
1645,193,2907,136,139,2308,5683,2022-03-12 17:32:30.029295
1647,352,4748,150,312,4374,9936,2022-03-12 17:32:32.33901
1650,1255,7632,1046,708,13614,24255,2022-03-12 17:32:36.713906
1651,274,3360,205,193,3446,7478,2022-03-12 17:32:39.782531
1655,353,3904,468,530,3000,8255,2022-03-12 17:32:47.846426
1656,21,172,14,81,138,426,2022-03-12 17:32:49.025457
1657,443,6280,459,707,6502,14391,2022-03-12 17:32:51.438335
1658,220,3313,108,74,2992,6707,2022-03-12 17:32:53.542463
1660,271,1675,230,281,2855,5312,2022-03-12 17:32:58.382079
1661,847,4186,935,906,7758,14632,2022-03-12 17:33:00.867624
1662,83,1299,50,55,1329,2816,2022-03-12 17:33:02.546624
1663,336,3952,354,357,4147,9146,2022-03-12 17:33:04.781772
1664,166,1312,122,227,1356,3183,2022-03-12 17:33:06.776787
1665,79,1175,65,113,923,2355,2022-03-12 17:33:09.057914
1667,94,707,75,166,903,1945,2022-03-12 17:33:12.815156
1668,640,38196,650,1298,3147,43931,2022-03-12 17:33:16.080305
1670,111,8166,93,154,1457,9981,2022-03-12 17:33:19.99904
1672,82,1614,91,212,678,2677,2022-03-12 17:33:25.135409
1673,55,963,50,126,523,1717,2022-03-12 17:33:27.084134
1674,500,22553,394,629,2524,26600,2022-03-12 17:33:29.961806
1675,298,6128,286,577,1136,8425,2022-03-12 17:33:33.026781
1676,196,2256,180,236,2077,4945,2022-03-12 17:33:36.018033
1678,1550,13418,2533,2408,9909,29818,2022-03-12 17:33:39.76339
1679,200,7729,172,148,2064,10313,2022-03-12 17:33:42.125108
1681,787,24663,439,292,13861,40042,2022-03-12 17:33:44.836606
1683,379,2659,561,717,2324,6640,2022-03-12 17:33:49.266781
1684,171,1815,154,230,1248,3618,2022-03-12 17:33:51.616015
1685,517,15351,631,2464,2446,21409,2022-03-12 17:33:51.928235
1686,2189,226003,945,606,17298,247041,2022-03-12 17:33:52.166235
1688,814,10677,844,1255,7790,21380,2022-03-12 17:33:54.852965
1689,14747,619220,7357,5642,179696,826662,2022-03-12 17:33:58.382143
1690,7906,54701,6746,6155,94996,170504,2022-03-12 17:34:01.911427
1691,18284,289470,13367,17573,79560,418254,2022-03-12 17:34:06.943935
45547,0,0,0,0,0,0,2022-03-12 20:07:07.536564
45549,0,0,0,0,0,0,2022-03-12 20:07:08.993838
45551,0,0,0,0,0,0,2022-03-12 20:07:10.005778
47582,0,0,0,0,0,0,2022-03-12 20:24:58.449373
1694,1080,7180,1124,1776,10297,21457,2022-03-12 17:34:12.946499
1696,1779,35481,1579,1622,13708,54169,2022-03-12 17:34:16.015161
1699,8314,86194,8592,8680,58681,170461,2022-03-12 17:34:21.73841
1701,177,2372,94,111,1811,4565,2022-03-12 17:34:22.079524
1703,581,2890,368,587,6204,10630,2022-03-12 17:34:26.412789
1704,514,3441,376,499,4791,9621,2022-03-12 17:34:26.702765
1705,73,711,70,154,732,1740,2022-03-12 17:34:31.843888
1706,408,4066,448,431,3987,9340,2022-03-12 17:34:40.662654
1707,619,9978,669,1166,2514,14946,2022-03-12 17:34:53.685533
1709,402,65041,216,198,3829,69686,2022-03-12 17:35:14.682579
1710,1554,23813,1818,2598,5108,34891,2022-03-12 17:35:19.638806
1711,127,1063,102,176,1150,2618,2022-03-12 17:35:21.67812
1712,69,449,63,103,557,1241,2022-03-12 17:35:23.238262
1713,97,613,69,101,860,1740,2022-03-12 17:35:24.713377
1718,167,4421,138,133,2468,7327,2022-03-12 17:35:26.596282
1719,714,47294,536,394,8856,57794,2022-03-12 17:35:29.237658
1720,190,3671,164,126,2351,6502,2022-03-12 17:35:32.97842
1721,793,9123,760,1076,7307,19059,2022-03-12 17:35:35.061681
1723,1923,114129,1660,2315,40017,160044,2022-03-12 17:35:41.139747
1725,218,2577,122,192,2013,5122,2022-03-12 17:35:41.897725
1727,1724,13240,1249,1628,12437,30278,2022-03-12 17:35:49.288593
1731,1856,28586,1483,1205,16619,49749,2022-03-12 17:35:55.56403
1732,307,12090,236,167,4193,16993,2022-03-12 17:35:59.208808
1733,87,2543,45,63,1127,3865,2022-03-12 17:36:02.942992
1735,407063,1262924,125780,139688,110399,2045854,2022-03-12 17:36:03.963987
1736,119,3146,121,118,1070,4574,2022-03-12 17:36:07.911577
1737,122,540,84,125,1102,1973,2022-03-12 17:36:10.496566
1740,86,291,65,134,819,1395,2022-03-12 17:36:14.892443
1741,50,1018,40,56,509,1673,2022-03-12 17:36:16.601612
1742,149,933,102,142,1503,2829,2022-03-12 17:36:18.486615
1744,1042,9045,1574,1735,3768,17164,2022-03-12 17:36:21.770953
1746,295,6577,367,815,2382,10436,2022-03-12 17:36:26.470878
1747,822,8804,643,575,11356,22200,2022-03-12 17:36:28.722933
1748,91,1263,100,105,930,2489,2022-03-12 17:36:31.361246
1749,213,11232,158,185,2245,14033,2022-03-12 17:36:31.727273
1750,298,9989,169,191,2565,13212,2022-03-12 17:36:32.264248
1751,56,5318,54,78,1036,6542,2022-03-12 17:36:34.24184
1752,62,2157,42,72,857,3190,2022-03-12 17:36:36.153109
1753,29,1341,24,51,562,2007,2022-03-12 17:36:37.750732
1754,72,2153,40,78,635,2978,2022-03-12 17:36:39.162326
1755,55,1831,39,68,672,2665,2022-03-12 17:36:40.782547
1756,50,1873,43,66,649,2681,2022-03-12 17:36:42.557522
1757,46,2571,30,67,577,3291,2022-03-12 17:36:43.875624
1758,43,1147,36,59,624,1909,2022-03-12 17:36:44.137623
1759,103,2150,45,54,1288,3640,2022-03-12 17:36:46.922655
1760,416,8609,189,172,6242,15628,2022-03-12 17:36:49.125128
1761,244,5171,128,97,3301,8941,2022-03-12 17:36:51.754144
1762,950,7701,696,843,9513,19703,2022-03-12 17:36:54.373788
1766,93,1351,44,56,1102,2646,2022-03-12 17:37:06.006181
1767,159,2211,70,79,2284,4803,2022-03-12 17:37:08.240296
1768,80,1651,64,77,813,2685,2022-03-12 17:37:10.389879
1771,104,918,60,95,828,2005,2022-03-12 17:37:14.09973
1772,76,906,42,101,782,1907,2022-03-12 17:37:15.685503
1774,49,1482,51,48,781,2411,2022-03-12 17:37:17.866501
1775,340,1544,228,353,3880,6345,2022-03-12 17:37:20.493237
1777,150,2763,72,64,2262,5311,2022-03-12 17:37:24.588333
1778,192,1663,153,201,1492,3701,2022-03-12 17:37:27.671373
1786,114,1079,62,93,902,2250,2022-03-12 17:37:30.043627
1789,59,2333,75,74,1056,3597,2022-03-12 17:37:32.022745
1790,51,1100,45,50,519,1765,2022-03-12 17:37:33.997431
1795,106,2365,67,48,1384,3970,2022-03-12 17:37:43.1399
1797,149,5879,99,91,2785,9003,2022-03-12 17:37:47.109301
1798,80,4257,62,53,1068,5520,2022-03-12 17:37:48.897279
1799,156,7176,96,71,1938,9437,2022-03-12 17:37:51.496082
1802,275,4143,324,337,2900,7979,2022-03-12 17:37:55.946084
1803,119,2778,79,51,1700,4727,2022-03-12 17:37:57.762614
1805,189,2954,147,190,1768,5248,2022-03-12 17:38:02.562818
1807,956,10920,873,1385,7359,21493,2022-03-12 17:38:06.861604
1811,113,1791,82,75,1351,3412,2022-03-12 17:38:11.444546
1812,166,2065,102,404,1541,4278,2022-03-12 17:38:14.197581
1813,573,38117,472,257,8250,47669,2022-03-12 17:38:16.519169
1815,924,42669,757,510,14979,59839,2022-03-12 17:38:16.825169
1817,321,20370,228,164,3830,24913,2022-03-12 17:38:22.133053
1818,25726,360670,21689,22034,175136,605255,2022-03-12 17:38:22.489055
1822,334,2543,252,312,4545,7986,2022-03-12 17:38:27.227103
1823,251,2768,187,213,2281,5700,2022-03-12 17:38:30.477763
1824,899,21052,498,270,20790,43509,2022-03-12 17:38:33.285931
1826,1729,12521,1807,1876,8188,26121,2022-03-12 17:38:34.674821
1827,11310,82396,8643,5380,90308,198037,2022-03-12 17:38:37.183725
1828,59,917,31,71,798,1876,2022-03-12 17:38:39.047578
1829,1260,98592,884,613,24814,126163,2022-03-12 17:38:42.363113
1830,314,10541,400,194,3136,14585,2022-03-12 17:38:42.795089
1832,184,2789,112,130,1934,5149,2022-03-12 17:38:44.206551
1833,56,805,22,56,578,1517,2022-03-12 17:38:46.395699
1835,610,7168,617,682,3005,12082,2022-03-12 17:38:46.681673
1836,1393,32650,1275,2081,14906,52305,2022-03-12 17:38:49.863279
1837,250,2403,216,286,2304,5459,2022-03-12 17:38:50.118795
1838,660,17821,277,518,5088,24364,2022-03-12 17:38:53.825513
1842,1189,53219,564,564,7345,62881,2022-03-12 17:38:59.696042
1844,592,5992,831,800,4633,12848,2022-03-12 17:39:04.426233
1845,251,1638,244,222,2053,4408,2022-03-12 17:39:07.164722
1846,512,4312,459,430,5097,10810,2022-03-12 17:39:07.416719
1848,187,726,153,205,1553,2824,2022-03-12 17:39:11.597261
1849,54,427,43,63,590,1177,2022-03-12 17:39:13.116262
1850,31,326,23,40,379,799,2022-03-12 17:39:14.312852
1851,25,320,21,45,350,761,2022-03-12 17:39:15.447609
1852,3321,29471,3257,3030,32400,71479,2022-03-12 17:39:17.861803
1854,110,2204,100,111,1041,3566,2022-03-12 17:39:20.512519
1855,43,900,29,56,540,1568,2022-03-12 17:39:22.522528
1856,138,4011,144,139,1693,6125,2022-03-12 17:39:24.404096
1857,113,1023,75,79,1552,2842,2022-03-12 17:39:26.58382
1859,284,10886,147,181,3101,14599,2022-03-12 17:39:31.836002
1860,5356,31939,3556,3826,36017,80694,2022-03-12 17:39:40.751726
1861,225,10454,171,157,3417,14424,2022-03-12 17:39:48.092003
1862,495,16752,288,274,7150,24959,2022-03-12 17:39:50.721721
1863,36,83,10,67,354,550,2022-03-12 17:39:52.288131
1864,500,4487,320,369,4405,10081,2022-03-12 17:39:55.193826
1868,397,3468,333,508,2952,7658,2022-03-12 17:40:01.66583
1869,330,12489,286,273,3432,16810,2022-03-12 17:40:04.396633
1872,71,361,68,147,477,1124,2022-03-12 17:40:06.131418
1878,228,2897,216,262,2826,6429,2022-03-12 17:40:10.846638
1879,324,4871,110,89,4243,9637,2022-03-12 17:40:14.258348
1880,121,3443,58,58,1333,5013,2022-03-12 17:40:16.221527
1885,117,515,117,244,878,1871,2022-03-12 17:40:26.821288
1887,35367,330767,35691,41749,147222,590796,2022-03-12 17:40:31.797515
1888,420,17483,297,188,4454,22842,2022-03-12 17:40:36.273625
1890,159,8918,99,86,3145,12407,2022-03-12 17:40:39.379951
1891,90,892,69,131,724,1906,2022-03-12 17:40:41.242207
1892,36,557,25,65,314,997,2022-03-12 17:40:43.831704
1893,127,1226,128,243,881,2605,2022-03-12 17:40:48.805312
1894,462,63055,209,242,4155,68123,2022-03-12 17:40:49.122312
1898,108,1924,60,58,945,3095,2022-03-12 17:40:52.201305
1899,182,1033,148,198,1330,2891,2022-03-12 17:40:55.140355
1900,53,950,45,60,548,1656,2022-03-12 17:40:57.649102
1902,83,4538,92,74,1441,6228,2022-03-12 17:41:03.538547
1903,51,853,35,52,575,1566,2022-03-12 17:41:05.114789
1904,113,1329,74,89,1507,3112,2022-03-12 17:41:07.533057
1905,90,1353,58,88,1041,2630,2022-03-12 17:41:09.415075
1906,176,2450,101,117,2679,5523,2022-03-12 17:41:11.357287
1907,60,901,50,75,914,2000,2022-03-12 17:41:12.565724
1908,150,5545,84,123,2682,8584,2022-03-12 17:41:15.020367
1909,128,2900,55,110,1504,4697,2022-03-12 17:41:17.456456
1910,378,3064,231,140,4712,8525,2022-03-12 17:41:17.737457
1911,369,5046,312,214,6272,12213,2022-03-12 17:41:20.693101
1913,1824,21158,1193,856,14801,39832,2022-03-12 17:41:23.724749
1914,2226,21387,2110,1202,10727,37652,2022-03-12 17:41:26.571832
1915,1891,31589,1869,1584,12981,49914,2022-03-12 17:41:29.754957
1917,292,9407,238,286,3787,14010,2022-03-12 17:41:32.745637
2608,3537,15148,2009,2152,10985,33831,2022-03-12 17:59:38.430894
2611,173,6369,114,144,2503,9303,2022-03-12 17:59:41.03569
2612,72,1085,90,218,342,1807,2022-03-12 17:59:42.768886
2613,73,719,54,104,1066,2016,2022-03-12 17:59:44.602591
2614,44,671,42,87,820,1664,2022-03-12 17:59:46.986964
2615,141,8874,103,106,2022,11246,2022-03-12 17:59:47.241959
1918,197,3959,163,191,2300,6810,2022-03-12 17:41:34.801635
1919,231,2878,189,128,2202,5628,2022-03-12 17:41:37.558875
1920,158,5684,114,100,2761,8817,2022-03-12 17:41:37.918872
1921,380,9149,182,195,5413,15319,2022-03-12 17:41:40.547782
1923,123,3488,100,87,2106,5904,2022-03-12 17:41:44.804243
1924,138,3510,109,103,2290,6150,2022-03-12 17:41:45.190241
1925,150,3156,104,96,2536,6042,2022-03-12 17:41:47.104375
1926,33,1749,26,54,484,2346,2022-03-12 17:41:49.434855
1927,86,1498,40,58,840,2522,2022-03-12 17:41:50.939793
1928,95,1890,59,71,1112,3227,2022-03-12 17:41:51.484794
1929,746,9643,702,658,4029,15778,2022-03-12 17:41:51.791817
1930,122,3799,87,123,1691,5822,2022-03-12 17:41:52.10979
1932,897,7823,886,741,4328,14675,2022-03-12 17:41:54.827095
1935,1102,5021,705,459,9919,17206,2022-03-12 17:41:58.942415
1936,61,549,61,126,744,1541,2022-03-12 17:42:00.434419
1937,55,876,45,51,719,1746,2022-03-12 17:42:02.046422
1939,78,1324,77,150,1037,2666,2022-03-12 17:42:05.500393
1940,233,4026,107,85,2439,6890,2022-03-12 17:42:07.922054
1941,443,3510,402,529,5201,10085,2022-03-12 17:42:09.997694
1942,315,3221,287,340,3669,7832,2022-03-12 17:42:12.380767
1943,7969,288580,3371,1723,144302,445945,2022-03-12 17:42:13.54677
1944,520,7852,306,361,4097,13136,2022-03-12 17:42:15.678015
1946,1518,12830,1788,1452,10497,28085,2022-03-12 17:42:18.57358
1947,120,463,87,140,1057,1867,2022-03-12 17:42:18.829582
1949,53,2405,33,47,655,3193,2022-03-12 17:42:20.981257
1951,883,13425,352,179,12872,27711,2022-03-12 17:42:21.229257
1953,840,33651,920,833,11519,47763,2022-03-12 17:42:27.790808
1954,302,9307,301,247,4128,14285,2022-03-12 17:42:31.99427
1955,53,1326,35,83,755,2252,2022-03-12 17:42:33.641264
1957,147,3658,119,132,1368,5424,2022-03-12 17:42:39.256741
1958,77,5752,48,55,1334,7266,2022-03-12 17:42:41.194249
1959,93,734,49,72,1228,2176,2022-03-12 17:42:42.835678
1961,379,13076,229,256,7230,21170,2022-03-12 17:42:44.118679
1962,100,642,63,121,913,1839,2022-03-12 17:42:45.652236
1964,113,1734,91,106,1531,3575,2022-03-12 17:42:47.44123
1965,3356,54923,3162,3237,30814,95492,2022-03-12 17:42:49.677769
1967,198,7716,154,162,3213,11443,2022-03-12 17:42:53.55185
1968,163,6929,127,149,2864,10232,2022-03-12 17:42:56.308808
1969,149,6735,131,147,2956,10118,2022-03-12 17:42:58.600681
1972,636,4120,620,464,4100,9940,2022-03-12 17:42:58.944683
1973,77,1611,40,73,1390,3191,2022-03-12 17:43:01.512626
1974,1851,13438,1550,1434,16699,34972,2022-03-12 17:43:04.127728
1975,70,303,59,119,720,1271,2022-03-12 17:43:04.485731
1977,67,1477,45,39,1364,2992,2022-03-12 17:43:06.744996
1978,151,5685,87,65,3070,9058,2022-03-12 17:43:09.039145
1980,379,7652,235,204,6257,14727,2022-03-12 17:43:11.806963
1981,174,3074,103,101,3287,6739,2022-03-12 17:43:12.210959
1983,93,2526,84,84,1672,4459,2022-03-12 17:43:13.516616
1984,43,2229,18,64,426,2780,2022-03-12 17:43:15.325097
1985,438,6120,404,571,2473,10006,2022-03-12 17:43:18.021262
1989,34,1953,24,59,376,2446,2022-03-12 17:43:23.77977
1990,34,741,22,41,398,1236,2022-03-12 17:43:25.223597
1991,260,2265,213,331,2200,5269,2022-03-12 17:43:25.482594
1992,84,892,53,79,757,1865,2022-03-12 17:43:27.294719
1993,17,617,22,44,166,866,2022-03-12 17:43:28.616695
1994,184,7028,178,232,3738,11360,2022-03-12 17:43:30.654814
1996,133,6475,108,110,2461,9287,2022-03-12 17:43:33.417184
1998,198,5644,161,169,2634,8806,2022-03-12 17:43:33.788185
1999,83,1455,70,68,1137,2813,2022-03-12 17:43:35.730336
2000,955,12824,346,163,15829,30117,2022-03-12 17:43:35.992333
2003,64,951,29,57,780,1881,2022-03-12 17:43:41.186624
2004,646,4394,563,557,7306,13466,2022-03-12 17:43:43.45688
2006,601,41376,327,372,5359,48035,2022-03-12 17:43:45.916131
2008,60,918,39,63,917,1997,2022-03-12 17:43:48.001474
2009,69,1221,43,67,1009,2409,2022-03-12 17:43:50.096476
2012,1112,6594,1127,903,7866,17602,2022-03-12 17:44:08.558384
2014,366,5262,295,224,3300,9447,2022-03-12 17:44:15.249042
2015,69,1259,51,55,892,2326,2022-03-12 17:44:16.224042
2017,146,3886,111,72,2887,7102,2022-03-12 17:44:18.59927
2018,98,2452,52,55,1753,4410,2022-03-12 17:44:20.635511
2020,363,22944,317,251,5147,29022,2022-03-12 17:44:21.355638
2022,48,656,27,33,486,1250,2022-03-12 17:44:22.713637
2023,132,1256,100,142,1398,3028,2022-03-12 17:44:25.035818
2024,66,182,56,131,268,703,2022-03-12 17:44:25.291361
2025,43758,494633,36042,25241,250229,849903,2022-03-12 17:44:25.738362
2027,55,1086,42,46,663,1892,2022-03-12 17:44:31.236992
2028,24,257,15,51,239,586,2022-03-12 17:44:32.467007
2029,120,2122,80,101,2299,4722,2022-03-12 17:44:32.798009
2031,1549,15348,1274,2060,12264,32495,2022-03-12 17:44:38.355587
34201,12,41,2,46,71,172,2022-03-12 19:31:52.880346
2033,211,3521,131,143,4587,8593,2022-03-12 17:44:43.041049
2034,22181,325517,16309,17153,132835,513995,2022-03-12 17:44:43.992048
2035,719,14233,501,411,7900,23764,2022-03-12 17:44:47.519298
2036,211,1554,287,297,1342,3691,2022-03-12 17:44:51.36888
2037,472,3092,483,470,3470,7987,2022-03-12 17:44:53.522494
2039,166,697,192,160,1361,2576,2022-03-12 17:44:58.18001
2040,146,476,124,181,1432,2359,2022-03-12 17:44:59.858639
2041,332,5529,592,967,2017,9437,2022-03-12 17:45:01.951517
2042,284,5671,140,99,5288,11482,2022-03-12 17:45:04.229833
2044,1110,3892,889,615,5716,12222,2022-03-12 17:45:09.62743
2047,50,2819,22,63,812,3766,2022-03-12 17:45:15.510276
2048,472,3028,292,188,4437,8417,2022-03-12 17:45:19.397539
2049,54,1022,36,61,757,1930,2022-03-12 17:45:22.494968
2050,145,3505,87,90,2237,6064,2022-03-12 17:45:24.168032
2053,79,1437,54,63,1106,2739,2022-03-12 17:45:29.226085
2054,40,607,28,64,653,1392,2022-03-12 17:45:29.506085
2055,72,903,39,51,944,2009,2022-03-12 17:45:31.426858
2056,50,1342,35,58,777,2262,2022-03-12 17:45:33.111945
2057,79,1664,40,67,1036,2886,2022-03-12 17:45:34.700945
2058,40,775,25,53,465,1358,2022-03-12 17:45:36.45806
2060,164,2949,97,90,2785,6085,2022-03-12 17:45:40.004332
2061,72,1841,50,51,882,2896,2022-03-12 17:45:41.460931
2062,68,1664,50,51,867,2700,2022-03-12 17:45:43.092934
2064,99,1234,68,72,1057,2530,2022-03-12 17:45:46.449391
2065,72,1110,52,70,757,2061,2022-03-12 17:45:47.662829
2066,63,710,54,51,756,1634,2022-03-12 17:45:48.821828
2067,71,2717,59,54,1188,4089,2022-03-12 17:45:50.656605
2069,55,673,29,38,582,1377,2022-03-12 17:45:52.6521
2071,133,4403,103,94,2761,7494,2022-03-12 17:45:54.909117
2073,45,201,27,49,529,851,2022-03-12 17:45:56.881961
2074,61,374,66,105,595,1201,2022-03-12 17:45:58.308965
2075,64,276,55,101,519,1015,2022-03-12 17:46:00.378114
2076,2822,5949,2217,1275,13470,25733,2022-03-12 17:46:08.756079
2078,57,1182,52,71,728,2090,2022-03-12 17:46:12.012725
2080,41,497,17,51,482,1088,2022-03-12 17:46:13.826698
2081,45,692,22,42,460,1261,2022-03-12 17:46:14.1887
2082,58,612,38,53,708,1469,2022-03-12 17:46:15.775042
2083,105,1364,62,62,1149,2742,2022-03-12 17:46:17.394664
2084,188,1012,142,173,1396,2911,2022-03-12 17:46:19.199663
2086,45,402,27,52,510,1036,2022-03-12 17:46:22.997463
2087,159,1068,127,161,995,2510,2022-03-12 17:46:24.807583
2088,61,1207,39,55,979,2341,2022-03-12 17:46:26.427668
2090,93,1472,81,89,1462,3197,2022-03-12 17:46:28.797043
2092,45,560,17,42,503,1167,2022-03-12 17:46:32.15439
2093,41,526,15,48,470,1100,2022-03-12 17:46:32.429388
2094,62,933,27,49,677,1748,2022-03-12 17:46:34.101926
2095,57,547,39,76,659,1378,2022-03-12 17:46:35.39168
2096,40,509,15,47,434,1045,2022-03-12 17:46:37.072658
2098,206,4567,128,120,2689,7710,2022-03-12 17:46:40.569601
2099,125,2122,82,72,1785,4186,2022-03-12 17:46:42.756798
2101,46,610,14,58,517,1245,2022-03-12 17:46:44.881911
2102,102,1571,61,71,1058,2863,2022-03-12 17:46:45.288016
2103,83,1432,33,59,1411,3018,2022-03-12 17:46:47.248351
2104,18410,160493,15768,16670,88927,300268,2022-03-12 17:46:51.319619
2106,802,2981,690,803,4619,9895,2022-03-12 17:46:55.558661
2107,600,49191,448,404,7527,58170,2022-03-12 17:46:55.851665
2108,562,10867,676,657,3057,15819,2022-03-12 17:46:59.099656
2110,259,4262,270,274,2366,7431,2022-03-12 17:47:04.631478
2111,65,2717,67,78,1096,4023,2022-03-12 17:47:10.187217
2112,1506,24977,1227,1601,12506,41817,2022-03-12 17:47:11.729858
2114,75,862,38,67,744,1786,2022-03-12 17:47:42.678772
2117,189,8939,155,213,1533,11029,2022-03-12 17:47:48.268907
2118,98,4238,65,107,966,5474,2022-03-12 17:47:48.58788
2119,88,3442,67,113,909,4619,2022-03-12 17:47:48.961884
2121,88,3442,58,103,917,4608,2022-03-12 17:47:55.87588
2123,210,15659,185,229,3154,19437,2022-03-12 17:47:59.342014
2124,555,24024,491,545,9240,34855,2022-03-12 17:48:01.472677
2125,227,7339,187,172,3913,11838,2022-03-12 17:48:01.93004
2126,257,7113,194,184,4168,11916,2022-03-12 17:48:02.280039
2127,115,766,116,154,955,2106,2022-03-12 17:48:03.743229
2128,150,518,178,174,1325,2345,2022-03-12 17:48:05.71182
2130,4863,34328,4134,4768,25351,73444,2022-03-12 17:48:07.64806
2131,1321,83378,929,946,13660,100234,2022-03-12 17:48:11.147347
2133,87,1414,56,79,1722,3358,2022-03-12 17:48:16.179686
2141,135,2269,77,83,3446,6010,2022-03-12 17:48:20.127676
2142,2305,31005,2741,5273,7538,48862,2022-03-12 17:48:24.200615
2144,1343,167908,710,589,12722,183272,2022-03-12 17:48:27.254342
2147,173,6179,95,96,2586,9129,2022-03-12 17:48:34.200937
2150,1947,12048,1511,881,5556,21943,2022-03-12 17:48:37.633738
2151,138,4194,156,318,965,5771,2022-03-12 17:48:42.001493
2152,612,4842,710,808,4721,11693,2022-03-12 17:48:45.269388
2154,2077,50908,1052,582,43588,98207,2022-03-12 17:48:50.349908
2157,324,2821,257,284,2321,6007,2022-03-12 17:49:02.530874
2159,5046,46465,4302,2870,33732,92415,2022-03-12 17:49:06.410612
2163,864,12517,577,646,7234,21838,2022-03-12 17:49:12.009062
2164,7417,44385,7192,4734,69312,133040,2022-03-12 17:49:15.410213
2165,327,1416,342,412,2353,4850,2022-03-12 17:49:19.54494
2618,721,7304,487,401,8004,16917,2022-03-12 17:59:56.193898
2167,57664,823301,42997,42539,306661,1273162,2022-03-12 17:49:25.142089
2168,117,1216,117,116,1384,2950,2022-03-12 17:49:27.215785
2169,268,4213,222,434,2879,8016,2022-03-12 17:49:29.570903
2170,251,6341,241,158,3254,10245,2022-03-12 17:49:31.778625
2171,329,34922,203,186,3388,39028,2022-03-12 17:49:34.093727
2175,845,27366,502,222,16313,45248,2022-03-12 17:49:42.470094
2180,121,1074,84,98,1465,2842,2022-03-12 17:49:53.550595
2649,40,2029,30,84,435,2618,2022-03-12 18:00:40.593783
2181,87,1384,52,71,962,2556,2022-03-12 17:49:55.565306
2183,145,3019,75,106,1477,4822,2022-03-12 17:49:57.80959
2193,139,2036,100,152,2224,4651,2022-03-12 17:49:58.096567
2198,363,18248,311,201,4931,24054,2022-03-12 17:50:00.629794
2199,187,6279,119,106,4128,10819,2022-03-12 17:50:02.873973
2200,214,1480,186,168,2073,4121,2022-03-12 17:50:04.763977
2201,400,71576,264,271,4227,76738,2022-03-12 17:50:05.09397
2202,201,4998,125,128,3720,9172,2022-03-12 17:50:07.646233
2203,333,2727,220,202,2563,6045,2022-03-12 17:50:10.235061
2206,49,1862,58,61,961,2991,2022-03-12 17:50:17.519856
2210,110,13382,59,58,2062,15671,2022-03-12 17:50:21.762026
2212,107,2729,108,110,2476,5530,2022-03-12 17:50:24.536625
2213,2002,12908,2481,2077,11617,31085,2022-03-12 17:50:27.212915
2216,5473,38855,3569,3871,56728,108496,2022-03-12 17:50:31.101483
2217,113,6520,93,79,1363,8168,2022-03-12 17:50:33.374217
2219,107,2106,70,121,1712,4116,2022-03-12 17:50:36.577696
2220,141,6420,77,140,1930,8708,2022-03-12 17:50:39.313786
2221,361,3865,404,450,2410,7490,2022-03-12 17:50:41.781399
2225,962,22210,1028,1233,5854,31287,2022-03-12 17:50:50.908466
2226,19,320,20,92,184,635,2022-03-12 17:50:52.454489
2227,163,3207,168,272,1943,5753,2022-03-12 17:50:55.045622
2228,137,3352,106,208,759,4562,2022-03-12 17:50:57.44931
2229,1163,12407,921,997,5858,21346,2022-03-12 17:51:00.121406
2230,191,1854,221,282,2089,4637,2022-03-12 17:51:00.456086
2232,59,492,27,114,305,997,2022-03-12 17:51:03.905273
2233,65,514,56,102,374,1111,2022-03-12 17:51:05.631049
2234,96,891,173,281,703,2144,2022-03-12 17:51:07.209209
2235,311,17249,123,123,5299,23105,2022-03-12 17:51:07.538209
2237,202,12399,196,154,4326,17277,2022-03-12 17:51:13.208803
2243,135,473,93,163,1336,2200,2022-03-12 17:51:16.32103
2245,207,1410,174,234,2609,4634,2022-03-12 17:51:19.245684
2249,124,2876,78,109,1880,5067,2022-03-12 17:51:26.133714
2251,39494,404465,33696,20778,315880,814313,2022-03-12 17:51:29.353429
2252,1481,7670,986,1330,15190,26657,2022-03-12 17:51:32.458423
2253,985,7021,934,970,5334,15244,2022-03-12 17:51:35.106651
2255,317,1257,235,220,2444,4473,2022-03-12 17:51:39.406348
2256,39,713,30,56,598,1436,2022-03-12 17:51:41.256393
2258,25,443,20,62,305,855,2022-03-12 17:51:43.419517
2259,356,1023,373,405,1714,3871,2022-03-12 17:51:43.787518
2261,196,2059,97,136,2254,4742,2022-03-12 17:51:47.628759
2263,251,13916,109,136,2084,16496,2022-03-12 17:51:50.683519
2264,81,2465,41,87,1103,3777,2022-03-12 17:51:51.039519
2267,133,4462,119,117,2860,7691,2022-03-12 17:51:53.748456
2272,43,890,36,70,765,1804,2022-03-12 17:51:56.285446
2273,600,46528,308,235,6460,54131,2022-03-12 17:51:58.840131
2277,153,1472,134,230,1526,3515,2022-03-12 17:52:00.444779
2279,55,2550,28,77,968,3678,2022-03-12 17:52:02.620019
2280,52,379,70,166,443,1110,2022-03-12 17:52:02.900053
2282,110,321,84,104,861,1480,2022-03-12 17:52:06.006739
2283,183,1467,178,266,1293,3387,2022-03-12 17:52:08.418738
2284,165,3114,144,290,760,4473,2022-03-12 17:52:08.681151
2286,135,6403,81,89,2301,9009,2022-03-12 17:52:13.668487
2289,62,1262,57,69,785,2235,2022-03-12 17:52:20.488826
2290,80,5864,37,42,1452,7475,2022-03-12 17:52:22.697338
2291,270,3587,150,154,3166,7327,2022-03-12 17:52:24.974986
2293,136,3616,71,72,1956,5851,2022-03-12 17:52:27.658228
2294,237,7276,209,199,2883,10804,2022-03-12 17:52:27.931228
2298,174,10811,138,131,3135,14389,2022-03-12 17:52:30.445795
2299,50,1121,34,62,715,1982,2022-03-12 17:52:30.702914
2300,63,2135,52,87,1332,3669,2022-03-12 17:52:30.963911
2304,75,1630,63,130,1103,3001,2022-03-12 17:52:33.530042
2305,65,1708,73,146,1068,3060,2022-03-12 17:52:35.97146
2306,68,1856,60,132,1102,3218,2022-03-12 17:52:37.774102
2307,136,1505,94,82,1205,3022,2022-03-12 17:52:39.574228
2308,297,1129,170,258,2275,4129,2022-03-12 17:52:39.83825
2309,84,1953,53,88,973,3151,2022-03-12 17:52:41.536446
2311,59,802,39,62,1210,2172,2022-03-12 17:52:44.485578
2313,155,6276,83,140,2205,8859,2022-03-12 17:52:49.426701
2314,54,345,18,46,580,1043,2022-03-12 17:52:50.982405
2317,220,2621,89,162,1937,5029,2022-03-12 17:52:53.083626
2318,43,1099,31,64,552,1789,2022-03-12 17:52:53.376627
2319,57,1947,48,39,981,3072,2022-03-12 17:52:53.62663
2332,373,8000,167,131,4917,13588,2022-03-12 17:52:56.776
2334,44,713,38,69,465,1329,2022-03-12 17:53:00.977976
2335,377,4738,424,423,2285,8247,2022-03-12 17:53:03.263199
2336,115,7131,106,100,1750,9202,2022-03-12 17:53:05.312441
2337,281,1136,235,196,2588,4436,2022-03-12 17:53:05.564442
2346,236,5842,103,124,3301,9606,2022-03-12 17:53:08.386119
2354,474,18177,200,164,6826,25841,2022-03-12 17:53:08.650116
2355,307,14392,159,129,4355,19342,2022-03-12 17:53:11.060518
2359,160,3306,86,150,1812,5514,2022-03-12 17:53:17.025534
2361,221,2688,239,318,1492,4958,2022-03-12 17:53:18.849532
2362,126,600,64,199,1242,2231,2022-03-12 17:53:21.126255
2363,472,21550,720,760,4039,27541,2022-03-12 17:53:23.670453
2364,182,1711,159,315,1647,4014,2022-03-12 17:53:25.342544
2365,64,800,33,52,800,1749,2022-03-12 17:53:27.012696
2366,61,171,31,75,542,880,2022-03-12 17:53:28.444693
2369,3572,24844,3468,4183,22169,58236,2022-03-12 17:53:33.647321
2382,84,277,62,142,746,1311,2022-03-12 17:53:35.34607
2383,376,3899,312,293,3690,8570,2022-03-12 17:53:37.82618
2384,66,1298,42,57,736,2199,2022-03-12 17:53:39.517294
2386,367,32689,264,258,5271,38849,2022-03-12 17:53:42.840238
2387,113,1764,80,88,2199,4244,2022-03-12 17:53:45.272452
2388,37,300,22,57,620,1036,2022-03-12 17:53:47.148961
2389,557,3474,748,780,3469,9028,2022-03-12 17:53:49.390755
2391,214,4341,305,1300,1778,7938,2022-03-12 17:53:52.236468
2392,117,10567,49,127,785,11645,2022-03-12 17:53:52.853467
2393,80,6947,48,114,617,7806,2022-03-12 17:53:53.190179
2397,650,63392,286,312,5414,70054,2022-03-12 17:53:53.510179
2406,1770,0,602,1527,3032,6931,2022-03-12 17:53:57.301743
2407,101,4631,68,82,1218,6100,2022-03-12 17:54:01.123504
2408,93,3676,65,93,1220,5147,2022-03-12 17:54:03.929013
2409,760,6554,700,651,5210,13875,2022-03-12 17:54:06.527296
2414,84,1978,62,98,1393,3615,2022-03-12 17:54:08.373915
2416,128,1235,58,125,630,2176,2022-03-12 17:54:12.629902
2417,163,10896,80,153,1763,13055,2022-03-12 17:54:15.295123
2419,133,2243,74,71,2172,4693,2022-03-12 17:54:19.107042
2420,123,1496,63,61,1700,3443,2022-03-12 17:54:21.163298
2421,34,495,8,34,314,885,2022-03-12 17:54:22.403832
2423,76,1272,35,58,994,2435,2022-03-12 17:54:25.679106
2424,316,20323,298,182,5480,26599,2022-03-12 17:54:26.053103
2428,40,830,12,57,393,1332,2022-03-12 17:54:29.320919
2429,56,1667,28,69,833,2653,2022-03-12 17:54:31.059534
2448,573,16066,393,275,9994,27301,2022-03-12 17:54:34.687168
2449,761,22908,464,327,12769,37229,2022-03-12 17:54:35.012164
2451,1254,7103,929,650,8926,18862,2022-03-12 17:54:39.76943
2452,239,4793,134,98,3615,8879,2022-03-12 17:54:42.156178
2455,70,576,62,81,528,1317,2022-03-12 17:54:47.832308
2456,37,1165,18,50,453,1723,2022-03-12 17:54:50.489855
2458,210,4312,168,134,1992,6816,2022-03-12 17:54:52.405168
2459,119,2880,78,73,1603,4753,2022-03-12 17:54:52.763163
2462,106,2469,63,102,1092,3832,2022-03-12 17:54:59.691231
2463,287,335,136,77,1590,2425,2022-03-12 17:55:01.474351
2464,30,697,29,47,423,1226,2022-03-12 17:55:02.871324
2465,102,645,50,100,1326,2223,2022-03-12 17:55:04.854819
2466,55,743,35,40,481,1354,2022-03-12 17:55:06.218173
2467,93,1275,102,260,570,2300,2022-03-12 17:55:06.40617
2468,93,1753,48,59,1674,3627,2022-03-12 17:55:08.313171
2471,4616,28980,4550,7803,5195,51144,2022-03-12 17:55:09.81231
2472,2758,237582,814,629,17494,259277,2022-03-12 17:55:10.09231
2473,112,1873,68,93,1518,3664,2022-03-12 17:55:12.47102
2474,88,1370,51,58,958,2525,2022-03-12 17:55:14.25048
2475,131,1514,81,197,1307,3230,2022-03-12 17:55:16.333758
2482,67,897,41,49,680,1734,2022-03-12 17:55:21.096569
2483,76,1166,63,71,868,2244,2022-03-12 17:55:22.6092
2484,176,1330,164,197,1195,3062,2022-03-12 17:55:24.289195
2486,304,2184,302,222,3420,6432,2022-03-12 17:55:30.415607
2487,88,642,77,93,733,1633,2022-03-12 17:55:31.935583
2488,324,10347,218,157,7552,18598,2022-03-12 17:55:32.258584
2490,306,25711,248,229,4843,31337,2022-03-12 17:55:37.520261
2491,48,1195,44,85,791,2163,2022-03-12 17:55:39.53236
2492,39,1143,36,84,670,1972,2022-03-12 17:55:41.647199
2493,37,1074,41,76,692,1920,2022-03-12 17:55:42.726223
2494,4113,61366,2779,3698,20624,92580,2022-03-12 17:55:45.163223
2497,430,3856,308,254,3842,8690,2022-03-12 17:55:49.270886
2498,226,10402,168,156,3548,14500,2022-03-12 17:55:52.520303
2499,253,10342,174,171,3691,14631,2022-03-12 17:55:55.29928
2501,102,519,128,232,613,1594,2022-03-12 17:56:00.097115
2503,47,204,38,101,468,858,2022-03-12 17:56:00.506754
2508,2061,54545,1833,1346,17747,77532,2022-03-12 17:56:02.881105
2510,141,705,110,132,1431,2519,2022-03-12 17:56:03.159101
2514,198,13350,128,135,2270,16081,2022-03-12 17:56:11.856329
2515,123,10751,114,129,1963,13080,2022-03-12 17:56:16.937103
2517,73,3244,68,82,1629,5096,2022-03-12 17:56:20.735082
2518,168,1580,233,151,838,2970,2022-03-12 17:56:22.748413
2520,369,23279,245,291,4209,28393,2022-03-12 17:56:25.024537
2522,62,1218,40,67,839,2226,2022-03-12 17:56:28.517916
2525,240,2266,133,214,2163,5016,2022-03-12 17:56:35.486456
2528,111,1117,71,70,1194,2563,2022-03-12 17:56:40.828533
2529,54,930,36,43,647,1710,2022-03-12 17:56:44.112821
2534,185,2844,137,238,2217,5621,2022-03-12 17:56:49.872374
2535,78,1235,69,138,1161,2681,2022-03-12 17:56:50.125398
2536,93,1410,79,137,1300,3019,2022-03-12 17:56:51.812495
2537,55,485,46,103,758,1447,2022-03-12 17:56:53.273494
2542,350,5185,357,358,2651,8901,2022-03-12 17:56:58.367972
2543,267,4876,273,340,1909,7665,2022-03-12 17:57:01.391648
2544,229,3025,182,220,1791,5447,2022-03-12 17:57:03.380649
2547,562,11885,455,489,4337,17728,2022-03-12 17:57:17.695734
2549,240,1558,183,190,2820,4991,2022-03-12 17:57:22.72239
2550,33,2107,19,43,361,2563,2022-03-12 17:57:24.246529
2553,238,2046,219,246,3522,6271,2022-03-12 17:57:27.156303
2554,180,2470,179,253,1737,4819,2022-03-12 17:57:28.995479
2555,183,1694,135,184,1563,3759,2022-03-12 17:57:31.111893
2556,180,2200,208,370,1099,4057,2022-03-12 17:57:33.998272
2559,1767,19311,1099,774,20361,43312,2022-03-12 17:57:37.629842
2560,234,4261,148,153,4669,9465,2022-03-12 17:57:39.870459
2562,1364,12303,1458,1555,13294,29974,2022-03-12 17:57:42.490808
2564,690,9437,750,1200,5164,17241,2022-03-12 17:57:47.998369
2565,89,1134,60,193,812,2288,2022-03-12 17:57:49.793371
2567,46,1246,39,168,297,1796,2022-03-12 17:57:54.979357
2569,156,4633,139,323,992,6243,2022-03-12 17:58:02.374811
2570,86,1378,80,147,809,2500,2022-03-12 17:58:04.076304
2571,133,6729,195,664,697,8418,2022-03-12 17:58:04.51733
2573,84,826,91,125,872,1998,2022-03-12 17:58:06.740525
2574,68,953,56,157,411,1645,2022-03-12 17:58:07.148521
2575,27,590,29,118,170,934,2022-03-12 17:58:09.354623
2576,100,1001,77,185,1042,2405,2022-03-12 17:58:11.002741
2577,260,4280,249,360,2204,7353,2022-03-12 17:58:11.270742
2579,84,3644,69,197,554,4548,2022-03-12 17:58:15.05851
2580,152,8374,136,91,2439,11192,2022-03-12 17:58:17.122201
2582,1698,5566,1207,692,11640,20803,2022-03-12 17:58:22.60877
2583,78,2342,48,67,1075,3610,2022-03-12 17:58:24.891955
2584,77,2042,40,64,910,3133,2022-03-12 17:58:25.815499
2585,85,2244,62,63,1354,3808,2022-03-12 17:58:27.575615
2586,88,1808,66,63,1181,3206,2022-03-12 17:58:29.74096
2589,278,14307,278,185,5676,20724,2022-03-12 17:58:31.848219
2591,76,2139,46,65,1064,3390,2022-03-12 17:58:32.100222
2592,148,4363,98,148,2019,6776,2022-03-12 17:58:34.326763
2593,10749,212979,4015,1746,149410,378899,2022-03-12 17:58:36.969952
2598,436,1179,327,229,3299,5470,2022-03-12 17:58:49.745288
2600,32,327,18,47,410,834,2022-03-12 17:58:52.644065
2601,38,464,24,50,514,1090,2022-03-12 17:59:04.20509
2602,1684,20385,1205,1500,11581,36355,2022-03-12 17:59:19.353818
2604,1100,10412,1143,1412,8577,22644,2022-03-12 17:59:26.722459
46035,0,0,0,0,0,0,2022-03-12 20:11:19.111613
1,147052,890126,88300,33567,408216,1567261,2022-03-12 17:16:11.24743
5,5394,243249,2390,934,73473,325440,2022-03-12 17:16:42.092911
6,34826,385708,29076,15955,178493,644058,2022-03-12 17:17:00.201931
46044,0,0,0,0,0,0,2022-03-12 20:11:22.72019
46047,0,0,0,0,0,0,2022-03-12 20:11:23.875496
46057,0,0,0,0,0,0,2022-03-12 20:11:26.226789
7,4808,48717,5504,5715,39033,103777,2022-03-12 17:17:00.385593
8,701,7682,793,1164,3782,14122,2022-03-12 17:17:00.666593
20,183380,1938984,79911,117097,92268,2411640,2022-03-12 17:17:03.868811
21,1220606,39,233647,160673,188349,1803314,2022-03-12 17:17:04.060815
28,5723,43269,6208,4982,28345,88527,2022-03-12 17:17:05.19293
48,7309,96654,8755,12767,44104,169589,2022-03-12 17:17:07.4261
56,645,8210,731,1312,5651,16549,2022-03-12 17:17:08.706099
46063,0,0,0,0,0,0,2022-03-12 20:11:28.776309
46066,0,0,0,0,0,0,2022-03-12 20:11:30.461382
46067,0,0,0,0,0,0,2022-03-12 20:11:31.291501
46075,0,0,0,0,0,0,2022-03-12 20:11:34.809417
64,6192,120215,6312,8353,48487,189559,2022-03-12 17:17:09.904791
73,5144,188082,4055,2446,43818,243545,2022-03-12 17:17:11.233321
81,2817,49227,1624,889,16679,71236,2022-03-12 17:17:12.412331
88,485,19014,255,215,6626,26595,2022-03-12 17:17:13.490955
96,2977,42239,2731,1764,11610,61321,2022-03-12 17:17:14.754955
103,784,5594,1087,1060,4872,13397,2022-03-12 17:17:15.830168
111,585,7620,771,1040,4001,14017,2022-03-12 17:17:17.131268
119,1051,22654,809,1160,7822,33496,2022-03-12 17:17:18.328291
124,299,12302,241,247,3533,16622,2022-03-12 17:17:19.470768
132,6130,59512,8399,7910,31504,113455,2022-03-12 17:17:20.76655
139,2565,105337,974,867,18549,128292,2022-03-12 17:17:21.830678
148,386,2963,369,454,4291,8463,2022-03-12 17:17:23.057747
156,2977,41537,3472,3211,24057,75254,2022-03-12 17:17:24.284752
164,14653,892260,4180,1727,153082,1065902,2022-03-12 17:17:25.555783
171,212,1707,180,240,2436,4775,2022-03-12 17:17:26.678782
2817,192,4312,130,213,2131,6978,2022-03-12 18:05:40.946679
180,2251,55790,1905,2578,15578,78102,2022-03-12 17:17:27.900785
189,8579,163115,7774,12440,53351,245259,2022-03-12 17:17:29.110882
199,19081,1410078,3902,1765,127841,1562667,2022-03-12 17:17:38.485762
200,1751,10318,1632,1693,9661,25055,2022-03-12 17:17:38.720758
201,767,15018,625,519,8933,25862,2022-03-12 17:17:38.879759
207,3301,26626,2079,1770,25258,59034,2022-03-12 17:17:39.689908
219,288,10399,191,122,3514,14514,2022-03-12 17:17:40.907503
46078,0,0,0,0,0,0,2022-03-12 20:11:36.223097
47585,0,0,0,0,0,0,2022-03-12 20:24:59.639808
47588,0,0,0,0,0,0,2022-03-12 20:25:01.026129
47590,0,0,0,0,0,0,2022-03-12 20:25:02.241032
230,1752,18387,1708,3190,10426,35463,2022-03-12 17:17:42.135974
231,354,2903,345,528,3014,7144,2022-03-12 17:17:46.607795
232,27337,239481,23850,16011,78308,384987,2022-03-12 17:17:47.14282
233,1506,12219,1943,1613,5319,22600,2022-03-12 17:17:47.321793
237,21247,202203,22408,18644,141357,405859,2022-03-12 17:17:47.966307
244,426,2193,546,659,3113,6937,2022-03-12 17:17:49.050459
252,1766,14979,1934,2121,17096,37896,2022-03-12 17:17:53.133829
46137,0,0,0,0,0,0,2022-03-12 20:12:06.623889
46139,0,0,0,0,0,0,2022-03-12 20:12:07.881305
46143,0,0,0,0,0,0,2022-03-12 20:12:09.148748
46146,0,0,0,0,0,0,2022-03-12 20:12:10.231181
253,1509,15441,2117,2002,10518,31587,2022-03-12 17:17:53.315812
254,239,8826,231,205,2203,11704,2022-03-12 17:17:53.476806
257,6781,83462,4858,9178,40214,144493,2022-03-12 17:17:53.940806
264,1948,94725,595,439,15099,112806,2022-03-12 17:17:55.035803
272,4350,43033,5495,5733,43158,101769,2022-03-12 17:17:56.292524
280,203,689,298,384,1016,2590,2022-03-12 17:17:57.691062
286,457,6216,451,594,2920,10638,2022-03-12 17:17:58.650212
294,516,4964,478,900,4655,11513,2022-03-12 17:17:59.847981
302,1902,17666,1365,877,20444,42254,2022-03-12 17:18:01.085728
310,47,883,53,173,534,1690,2022-03-12 17:18:02.291736
319,150,3780,136,170,1645,5881,2022-03-12 17:18:03.535856
327,548,7270,524,590,4497,13429,2022-03-12 17:18:08.697065
328,293,3586,346,673,3343,8241,2022-03-12 17:18:11.691727
329,12678,77362,9748,6715,115124,221627,2022-03-12 17:18:15.089171
330,4696,105757,3453,4640,32549,151095,2022-03-12 17:18:18.553777
331,589,3720,640,595,4145,9689,2022-03-12 17:18:18.745774
332,171,1718,171,219,1351,3630,2022-03-12 17:18:18.910775
333,260,2627,250,240,1876,5253,2022-03-12 17:18:19.089777
336,510,4414,637,958,5686,12205,2022-03-12 17:18:23.372066
337,397,6153,320,535,3252,10657,2022-03-12 17:18:25.900251
338,5167,28895,4315,2619,40509,81505,2022-03-12 17:18:26.107252
339,43125,269965,28678,18333,250378,610479,2022-03-12 17:18:26.573248
340,1233,11741,792,869,7951,22586,2022-03-12 17:18:26.757251
345,2261,19942,1781,1584,24641,50209,2022-03-12 17:18:29.548315
346,584,7052,481,680,5733,14530,2022-03-12 17:18:29.75134
354,428,4029,341,694,3298,8790,2022-03-12 17:18:34.211664
355,22045,308008,19714,22676,127483,499926,2022-03-12 17:18:34.414638
356,35039,590519,22928,27328,176368,852182,2022-03-12 17:18:35.324641
357,4330,132695,3037,6004,34764,180830,2022-03-12 17:18:38.165762
358,780,13131,631,640,9039,24221,2022-03-12 17:18:38.343789
359,137,2675,100,130,2030,5072,2022-03-12 17:18:38.532787
46225,0,0,0,0,0,0,2022-03-12 20:13:26.906509
46226,0,0,0,0,0,0,2022-03-12 20:13:27.761213
46229,0,0,0,0,0,0,2022-03-12 20:13:28.862467
46234,0,0,0,0,0,0,2022-03-12 20:13:33.305408
360,251,2341,261,328,2335,5516,2022-03-12 17:18:38.707765
366,1217,17129,859,1489,9367,30061,2022-03-12 17:18:39.624234
374,198,2726,220,287,1751,5182,2022-03-12 17:18:40.741811
382,1196,21776,752,936,8145,32805,2022-03-12 17:18:42.005177
390,4275,64033,3525,4630,31233,107696,2022-03-12 17:18:43.217202
398,407,11238,218,155,4433,16451,2022-03-12 17:18:44.458314
406,473,8134,427,839,3985,13858,2022-03-12 17:18:49.064766
407,1512,16403,1673,1299,10812,31699,2022-03-12 17:18:49.269762
408,583,52090,319,200,9838,63030,2022-03-12 17:18:49.464371
417,1705,28591,1816,3598,10370,46080,2022-03-12 17:18:50.350344
425,137,4099,91,156,1946,6429,2022-03-12 17:18:51.561521
433,4892,106278,2383,1352,82067,196972,2022-03-12 17:18:52.961523
439,192,4380,165,152,2791,7680,2022-03-12 17:18:54.26052
445,531,7999,597,717,6198,16042,2022-03-12 17:18:55.232161
454,250,14370,231,360,4666,19877,2022-03-12 17:19:00.955425
455,1290,8359,1362,1238,17786,30035,2022-03-12 17:19:04.759757
457,63873,264254,48627,22917,323964,723635,2022-03-12 17:19:08.643288
458,283,4407,178,205,2824,7897,2022-03-12 17:19:08.832288
459,1757,89094,506,450,10717,102524,2022-03-12 17:19:09.010288
460,749,69221,421,276,7974,78641,2022-03-12 17:19:09.179292
468,2061,104948,1149,529,36929,145616,2022-03-12 17:19:16.383161
469,5856,116199,5257,7501,31746,166559,2022-03-12 17:19:16.750158
470,1341,12721,875,1402,9109,25448,2022-03-12 17:19:16.921183
46235,0,0,0,0,0,0,2022-03-12 20:13:34.186162
46236,0,0,0,0,0,0,2022-03-12 20:13:34.984568
46238,0,0,0,0,0,0,2022-03-12 20:13:36.626601
46239,0,0,0,0,0,0,2022-03-12 20:13:37.487586
471,862,8900,714,786,8243,19505,2022-03-12 17:19:17.100158
476,1484,28633,1488,1637,12947,46189,2022-03-12 17:19:17.876696
485,404,6436,468,595,2564,10467,2022-03-12 17:19:19.122693
499,512,10681,213,165,7067,18638,2022-03-12 17:19:21.40393
508,2195,27874,4440,10586,7464,52559,2022-03-12 17:19:22.646523
516,8242,23990,11212,9676,15197,68317,2022-03-12 17:19:27.032601
517,795,44300,551,346,9752,55744,2022-03-12 17:19:30.04087
518,404,2265,382,402,3489,6942,2022-03-12 17:19:30.208469
519,1053,12791,938,1035,8097,23914,2022-03-12 17:19:33.166544
520,167,6253,134,99,3103,9756,2022-03-12 17:19:33.335543
521,2761,50670,2778,4359,9741,70309,2022-03-12 17:19:33.818752
522,1806,51238,889,534,36190,90657,2022-03-12 17:19:33.986728
526,574,6507,403,371,8715,16570,2022-03-12 17:19:34.637736
533,355,3433,462,540,2983,7773,2022-03-12 17:19:35.757308
541,503,14000,340,295,3909,19047,2022-03-12 17:19:36.999307
547,75,1619,82,79,906,2761,2022-03-12 17:19:38.178393
556,123,3099,115,125,1604,5066,2022-03-12 17:19:39.410392
564,543,21788,355,474,7523,30683,2022-03-12 17:19:40.672314
571,137,1501,98,179,1382,3297,2022-03-12 17:19:41.756145
580,130,3980,142,291,1380,5923,2022-03-12 17:19:42.971168
589,856,13013,647,633,8659,23808,2022-03-12 17:19:44.211359
597,2184,189831,956,383,34551,227905,2022-03-12 17:19:45.440933
605,334,2275,388,542,3140,6679,2022-03-12 17:19:46.731038
612,346,2635,285,378,2765,6409,2022-03-12 17:19:47.885044
619,110,2549,63,56,1386,4164,2022-03-12 17:19:48.97104
627,3098,60353,1982,1599,23857,90889,2022-03-12 17:19:50.226604
636,361,5496,348,316,3661,10182,2022-03-12 17:19:51.485601
647,117,1653,84,102,1385,3341,2022-03-12 17:19:52.597948
654,62,2186,80,61,1078,3467,2022-03-12 17:19:53.901116
660,122,1727,129,153,1220,3351,2022-03-12 17:19:55.084143
670,1555,22292,1251,1853,12447,39398,2022-03-12 17:19:56.278727
681,62,1212,29,43,609,1955,2022-03-12 17:19:57.489242
688,769,11149,791,1099,9709,23517,2022-03-12 17:19:58.594681
704,185,8244,192,183,4157,12961,2022-03-12 17:19:59.8167
705,56,1473,55,51,698,2333,2022-03-12 17:20:03.151105
706,301,5020,409,485,2842,9057,2022-03-12 17:20:03.432105
707,57,2245,91,58,1108,3559,2022-03-12 17:20:03.594296
2605,18255,140083,16722,11833,129065,315958,2022-03-12 17:59:30.031344
2606,186,9090,175,171,2909,12531,2022-03-12 17:59:33.490436
2607,147,2640,79,100,2776,5742,2022-03-12 17:59:35.478231
2619,393,4898,388,631,1925,8235,2022-03-12 17:59:59.339047
2622,71,1693,37,62,823,2686,2022-03-12 18:00:06.615696
2623,547,6471,268,193,12311,19790,2022-03-12 18:00:10.324955
2625,28,1271,21,88,403,1811,2022-03-12 18:00:12.6147
2626,22,806,21,79,326,1254,2022-03-12 18:00:14.482781
2628,24,685,20,78,340,1147,2022-03-12 18:00:16.347052
2629,27,1057,25,84,346,1539,2022-03-12 18:00:19.615269
2630,42,1423,36,93,487,2081,2022-03-12 18:00:22.741511
2631,26,857,22,84,331,1320,2022-03-12 18:00:24.552729
2633,26,872,24,85,384,1391,2022-03-12 18:00:26.38547
2636,17,201,13,43,126,400,2022-03-12 18:00:29.620631
2639,16,206,12,40,120,394,2022-03-12 18:00:31.005346
2642,13,166,11,38,101,329,2022-03-12 18:00:32.268529
2645,25,808,26,76,340,1275,2022-03-12 18:00:33.667943
2646,31,1033,27,71,340,1502,2022-03-12 18:00:35.197035
2648,69,3374,38,100,730,4311,2022-03-12 18:00:38.826988
2650,34,1200,26,92,414,1766,2022-03-12 18:00:41.944785
2652,36,2185,28,85,418,2752,2022-03-12 18:00:44.233951
2653,26,1044,23,73,387,1553,2022-03-12 18:00:45.817635
2654,57,3720,73,104,566,4520,2022-03-12 18:00:47.698578
2655,70,6536,53,113,657,7429,2022-03-12 18:00:50.090196
2656,69,5501,45,111,565,6291,2022-03-12 18:00:50.40079
2657,44,3440,40,106,558,4188,2022-03-12 18:00:50.665382
2659,53,4263,41,99,482,4938,2022-03-12 18:00:53.413993
2660,37,2009,29,79,436,2590,2022-03-12 18:00:55.462733
2661,51,5350,85,101,529,6116,2022-03-12 18:00:58.922955
2662,50,3133,43,106,567,3899,2022-03-12 18:01:00.663695
2664,53,5140,44,104,516,5857,2022-03-12 18:01:02.646337
2665,74,5659,75,120,615,6543,2022-03-12 18:01:04.684356
2666,46,3228,40,102,511,3927,2022-03-12 18:01:05.0288
2668,48,3272,44,108,545,4017,2022-03-12 18:01:07.083046
2669,51,4305,47,100,536,5039,2022-03-12 18:01:09.558044
2670,61,8395,45,104,584,9189,2022-03-12 18:01:11.334432
2671,60,4210,42,106,544,4962,2022-03-12 18:01:12.836985
2673,92,5985,47,120,667,6911,2022-03-12 18:01:16.910102
2676,59,4675,40,105,496,5375,2022-03-12 18:01:21.700596
2677,49,5008,40,110,532,5739,2022-03-12 18:01:23.563186
2678,39,2485,71,94,495,3184,2022-03-12 18:01:25.028833
2679,84,571,57,105,726,1543,2022-03-12 18:01:26.592565
2680,362,21397,283,284,4359,26685,2022-03-12 18:01:27.789697
2682,68,1355,49,79,697,2248,2022-03-12 18:01:34.208979
2683,1425,18057,1065,808,12872,34227,2022-03-12 18:01:37.573502
2684,238,5444,187,285,1996,8150,2022-03-12 18:01:39.981086
2685,2187,59418,1414,971,24406,88396,2022-03-12 18:01:43.400009
2686,155,788,212,461,1205,2821,2022-03-12 18:01:45.521766
2687,45,277,41,118,304,785,2022-03-12 18:01:46.547782
2688,284,1345,262,291,2575,4757,2022-03-12 18:01:46.959921
2689,38,633,33,56,487,1247,2022-03-12 18:01:48.696913
2692,124,1622,96,121,1080,3043,2022-03-12 18:01:53.515939
2693,114,1322,79,114,1587,3216,2022-03-12 18:01:55.310149
2695,183,4570,132,143,3115,8143,2022-03-12 18:01:59.894035
2696,96,1487,61,63,1275,2982,2022-03-12 18:02:01.581456
2697,66,318,62,72,759,1277,2022-03-12 18:02:01.94743
2699,118,849,94,165,1070,2296,2022-03-12 18:02:04.572564
2700,63,548,55,83,520,1269,2022-03-12 18:02:06.127267
2701,15,86,9,66,88,264,2022-03-12 18:02:07.1817
2702,47,632,35,108,362,1184,2022-03-12 18:02:08.681695
2704,210,1151,248,269,2252,4130,2022-03-12 18:02:11.910785
2705,380,7002,272,551,1496,9701,2022-03-12 18:02:12.183786
2706,172,4185,116,245,730,5448,2022-03-12 18:02:14.799531
2708,12,74,9,76,94,265,2022-03-12 18:02:17.865631
2709,108,2393,90,228,612,3431,2022-03-12 18:02:19.999623
2710,27,283,8,68,192,578,2022-03-12 18:02:20.252623
2714,57,513,34,39,605,1248,2022-03-12 18:02:24.569072
2715,57,1179,32,52,1082,2402,2022-03-12 18:02:26.417748
2717,172,1290,162,134,1858,3616,2022-03-12 18:02:28.474898
2718,69,717,77,154,742,1759,2022-03-12 18:02:30.023478
2724,265,14100,127,137,3324,17953,2022-03-12 18:02:40.357116
2725,194,6294,113,107,2198,8906,2022-03-12 18:02:54.375702
2726,204,2352,86,92,2867,5601,2022-03-12 18:03:02.836485
2728,23,2119,7,27,200,2376,2022-03-12 18:03:09.225007
2729,86,3058,56,76,1530,4806,2022-03-12 18:03:11.299383
2730,356,5634,167,377,2372,8906,2022-03-12 18:03:13.61038
2731,36,318,26,62,452,894,2022-03-12 18:03:14.894888
2734,87,2810,63,77,1190,4227,2022-03-12 18:03:19.183937
2735,35,133,14,73,198,453,2022-03-12 18:03:20.433623
2736,66,1465,104,241,398,2274,2022-03-12 18:03:22.969968
2737,49,453,25,51,480,1058,2022-03-12 18:03:24.498968
2739,33,230,15,54,351,683,2022-03-12 18:03:27.402092
2740,105,371,57,137,746,1416,2022-03-12 18:03:29.026093
2741,50,231,20,74,343,718,2022-03-12 18:03:30.39934
2742,37,111,17,80,218,463,2022-03-12 18:03:31.774775
2743,138,5050,120,155,2186,7649,2022-03-12 18:03:34.166948
2744,589,7470,701,978,5807,15545,2022-03-12 18:03:34.523983
2746,252,13787,160,164,3813,18176,2022-03-12 18:03:40.666082
2747,576,3993,903,1398,3925,10795,2022-03-12 18:03:43.615065
2748,220,2905,198,339,1143,4805,2022-03-12 18:03:46.047565
2750,15,119,6,53,131,324,2022-03-12 18:03:48.726171
2751,288,5091,177,173,5902,11631,2022-03-12 18:03:51.377514
2752,617,28830,304,268,4207,34226,2022-03-12 18:03:51.660154
2753,274,4256,158,137,6074,10899,2022-03-12 18:03:54.217526
2754,108,1173,66,108,1408,2863,2022-03-12 18:03:55.91678
2759,6590,381935,2694,1246,79921,472386,2022-03-12 18:04:07.034302
2760,77,2205,44,74,1422,3822,2022-03-12 18:04:09.656774
2761,215,3680,88,128,3807,7918,2022-03-12 18:04:12.743943
2765,64,1348,32,77,677,2198,2022-03-12 18:04:17.187114
2766,159,1579,188,360,1266,3552,2022-03-12 18:04:19.095196
2770,77,1624,45,72,1153,2971,2022-03-12 18:04:27.812397
2771,106,327,121,174,1088,1816,2022-03-12 18:04:29.616401
2772,1897,10971,1739,1990,8474,25071,2022-03-12 18:04:32.57222
2775,1491,11665,781,1063,15856,30856,2022-03-12 18:04:35.588219
2776,102,1299,54,106,1161,2722,2022-03-12 18:04:37.615663
2778,54,629,38,64,549,1334,2022-03-12 18:04:40.684582
2779,66,1002,41,75,761,1945,2022-03-12 18:04:42.169764
2781,116,982,104,179,1374,2755,2022-03-12 18:04:45.632576
2782,297,7205,184,217,4191,12094,2022-03-12 18:04:47.949247
2783,64,729,51,99,590,1533,2022-03-12 18:04:49.937284
2784,130,4972,103,96,1800,7101,2022-03-12 18:04:52.125391
2786,264,996,159,247,1349,3015,2022-03-12 18:04:54.658905
2789,350,9105,379,1089,1363,12286,2022-03-12 18:05:02.428404
2791,48,1126,14,44,490,1722,2022-03-12 18:05:11.561993
2792,58,1729,33,64,845,2729,2022-03-12 18:05:15.618161
2793,92,1863,53,74,1482,3564,2022-03-12 18:05:18.807305
2796,50,2368,32,135,589,3174,2022-03-12 18:05:22.62056
2797,184,1909,96,93,1651,3933,2022-03-12 18:05:22.973564
2799,171,3605,176,303,1168,5423,2022-03-12 18:05:23.29456
2802,66,1301,47,83,808,2305,2022-03-12 18:05:23.942784
2810,141,3205,132,204,1366,5048,2022-03-12 18:05:27.838426
2811,78,3376,38,78,1173,4743,2022-03-12 18:05:29.993369
2815,45,1024,70,135,266,1540,2022-03-12 18:05:36.188337
2819,367,1619,292,285,2857,5420,2022-03-12 18:05:44.875764
2822,31,357,30,94,195,707,2022-03-12 18:05:49.862784
2823,70,1704,83,337,288,2482,2022-03-12 18:05:51.796728
2824,31,670,21,128,221,1071,2022-03-12 18:05:53.557319
2827,78,2717,109,374,494,3772,2022-03-12 18:05:58.204595
2828,626,5018,515,422,6177,12758,2022-03-12 18:05:58.478598
2829,598,10450,413,366,6212,18039,2022-03-12 18:06:01.581844
2830,29,382,23,88,339,861,2022-03-12 18:06:02.783585
2831,30,529,25,75,477,1136,2022-03-12 18:06:04.8167
2834,220,1536,249,273,2046,4324,2022-03-12 18:06:07.442451
2835,769,980,690,475,3783,6697,2022-03-12 18:06:07.743455
2836,76,2097,94,290,470,3027,2022-03-12 18:06:09.852924
2837,55,660,47,64,592,1418,2022-03-12 18:06:10.108044
2839,58,713,44,74,828,1717,2022-03-12 18:06:11.989042
2842,126,11338,113,128,2068,13773,2022-03-12 18:06:16.185782
2847,559,94377,254,277,4431,99898,2022-03-12 18:06:18.669561
2848,297,8794,187,144,5607,15029,2022-03-12 18:06:19.277563
2851,40,889,30,57,511,1527,2022-03-12 18:06:19.647569
2876,25,309,12,57,438,841,2022-03-12 18:06:20.998202
2881,75,858,48,56,1053,2090,2022-03-12 18:06:23.576332
2882,81,1043,106,271,512,2013,2022-03-12 18:06:25.439716
2884,167,5632,115,221,3183,9318,2022-03-12 18:06:27.789828
2885,83,428,78,145,599,1333,2022-03-12 18:06:28.044824
2892,53,974,83,221,419,1750,2022-03-12 18:06:39.176032
2895,106,590,80,108,2559,3443,2022-03-12 18:06:41.608919
2897,34,2115,26,46,778,2999,2022-03-12 18:06:43.348946
2899,778,55751,582,305,14376,71792,2022-03-12 18:06:46.276671
2903,988,3104,672,460,6522,11746,2022-03-12 18:06:49.815981
2906,39,360,14,48,384,845,2022-03-12 18:06:57.024203
2907,331,4466,475,627,1462,7361,2022-03-12 18:07:01.001335
2911,170,2756,130,123,2103,5282,2022-03-12 18:07:05.438549
2912,62,1406,77,195,341,2081,2022-03-12 18:07:07.400694
2915,48,656,29,49,741,1523,2022-03-12 18:07:10.834198
2916,66,416,44,75,464,1065,2022-03-12 18:07:12.364932
2920,138,2352,74,149,2249,4962,2022-03-12 18:07:14.415581
2923,11052,123027,10749,15783,40049,200660,2022-03-12 18:07:20.329795
2924,8979,123403,8020,6902,90540,237844,2022-03-12 18:07:23.405211
2927,4052,47947,3097,3459,26828,85383,2022-03-12 18:07:28.720163
2928,352,13590,268,293,6037,20540,2022-03-12 18:07:31.485461
2929,196,2048,173,146,1977,4540,2022-03-12 18:07:34.123626
2931,755,3102,720,925,8428,13930,2022-03-12 18:07:39.01164
2934,215,326,203,202,1910,2856,2022-03-12 18:07:41.481793
2937,195,11828,186,136,3744,16089,2022-03-12 18:07:44.095877
2938,305,1802,269,235,2195,4806,2022-03-12 18:07:46.747158
2947,69,3069,65,85,1239,4527,2022-03-12 18:07:50.403667
2948,65,2938,58,84,1270,4415,2022-03-12 18:07:52.541857
2951,730,39084,423,338,10299,50874,2022-03-12 18:07:57.691615
2953,90,10897,51,57,1690,12785,2022-03-12 18:08:03.951282
2961,798,98147,302,356,5153,104756,2022-03-12 18:08:10.406359
2962,332,38416,228,220,3696,42892,2022-03-12 18:08:12.909616
2963,6952,83642,5499,5525,59205,160823,2022-03-12 18:08:16.071997
2965,706,2330,728,901,4603,9268,2022-03-12 18:08:21.823807
2966,35146,430802,28707,18636,215475,728766,2022-03-12 18:08:25.275594
2967,247,2146,157,255,2253,5058,2022-03-12 18:08:28.151305
2969,437,29560,300,244,6659,37200,2022-03-12 18:08:30.633881
2970,1915,18017,1709,2513,10970,35124,2022-03-12 18:08:33.138248
2971,742,13898,590,375,6594,22199,2022-03-12 18:08:35.863521
2972,65,994,35,57,1010,2161,2022-03-12 18:08:38.373337
2973,95,2804,56,65,1488,4508,2022-03-12 18:08:40.271623
2974,72,1211,30,62,843,2218,2022-03-12 18:08:41.880778
2980,74,411,75,105,632,1297,2022-03-12 18:08:46.046198
2981,954,31940,347,537,15242,49020,2022-03-12 18:08:46.397201
2985,3248,31283,3153,3409,22017,63110,2022-03-12 18:08:49.431368
2986,4162,46879,4741,4847,23555,84184,2022-03-12 18:08:51.913318
2994,4173,119843,3132,2360,50633,180141,2022-03-12 18:08:57.280415
2999,49,1139,42,55,949,2234,2022-03-12 18:09:05.303245
3002,17450,158521,11088,7509,109066,303634,2022-03-12 18:09:14.371446
3005,172,2808,88,95,2193,5356,2022-03-12 18:09:21.246332
3006,496,1888,476,584,946,4390,2022-03-12 18:09:24.222842
3007,97,3482,54,134,1377,5144,2022-03-12 18:09:28.015279
3008,191,2563,225,425,1194,4598,2022-03-12 18:09:31.181167
3009,376,4591,329,526,3206,9028,2022-03-12 18:09:33.451706
3010,361,7039,386,510,2137,10433,2022-03-12 18:09:36.307299
3011,325,6841,199,221,3478,11064,2022-03-12 18:09:39.212973
3012,258,3861,221,419,1040,5799,2022-03-12 18:09:42.60073
3014,590,24541,309,201,8620,34261,2022-03-12 18:09:57.415277
3016,562,19339,340,254,9613,30108,2022-03-12 18:10:26.322914
3020,55,239,52,122,358,826,2022-03-12 18:10:30.384679
3021,166,613,134,183,1224,2320,2022-03-12 18:10:32.186831
3022,43,401,55,96,389,984,2022-03-12 18:10:33.696005
3024,265,1327,316,379,1943,4230,2022-03-12 18:10:37.623998
3025,83,813,33,54,769,1752,2022-03-12 18:10:37.915998
3026,78,1082,57,82,985,2284,2022-03-12 18:10:40.214016
3027,183,4775,122,101,2630,7811,2022-03-12 18:10:42.702455
3031,222,14821,204,188,3630,19065,2022-03-12 18:10:47.316086
3032,231,15921,197,168,3566,20083,2022-03-12 18:10:49.586087
3033,264,18832,194,173,3752,23215,2022-03-12 18:10:52.553227
3035,170,534,120,139,1694,2657,2022-03-12 18:10:52.812229
3036,108,782,99,161,847,1997,2022-03-12 18:10:53.077225
3038,135,1851,89,121,2217,4413,2022-03-12 18:10:55.234695
3043,101,3082,48,100,1523,4854,2022-03-12 18:10:55.509215
3060,245,2978,174,223,3621,7241,2022-03-12 18:10:59.876312
3061,81,797,88,102,1093,2161,2022-03-12 18:11:01.760936
3065,75,764,47,53,782,1721,2022-03-12 18:11:04.308936
3067,117,1662,77,102,1809,3767,2022-03-12 18:11:06.401323
3070,35,918,17,46,358,1374,2022-03-12 18:11:09.620618
3071,108,1562,72,92,1563,3397,2022-03-12 18:11:11.80569
3072,126,1469,73,90,1872,3630,2022-03-12 18:11:13.823839
3075,57,644,59,154,402,1316,2022-03-12 18:11:16.64353
3076,319,15141,281,206,5423,21370,2022-03-12 18:11:19.137382
3077,655,851,452,515,2889,5362,2022-03-12 18:11:21.7941
3079,380,1469,340,226,3244,5659,2022-03-12 18:11:23.877198
3080,139,7589,68,93,2258,10147,2022-03-12 18:11:26.221304
3081,282,3617,269,448,1622,6238,2022-03-12 18:11:28.195399
3085,799,12149,504,525,5592,19569,2022-03-12 18:11:30.838967
3086,726,15454,512,480,7398,24570,2022-03-12 18:11:33.03514
3088,650,13606,326,235,9646,24463,2022-03-12 18:11:38.215481
3090,448,18940,344,232,5557,25521,2022-03-12 18:11:43.845368
3091,4280,81927,3215,2258,36808,128488,2022-03-12 18:11:46.546511
3092,8255,183657,4436,8509,28071,232928,2022-03-12 18:11:46.865515
3095,132,1100,66,93,1274,2665,2022-03-12 18:11:48.986841
3099,133,500,90,121,1027,1871,2022-03-12 18:11:52.067205
3101,537,2551,538,691,3996,8313,2022-03-12 18:11:55.665674
3104,86,293,83,127,879,1468,2022-03-12 18:11:57.369674
3111,85,1966,39,63,1216,3369,2022-03-12 18:12:01.533337
3112,245,1207,142,270,1830,3694,2022-03-12 18:12:03.355337
3113,35,588,19,58,384,1084,2022-03-12 18:12:04.875501
3114,49,254,40,91,558,992,2022-03-12 18:12:06.390486
3115,122,1280,53,65,1997,3517,2022-03-12 18:12:08.256094
3116,89,1057,66,134,434,1780,2022-03-12 18:12:09.795212
3121,606,22593,443,363,4679,28684,2022-03-12 18:12:13.624379
3129,54,537,52,150,337,1130,2022-03-12 18:12:18.09797
3130,44,571,49,130,220,1014,2022-03-12 18:12:19.134598
3131,29,330,16,115,221,711,2022-03-12 18:12:19.544457
3132,42,510,30,80,393,1055,2022-03-12 18:12:21.071035
3135,289,4141,96,88,4010,8624,2022-03-12 18:12:23.652823
3136,78,1691,99,169,601,2638,2022-03-12 18:12:23.897848
3137,209,2088,191,301,1341,4130,2022-03-12 18:12:25.761716
3146,137,683,130,154,2068,3172,2022-03-12 18:12:28.372105
3147,44,591,17,43,455,1150,2022-03-12 18:12:30.151395
3152,90,1093,27,48,1303,2561,2022-03-12 18:12:34.135611
3153,53,675,36,85,688,1537,2022-03-12 18:12:35.676012
3155,20,338,9,46,220,633,2022-03-12 18:12:39.334376
3159,204,434,232,218,1556,2644,2022-03-12 18:12:42.086407
3164,34,139,20,59,222,474,2022-03-12 18:12:45.468578
3166,1122,15120,1115,1795,8359,27511,2022-03-12 18:12:48.444749
3174,219,11336,239,161,2877,14832,2022-03-12 18:12:57.626111
3175,44,623,16,56,537,1276,2022-03-12 18:13:20.570553
3176,93,249,59,97,1089,1587,2022-03-12 18:13:39.947893
3183,38,412,17,47,494,1008,2022-03-12 18:14:01.934848
3186,78,2113,40,75,1187,3493,2022-03-12 18:14:26.482556
3192,79,880,38,65,1098,2160,2022-03-12 18:14:30.622637
3193,169,1255,176,254,1194,3048,2022-03-12 18:14:32.443693
3194,73,758,55,136,508,1530,2022-03-12 18:14:34.487851
3196,98,951,57,152,1132,2390,2022-03-12 18:14:34.931851
3199,166,2530,162,274,1947,5079,2022-03-12 18:14:37.297615
3201,32,344,32,109,246,763,2022-03-12 18:14:38.917699
3202,56,1462,89,245,654,2506,2022-03-12 18:14:40.888641
3203,38,1182,29,70,470,1789,2022-03-12 18:14:42.770233
3205,227,966,153,220,1816,3382,2022-03-12 18:14:44.785356
3213,98,692,82,161,1147,2180,2022-03-12 18:14:50.579325
3214,31,606,16,41,388,1082,2022-03-12 18:14:52.200439
3218,130,2746,124,105,1778,4883,2022-03-12 18:14:56.621052
3219,95,4616,98,61,1575,6445,2022-03-12 18:14:58.553049
3221,278,16611,287,238,6192,23606,2022-03-12 18:15:01.742152
3223,111,1907,105,108,2054,4285,2022-03-12 18:15:05.562503
3226,1347,49931,639,566,7007,59490,2022-03-12 18:15:09.691039
3227,110,1545,68,77,1546,3346,2022-03-12 18:15:11.59362
3229,5285,67511,3014,3462,29853,109125,2022-03-12 18:15:14.726743
3230,4935,63452,3304,5020,34386,111097,2022-03-12 18:15:18.301727
3231,1961,32533,2283,3093,17055,56925,2022-03-12 18:15:21.163574
3234,144,2742,93,112,1706,4797,2022-03-12 18:15:23.844338
3235,61,289,44,91,556,1041,2022-03-12 18:15:25.30748
3243,17,88,6,64,96,271,2022-03-12 18:15:26.50413
3248,106,1210,133,107,1158,2714,2022-03-12 18:15:32.557509
3251,35,139,19,62,220,475,2022-03-12 18:15:34.264502
3252,31,420,11,51,293,806,2022-03-12 18:15:35.981049
3259,83,519,56,90,862,1610,2022-03-12 18:15:40.461565
3264,66,460,40,75,668,1309,2022-03-12 18:15:40.883569
3269,547,20682,401,456,8702,30788,2022-03-12 18:15:50.625152
3270,678,10531,636,860,5617,18322,2022-03-12 18:15:54.121302
3271,129,1767,114,193,545,2748,2022-03-12 18:15:56.467004
3273,45,544,22,83,505,1199,2022-03-12 18:16:01.416849
3275,27,315,20,68,329,759,2022-03-12 18:16:04.215993
3276,28,307,17,68,335,755,2022-03-12 18:16:05.835072
3277,29,257,14,71,313,684,2022-03-12 18:16:06.861156
3279,31,260,17,67,297,672,2022-03-12 18:16:09.174673
3280,29,410,22,73,349,883,2022-03-12 18:16:10.29879
3281,130,1328,85,162,1117,2822,2022-03-12 18:16:14.022096
3288,372,5501,398,264,3472,10007,2022-03-12 18:16:21.314289
3290,59,207,45,103,485,899,2022-03-12 18:16:22.814834
3292,106,2636,121,86,720,3669,2022-03-12 18:16:28.485475
3294,57,231,46,96,395,825,2022-03-12 18:16:37.299768
3297,4280,34464,2760,2727,68170,112401,2022-03-12 18:16:49.002395
3299,2957,58471,2611,4141,22807,90987,2022-03-12 18:16:52.227522
3305,204,1241,164,173,1359,3141,2022-03-12 18:16:54.107687
3312,691,8538,924,1458,4597,16208,2022-03-12 18:16:59.926602
3315,64,239,59,95,610,1067,2022-03-12 18:17:03.736464
3317,74,398,68,109,510,1159,2022-03-12 18:17:05.297847
3318,1052,17831,881,780,6889,27433,2022-03-12 18:17:07.625871
3320,51,857,39,52,718,1717,2022-03-12 18:17:09.135968
3322,2028,13534,1924,1950,11176,30612,2022-03-12 18:17:11.516769
3323,691,16763,309,253,8581,26597,2022-03-12 18:17:14.375361
3325,167,676,126,153,1073,2195,2022-03-12 18:17:16.030707
3327,318,1169,254,169,3073,4983,2022-03-12 18:17:18.923672
3332,911,1349,623,364,4911,8158,2022-03-12 18:17:24.416385
3335,300,864,263,232,3442,5101,2022-03-12 18:17:26.805736
3336,65,1526,52,73,1402,3118,2022-03-12 18:17:27.060708
3342,8761,81842,5812,5092,65710,167217,2022-03-12 18:17:29.865128
3345,176,920,116,157,1229,2598,2022-03-12 18:17:30.213296
3354,361,20924,307,215,5693,27500,2022-03-12 18:17:35.642755
3356,170,1096,244,324,1578,3412,2022-03-12 18:17:39.417847
3358,3530,44575,2731,2645,31773,85254,2022-03-12 18:17:42.853816
3361,61,334,36,121,359,911,2022-03-12 18:17:46.364239
3362,34,143,17,54,515,763,2022-03-12 18:17:48.387847
3363,1665,5678,1528,2084,13370,24325,2022-03-12 18:17:50.675538
3366,4689,26682,4723,6077,34660,76831,2022-03-12 18:17:53.234739
3367,74,999,37,54,1277,2441,2022-03-12 18:17:55.457462
3371,884,9526,667,310,9639,21026,2022-03-12 18:18:00.901489
3372,17,70,5,60,129,281,2022-03-12 18:18:02.147522
3375,1272,43186,408,640,5058,50564,2022-03-12 18:18:04.750602
3388,178,861,153,202,1440,2834,2022-03-12 18:18:06.957516
3389,464,19116,433,660,5591,26264,2022-03-12 18:18:09.612606
3390,155,1188,125,215,1585,3268,2022-03-12 18:18:11.745834
3391,335,399,257,365,1803,3159,2022-03-12 18:18:13.731222
3392,272,18042,161,156,3379,22010,2022-03-12 18:18:16.932064
3398,70,913,36,69,862,1950,2022-03-12 18:18:19.097174
3399,164,561,151,174,1189,2239,2022-03-12 18:18:21.26119
3407,3959,33570,3752,6541,30576,78398,2022-03-12 18:18:29.118206
3410,122,2234,115,112,1164,3747,2022-03-12 18:18:31.287225
3414,21,96,10,76,123,326,2022-03-12 18:18:32.490204
3417,202,2632,180,264,1853,5131,2022-03-12 18:18:35.256477
3418,164,583,119,157,1193,2216,2022-03-12 18:18:37.107697
3419,316,7938,199,128,3061,11642,2022-03-12 18:18:41.994944
3420,3350,36252,2912,2554,39566,84634,2022-03-12 18:18:42.969944
3421,142,3354,84,91,2047,5718,2022-03-12 18:18:45.346987
3432,86,670,75,126,609,1566,2022-03-12 18:18:53.854951
3433,48,296,44,99,304,791,2022-03-12 18:18:55.581269
3435,59,427,48,117,590,1241,2022-03-12 18:18:58.819587
3436,37,305,37,111,212,702,2022-03-12 18:19:00.193041
3446,310,29837,115,119,2978,33359,2022-03-12 18:19:07.945567
3447,178,6950,167,162,4466,11923,2022-03-12 18:19:11.304155
3451,24,151,10,58,162,405,2022-03-12 18:19:16.624378
3457,18491,421705,12289,28805,68653,549943,2022-03-12 18:19:25.101736
3460,70,757,72,134,512,1545,2022-03-12 18:19:28.586577
3461,95,926,78,95,983,2177,2022-03-12 18:19:31.088101
3462,62,1133,37,48,957,2237,2022-03-12 18:19:32.907234
3463,66,853,48,127,827,1921,2022-03-12 18:19:34.521237
3464,1993,20723,1372,2378,12035,38501,2022-03-12 18:19:37.595189
3465,51,284,27,54,620,1036,2022-03-12 18:19:39.316327
3466,505,24706,335,174,9465,35185,2022-03-12 18:19:41.771026
3467,4670,84148,2952,3960,30357,126087,2022-03-12 18:19:44.369154
3468,165,6312,125,130,2123,8855,2022-03-12 18:19:46.387039
3470,13440,228338,10229,15819,68515,336341,2022-03-12 18:19:49.560199
3472,45,1278,24,67,620,2034,2022-03-12 18:19:51.248432
3473,24,1243,12,59,301,1639,2022-03-12 18:19:53.107562
3475,88,3250,34,53,1619,5044,2022-03-12 18:19:56.833917
3481,62,1398,39,58,555,2112,2022-03-12 18:19:59.60568
3483,73,1591,64,74,1245,3047,2022-03-12 18:20:05.58203
3485,324,13027,353,248,5377,19329,2022-03-12 18:20:11.143234
3493,217,3833,164,180,1630,6024,2022-03-12 18:20:17.697291
3496,38,344,16,47,342,787,2022-03-12 18:20:19.130287
3498,36,529,29,54,448,1096,2022-03-12 18:20:23.283091
3499,39,555,44,133,337,1108,2022-03-12 18:20:24.819224
3501,224,1888,200,178,2293,4783,2022-03-12 18:20:26.373317
3503,10937,144154,6608,13104,53518,228321,2022-03-12 18:20:26.827318
3505,105,586,90,131,999,1911,2022-03-12 18:20:27.078321
3509,111,1892,38,55,1267,3363,2022-03-12 18:20:31.61588
3513,34,458,20,44,434,990,2022-03-12 18:20:39.751953
3514,44,159,26,99,634,962,2022-03-12 18:20:41.301774
3515,631,30857,404,257,5035,37184,2022-03-12 18:20:45.206945
3516,19,308,18,60,206,611,2022-03-12 18:20:46.568495
3517,16,156,7,49,120,348,2022-03-12 18:20:47.678104
3518,62,1560,35,43,1039,2739,2022-03-12 18:20:49.592079
3519,70,617,57,133,368,1245,2022-03-12 18:20:51.426083
3533,57,404,49,95,807,1412,2022-03-12 18:20:58.049048
3535,112,2009,69,124,1104,3418,2022-03-12 18:21:00.202007
3545,1056,5718,1176,1246,5851,15047,2022-03-12 18:21:03.38155
3546,52,412,35,85,414,998,2022-03-12 18:21:04.990252
3547,40,514,27,61,472,1114,2022-03-12 18:21:07.100966
3561,141,1076,103,172,769,2261,2022-03-12 18:21:10.281265
3565,63,581,48,84,400,1176,2022-03-12 18:21:11.772348
3570,70,599,63,112,1771,2615,2022-03-12 18:21:15.941832
3572,7034,76981,5650,4710,42933,137308,2022-03-12 18:21:21.670929
3574,823,13525,579,444,10120,25491,2022-03-12 18:21:27.512461
3575,13,67,6,58,109,253,2022-03-12 18:21:28.821589
3577,1845,11330,1909,2266,10082,27432,2022-03-12 18:21:34.627446
3579,470,1843,429,380,3705,6827,2022-03-12 18:21:36.836157
3588,104792,876825,89827,78408,283866,1433718,2022-03-12 18:21:37.101131
35130,7,18,1,40,38,104,2022-03-12 19:33:27.803579
3593,791,12540,454,323,5301,19409,2022-03-12 18:21:39.541131
3594,5505,34863,4241,5377,24342,74328,2022-03-12 18:21:42.473254
3595,126,854,71,80,1278,2409,2022-03-12 18:21:42.787226
3596,35,478,15,47,336,911,2022-03-12 18:21:45.713954
3597,57,1405,28,64,710,2264,2022-03-12 18:21:47.567329
3600,82,785,47,75,1144,2133,2022-03-12 18:21:50.999453
3604,1168,19012,901,609,7576,29266,2022-03-12 18:21:58.462623
3613,2921,31156,2221,2554,28656,67508,2022-03-12 18:22:04.53396
3614,928,6716,711,744,8254,17353,2022-03-12 18:22:07.083227
3615,1766,18671,1526,2251,11088,35302,2022-03-12 18:22:09.971328
3618,152,4025,238,168,1402,5985,2022-03-12 18:22:12.725139
3619,75,565,64,132,861,1697,2022-03-12 18:22:14.748811
3625,170,3518,73,116,2876,6753,2022-03-12 18:22:19.632304
3626,229,6084,173,190,3653,10329,2022-03-12 18:22:21.929646
3627,698,17775,581,625,8680,28359,2022-03-12 18:22:24.206528
3631,70,940,50,157,512,1729,2022-03-12 18:22:26.946392
3637,69,295,36,100,369,869,2022-03-12 18:22:28.544487
3638,231,1376,191,249,896,2943,2022-03-12 18:22:30.750188
3641,250,4534,157,241,2455,7637,2022-03-12 18:22:33.507284
3642,200,2382,72,112,2375,5141,2022-03-12 18:22:35.326201
3652,4724,124962,2784,2086,42783,177339,2022-03-12 18:22:40.515525
3655,9572,75190,9509,10441,52418,157130,2022-03-12 18:22:48.086581
3656,3612,24856,3266,4811,19675,56220,2022-03-12 18:22:48.542617
3659,22,273,18,52,235,600,2022-03-12 18:22:50.133674
3660,185,744,131,156,1292,2508,2022-03-12 18:22:52.158836
3661,46,756,20,41,563,1426,2022-03-12 18:22:53.553935
3665,810,8061,638,292,8019,17820,2022-03-12 18:22:57.969809
3667,7225,80914,4956,9518,55252,157865,2022-03-12 18:23:00.620526
3668,569,2413,621,986,3904,8493,2022-03-12 18:23:02.664873
3669,40,671,23,85,401,1220,2022-03-12 18:23:04.24687
3671,48,721,41,57,651,1518,2022-03-12 18:23:10.3887
3672,68,1431,74,159,688,2420,2022-03-12 18:23:12.836355
3673,1827,12711,1554,1517,14639,32248,2022-03-12 18:23:15.812139
3676,112,381,108,124,965,1690,2022-03-12 18:23:20.897094
3683,37,265,21,106,184,613,2022-03-12 18:23:22.458781
3684,41,1762,29,35,919,2786,2022-03-12 18:23:24.12878
3685,21,2597,11,53,329,3011,2022-03-12 18:23:25.713987
3686,110,2988,101,87,1264,4550,2022-03-12 18:23:27.726478
3689,47,362,30,86,305,830,2022-03-12 18:23:29.076639
3691,77,310,59,90,614,1150,2022-03-12 18:23:30.984397
3692,448,4902,349,318,3027,9044,2022-03-12 18:23:33.40262
3701,6527,44433,4597,3181,73079,131817,2022-03-12 18:23:36.299424
3704,99,231,87,206,341,964,2022-03-12 18:23:41.003705
3710,565,4097,596,694,4824,10776,2022-03-12 18:23:43.876898
3713,4019,50333,3685,2638,35110,95785,2022-03-12 18:23:52.147258
3720,39,1043,17,62,383,1544,2022-03-12 18:23:53.611332
3723,35,409,30,106,188,768,2022-03-12 18:23:55.232063
3726,45,673,20,46,497,1281,2022-03-12 18:23:58.807203
3727,78,6075,54,121,673,7001,2022-03-12 18:24:01.698849
3731,10159,171562,6874,11526,57771,257892,2022-03-12 18:24:02.677384
3738,53,4153,39,114,327,4686,2022-03-12 18:24:14.313699
3743,27,1525,14,53,314,1933,2022-03-12 18:24:16.292105
3744,69,3287,45,100,758,4259,2022-03-12 18:24:18.441258
3745,70,6399,36,111,606,7222,2022-03-12 18:24:21.144945
3750,634,11549,420,458,7010,20071,2022-03-12 18:24:23.29149
3751,41,1164,22,52,661,1940,2022-03-12 18:24:24.866184
3752,34,1213,19,64,343,1673,2022-03-12 18:24:30.827324
3757,42,806,17,53,390,1308,2022-03-12 18:24:37.418537
3758,19,361,6,55,199,640,2022-03-12 18:24:38.888619
3759,616,40472,448,451,8454,50441,2022-03-12 18:24:41.748918
3760,45,750,27,55,824,1701,2022-03-12 18:24:43.670513
3761,77,1936,88,182,419,2702,2022-03-12 18:24:45.649854
3762,45,382,25,43,429,924,2022-03-12 18:24:45.904852
3765,59,558,48,122,514,1301,2022-03-12 18:24:52.412944
3769,28,159,12,70,226,495,2022-03-12 18:24:59.475942
3782,2914,172288,1471,532,39801,217006,2022-03-12 18:25:07.979356
3783,2728,162406,1294,507,39137,206072,2022-03-12 18:25:11.243558
3784,6267,364641,2459,1043,79506,453916,2022-03-12 18:25:14.724691
3785,4673,281057,2046,808,76140,364724,2022-03-12 18:25:18.038943
3786,3635,109541,1160,371,160504,275211,2022-03-12 18:25:20.779752
3787,90,2019,51,59,1341,3560,2022-03-12 18:25:22.672906
46241,0,0,0,0,0,0,2022-03-12 20:13:38.450022
46246,0,0,0,0,0,0,2022-03-12 20:13:39.784135
46249,0,0,0,0,0,0,2022-03-12 20:13:40.959032
46253,0,0,0,0,0,0,2022-03-12 20:13:42.025805
3791,555,36750,342,261,6889,44797,2022-03-12 18:25:25.198788
3799,22,868,6,50,177,1123,2022-03-12 18:25:28.415401
3800,95,781,83,172,653,1784,2022-03-12 18:25:29.879495
3806,78,397,63,139,613,1290,2022-03-12 18:25:34.638831
3807,170,1109,133,161,1336,2909,2022-03-12 18:25:36.776052
3808,54,235,35,92,438,854,2022-03-12 18:25:38.058331
3810,49,723,47,132,403,1354,2022-03-12 18:25:42.245425
3811,94,631,105,154,726,1710,2022-03-12 18:25:43.984153
3812,29,420,24,101,183,757,2022-03-12 18:25:45.527157
3817,30,309,13,40,333,725,2022-03-12 18:25:48.672269
3818,20,1505,10,25,234,1794,2022-03-12 18:25:50.186869
3819,112,386,62,145,790,1495,2022-03-12 18:25:51.777218
3820,43,2185,19,38,719,3004,2022-03-12 18:25:53.841332
3822,42,182,19,86,381,710,2022-03-12 18:25:57.133733
3823,27,443,17,102,218,807,2022-03-12 18:25:58.633738
3827,75,413,56,116,682,1342,2022-03-12 18:26:01.542311
3829,161,2815,94,115,3957,7142,2022-03-12 18:26:05.337702
3832,31,247,22,39,324,663,2022-03-12 18:26:06.812703
3838,49,340,36,82,408,915,2022-03-12 18:26:12.998448
3839,50,292,24,76,415,857,2022-03-12 18:26:15.319251
3840,837,5833,833,1495,6967,15965,2022-03-12 18:26:24.554852
3841,5841,25280,6405,5144,16571,59241,2022-03-12 18:26:34.540695
3842,48,1015,36,64,904,2067,2022-03-12 18:26:36.044243
3843,42,840,28,84,466,1460,2022-03-12 18:26:37.734584
3846,39,163,24,85,248,559,2022-03-12 18:26:40.82636
3847,47,1048,20,74,589,1778,2022-03-12 18:26:42.621726
3848,637,45934,469,391,8547,55978,2022-03-12 18:26:45.036948
3849,50,890,35,49,735,1759,2022-03-12 18:26:47.052098
3859,1091,3920,980,1090,10731,17812,2022-03-12 18:26:53.611083
3861,483,11864,397,311,5911,18966,2022-03-12 18:26:53.96608
3863,31,579,26,51,272,959,2022-03-12 18:26:55.444055
3868,93,1178,75,105,1777,3228,2022-03-12 18:27:03.103532
3873,51,332,46,88,449,966,2022-03-12 18:27:05.388762
3874,121,878,89,156,687,1931,2022-03-12 18:27:07.198085
3875,54,688,54,116,447,1359,2022-03-12 18:27:08.656177
3876,43,282,35,87,454,901,2022-03-12 18:27:10.17428
3879,67,342,38,101,492,1040,2022-03-12 18:27:13.610342
3880,64,300,39,95,578,1076,2022-03-12 18:27:15.379977
3881,67,363,49,108,541,1128,2022-03-12 18:27:16.727588
3882,134,2114,54,70,1497,3869,2022-03-12 18:27:18.834773
3884,42,536,37,39,429,1083,2022-03-12 18:27:19.160772
3885,40,196,31,82,486,835,2022-03-12 18:27:19.486279
3886,82,3176,42,92,1213,4605,2022-03-12 18:27:19.828278
3898,107,2203,68,101,1465,3944,2022-03-12 18:27:22.847428
3901,2158,134865,1625,954,26736,166338,2022-03-12 18:27:28.348576
3906,79,1023,35,63,1926,3126,2022-03-12 18:27:32.668951
3907,641,5702,426,413,6348,13530,2022-03-12 18:27:35.740037
3909,33,202,30,94,305,664,2022-03-12 18:27:36.936093
3913,141,1090,84,75,1338,2728,2022-03-12 18:27:38.899159
3915,109,689,110,236,1032,2176,2022-03-12 18:27:42.918221
3927,4568,110749,2527,1606,17979,137429,2022-03-12 18:27:46.61249
3929,30,916,13,59,216,1234,2022-03-12 18:27:48.51461
3931,450,20080,215,239,5418,26402,2022-03-12 18:27:52.990196
3932,66,330,63,111,480,1050,2022-03-12 18:27:54.728514
3936,36,504,24,96,386,1046,2022-03-12 18:27:58.144821
3937,21,167,11,86,107,392,2022-03-12 18:27:59.358826
3946,77,1859,65,75,1524,3600,2022-03-12 18:28:01.188888
3954,107,5327,111,88,2528,8161,2022-03-12 18:28:07.054262
3956,627,30727,560,402,8230,40546,2022-03-12 18:28:07.431259
3962,386,6477,407,811,4005,12086,2022-03-12 18:28:12.571963
3963,108,2093,118,132,1998,4449,2022-03-12 18:28:14.503751
3964,100,1977,105,131,1929,4242,2022-03-12 18:28:16.414558
3965,237,21466,219,121,5123,27166,2022-03-12 18:28:21.03479
3969,58,344,40,112,429,983,2022-03-12 18:28:26.472305
3972,9073,81547,8665,10363,13136,122784,2022-03-12 18:28:26.943308
3973,14,89,7,49,125,284,2022-03-12 18:28:28.426907
3975,45,161,32,112,261,611,2022-03-12 18:28:32.838704
3977,76,1558,80,78,1236,3028,2022-03-12 18:28:34.505513
3989,91,1107,39,39,1195,2471,2022-03-12 18:28:36.374223
3990,33,1509,19,62,357,1980,2022-03-12 18:28:38.040361
3991,195,1947,140,127,2486,4895,2022-03-12 18:28:39.999108
4003,483,1862,219,209,3843,6616,2022-03-12 18:28:42.383669
4012,106,5288,35,83,1279,6791,2022-03-12 18:28:45.107768
4013,42,394,31,96,270,833,2022-03-12 18:28:46.628064
4021,1603,18008,1435,2107,11789,34942,2022-03-12 18:28:52.704107
4024,68,736,47,111,497,1459,2022-03-12 18:28:56.391815
4026,397,73923,247,251,4089,78907,2022-03-12 18:29:00.97579
4028,1184,23335,1226,1133,7880,34758,2022-03-12 18:29:03.70703
4033,194,5201,141,160,3646,9342,2022-03-12 18:29:08.984409
4037,840,24794,543,333,16530,43040,2022-03-12 18:29:12.765698
4039,3497,9862,2798,2554,19351,38062,2022-03-12 18:29:16.579357
4042,107,1607,59,69,1078,2920,2022-03-12 18:29:19.066802
4044,91,524,90,165,781,1651,2022-03-12 18:29:20.919927
4049,39,383,34,113,292,861,2022-03-12 18:29:22.78329
4050,160,1499,149,202,1074,3084,2022-03-12 18:29:25.197524
4053,664,27022,380,347,4873,33286,2022-03-12 18:29:35.947792
4058,53,936,39,52,739,1819,2022-03-12 18:29:43.720583
4059,2228,255228,1022,769,24951,284198,2022-03-12 18:29:47.165472
4062,151,529,134,157,1212,2183,2022-03-12 18:29:53.505381
4063,15275,255277,8069,12654,78221,369496,2022-03-12 18:29:56.673118
4067,120,441,81,146,1478,2266,2022-03-12 18:30:02.448355
4070,45,1140,47,76,802,2110,2022-03-12 18:30:06.23055
4071,69,1428,61,79,1150,2787,2022-03-12 18:30:06.724679
4073,55,481,41,95,369,1041,2022-03-12 18:30:08.381743
4074,36,605,11,69,548,1269,2022-03-12 18:30:08.632745
4078,123,4119,89,66,1783,6180,2022-03-12 18:30:12.769175
4081,28923,201700,19627,10844,211968,473062,2022-03-12 18:30:18.456359
4083,51,372,51,105,392,971,2022-03-12 18:30:21.916557
4085,44,322,31,56,802,1255,2022-03-12 18:30:24.157685
4086,63,1616,74,179,413,2345,2022-03-12 18:30:24.491294
4087,13271,59761,10684,6062,83979,173757,2022-03-12 18:30:28.856699
4095,67,2799,47,49,1654,4616,2022-03-12 18:30:36.800046
4096,13,177,6,35,96,327,2022-03-12 18:30:38.216046
4099,21,774,7,44,211,1057,2022-03-12 18:30:41.493901
4101,73,133,58,93,542,899,2022-03-12 18:30:45.138658
4103,48,1138,17,51,521,1775,2022-03-12 18:30:51.041261
4104,21,312,16,63,166,578,2022-03-12 18:30:58.612923
4106,1907,90262,814,363,29930,123276,2022-03-12 18:31:05.759769
4107,2546,103808,1334,820,37936,146444,2022-03-12 18:31:08.452912
4113,70,529,75,153,791,1618,2022-03-12 18:31:10.136997
4119,136,340,89,115,1066,1746,2022-03-12 18:31:14.718371
4124,86,2708,74,111,1422,4401,2022-03-12 18:31:18.284326
4129,18,381,15,44,264,722,2022-03-12 18:31:21.280924
4131,35,147,9,48,280,519,2022-03-12 18:31:27.297652
4132,41,536,29,119,497,1222,2022-03-12 18:31:27.59865
4134,943,47240,520,471,10604,59778,2022-03-12 18:31:28.245647
4136,1024,7028,884,1177,5973,16086,2022-03-12 18:31:30.335606
4138,36,2288,23,66,386,2799,2022-03-12 18:31:32.398976
4149,107,1430,62,86,904,2589,2022-03-12 18:31:37.075893
4150,47,1398,34,58,805,2342,2022-03-12 18:31:39.554983
4151,4041,28909,2843,3735,23756,63284,2022-03-12 18:31:42.150661
4155,2967,181523,877,637,20028,206032,2022-03-12 18:31:44.292799
4158,28,2076,18,37,647,2806,2022-03-12 18:31:49.853694
4162,108,2745,80,52,1461,4446,2022-03-12 18:31:52.407366
4163,1186,37667,646,367,10005,49871,2022-03-12 18:31:55.938021
4166,235,3344,144,120,2424,6267,2022-03-12 18:31:58.073184
4173,159,1826,216,188,1605,3994,2022-03-12 18:32:01.842628
4176,57,1188,33,62,938,2278,2022-03-12 18:32:03.63275
4177,7334,65798,5651,4744,44866,128393,2022-03-12 18:32:07.319256
4181,33950,726538,18942,15054,264660,1059144,2022-03-12 18:32:07.498256
4182,1352,107807,746,427,20410,130742,2022-03-12 18:32:16.048875
4187,63,921,32,48,896,1960,2022-03-12 18:32:22.001526
4188,1466,15274,744,528,11331,29343,2022-03-12 18:32:24.870128
4190,45,681,29,54,574,1383,2022-03-12 18:32:27.162501
4195,771,22799,427,353,5837,30187,2022-03-12 18:32:30.760193
46257,0,0,0,0,0,0,2022-03-12 20:13:43.270828
46260,0,0,0,0,0,0,2022-03-12 20:13:44.751428
46266,0,0,0,0,0,0,2022-03-12 20:13:46.894888
46270,0,0,0,0,0,0,2022-03-12 20:13:48.172724
4197,670,9970,618,802,3926,15986,2022-03-12 18:32:37.302391
4199,64,562,64,125,598,1413,2022-03-12 18:32:42.648665
4200,279,3339,199,125,2460,6402,2022-03-12 18:32:44.950596
4201,49,340,28,47,801,1265,2022-03-12 18:32:46.662034
4205,191,8975,142,85,2437,11830,2022-03-12 18:32:50.978276
4208,95,815,81,159,667,1817,2022-03-12 18:32:52.75837
4209,354,2536,326,480,1825,5521,2022-03-12 18:32:53.011366
4210,67,705,27,71,991,1861,2022-03-12 18:32:55.177876
4213,98,1316,67,58,1135,2674,2022-03-12 18:32:59.052698
4220,11,152,7,41,166,377,2022-03-12 18:33:04.92913
4232,294,7406,195,192,3105,11192,2022-03-12 18:33:09.153993
4242,66,239,62,87,589,1043,2022-03-12 18:33:12.564273
4244,60,238,51,77,615,1041,2022-03-12 18:33:13.991956
4246,666,29493,523,445,12079,43206,2022-03-12 18:33:16.611566
4250,37,868,11,56,274,1246,2022-03-12 18:33:18.157681
4252,62,653,36,48,602,1401,2022-03-12 18:33:21.332812
4262,2363,23413,1739,2538,14775,44828,2022-03-12 18:33:23.892167
4266,76,364,38,100,980,1558,2022-03-12 18:33:26.466397
4282,4015,152372,1852,789,55633,214661,2022-03-12 18:33:29.557889
4298,62,431,35,71,644,1243,2022-03-12 18:33:33.782099
4312,202,4623,119,106,2556,7606,2022-03-12 18:33:39.050731
4314,20,272,14,52,199,557,2022-03-12 18:33:40.410431
4316,19,238,12,50,199,518,2022-03-12 18:33:41.945518
4320,139,4987,111,98,2305,7640,2022-03-12 18:33:46.802537
4331,62,210,43,193,188,696,2022-03-12 18:33:48.272644
4332,35,298,35,94,356,818,2022-03-12 18:33:49.774338
4334,2399,15058,2477,5601,11274,36809,2022-03-12 18:33:52.646171
4353,131,4854,105,181,1772,7043,2022-03-12 18:33:55.647864
4361,206,3031,181,115,2467,6000,2022-03-12 18:33:58.070183
4371,53,632,25,59,512,1281,2022-03-12 18:34:02.150996
4375,112,1519,129,291,455,2506,2022-03-12 18:34:04.50264
4382,15427,346891,10723,9975,94835,477851,2022-03-12 18:34:06.970584
4383,37,838,28,57,503,1463,2022-03-12 18:34:08.952661
4385,59,1264,41,76,679,2119,2022-03-12 18:34:11.402611
4387,67,1295,44,81,591,2078,2022-03-12 18:34:13.715011
4389,96,1848,54,127,996,3121,2022-03-12 18:34:15.678625
4390,28,932,8,58,183,1209,2022-03-12 18:34:17.606286
4391,38,1181,17,52,221,1509,2022-03-12 18:34:19.606
4392,22,749,7,55,168,1001,2022-03-12 18:34:20.764786
4393,30,1419,15,51,202,1717,2022-03-12 18:34:22.853995
4394,25,771,10,52,144,1002,2022-03-12 18:34:24.2451
4395,21,642,9,56,127,855,2022-03-12 18:34:25.385255
4396,15,909,5,40,116,1085,2022-03-12 18:34:26.948499
4398,38,2302,21,68,732,3161,2022-03-12 18:34:28.835137
4418,22,823,23,41,317,1226,2022-03-12 18:34:39.483384
4420,25,674,6,50,296,1051,2022-03-12 18:34:42.908441
4427,83,329,76,118,633,1239,2022-03-12 18:34:45.411158
4437,2191,208377,831,610,18123,230132,2022-03-12 18:34:45.726157
4439,92,613,61,148,774,1688,2022-03-12 18:34:46.32731
4440,27,185,11,61,290,574,2022-03-12 18:34:46.645318
4454,211,8289,138,145,3243,12026,2022-03-12 18:34:50.027839
4458,18,2214,18,43,504,2797,2022-03-12 18:34:52.293496
4460,121,5706,48,71,2255,8201,2022-03-12 18:34:58.854027
4461,32,1435,13,27,502,2009,2022-03-12 18:34:59.284027
4462,18,1242,5,42,106,1413,2022-03-12 18:35:00.654159
4467,26,1640,10,35,390,2101,2022-03-12 18:35:00.987156
4469,163,6360,167,215,3336,10241,2022-03-12 18:35:02.734163
4470,35,157,26,71,348,637,2022-03-12 18:35:04.276303
4472,1393,100643,822,575,20336,123769,2022-03-12 18:35:08.44234
4475,52,1791,23,42,942,2850,2022-03-12 18:35:08.808341
4476,140,2176,92,91,1795,4294,2022-03-12 18:35:11.752731
4477,2829,90683,2131,1243,18995,115881,2022-03-12 18:35:14.692993
4483,1289,7725,1106,979,13398,24497,2022-03-12 18:35:19.597136
4484,73,516,34,61,945,1629,2022-03-12 18:35:21.172091
4486,129,1103,99,141,1196,2668,2022-03-12 18:35:25.078659
4503,245,3727,244,249,2455,6920,2022-03-12 18:35:27.318018
4508,186,3203,152,140,2827,6508,2022-03-12 18:35:30.675661
4509,26,473,19,61,274,853,2022-03-12 18:35:32.375248
4511,30,340,37,95,305,807,2022-03-12 18:35:35.300946
4513,119,2460,60,105,2015,4759,2022-03-12 18:35:37.414077
4515,43,830,41,125,375,1414,2022-03-12 18:35:40.913711
4521,21,313,17,53,236,640,2022-03-12 18:35:42.323815
4524,81,744,35,56,773,1689,2022-03-12 18:35:44.916897
4534,47,482,31,46,545,1151,2022-03-12 18:35:52.573342
4540,114,2803,69,109,1715,4810,2022-03-12 18:36:01.452988
4544,17,74,20,55,346,512,2022-03-12 18:36:02.724082
4547,27,69,7,70,130,303,2022-03-12 18:36:03.760055
4548,8882,43264,5485,5979,76672,140282,2022-03-12 18:36:06.985371
4550,1772,23423,1820,2650,12711,42376,2022-03-12 18:36:09.952627
4551,4980,68973,3925,4458,31653,113989,2022-03-12 18:36:10.427347
4553,19,163,10,66,130,388,2022-03-12 18:36:12.175347
4554,64,285,56,109,548,1062,2022-03-12 18:36:12.61573
4565,4164,126559,1689,1091,57121,190624,2022-03-12 18:36:17.959084
4566,61,1146,56,62,818,2143,2022-03-12 18:36:20.129096
4574,46,228,30,97,379,780,2022-03-12 18:36:23.081049
4586,48,1000,59,177,284,1568,2022-03-12 18:36:32.405753
4591,291,1356,212,330,2462,4651,2022-03-12 18:36:34.575655
4597,53,306,38,93,407,897,2022-03-12 18:36:39.968297
4598,18,140,12,98,125,393,2022-03-12 18:36:55.079023
4599,29,455,23,97,203,807,2022-03-12 18:37:09.563632
4615,59,524,60,140,518,1301,2022-03-12 18:37:18.278942
4616,21,581,15,89,153,859,2022-03-12 18:37:22.953295
4617,72,1002,40,51,1090,2255,2022-03-12 18:37:26.101579
4618,1861,24630,1721,1995,14604,44811,2022-03-12 18:37:26.354573
4621,12,71,4,66,107,260,2022-03-12 18:37:27.795165
4646,190,2904,113,133,1693,5033,2022-03-12 18:37:37.883596
4654,45413,436298,33459,31925,179599,726694,2022-03-12 18:37:41.488198
4657,1289,6168,1175,1827,5172,15631,2022-03-12 18:37:44.648644
4663,146,2435,106,147,1153,3987,2022-03-12 18:37:50.681278
4664,243,6298,191,184,4239,11155,2022-03-12 18:37:53.292902
4667,125,3356,110,274,741,4606,2022-03-12 18:37:55.622601
4672,1399,52600,782,645,27376,82802,2022-03-12 18:37:59.008712
4680,37,425,27,60,628,1177,2022-03-12 18:38:01.005516
4681,29,402,15,57,380,883,2022-03-12 18:38:02.395032
4682,16,282,8,50,175,531,2022-03-12 18:38:03.463161
4684,16,100,24,75,172,387,2022-03-12 18:38:04.995443
4685,55,1370,24,50,707,2206,2022-03-12 18:38:06.407612
4689,56,2039,32,46,1214,3387,2022-03-12 18:38:10.777734
4690,410,3606,520,521,3649,8706,2022-03-12 18:38:13.160292
4709,17,242,19,121,158,557,2022-03-12 18:38:20.018422
4712,148,4447,117,171,2160,7043,2022-03-12 18:38:23.019005
4719,5690,40042,3636,7544,30029,86941,2022-03-12 18:38:34.745377
4722,8793,168157,6133,7115,54403,244601,2022-03-12 18:38:38.82691
4723,120,243,91,118,1144,1716,2022-03-12 18:38:41.145138
4725,9470,111768,7434,7664,85797,222133,2022-03-12 18:38:43.85379
4737,65,349,53,141,407,1015,2022-03-12 18:38:52.146833
4744,5377,102433,3223,5300,26888,143221,2022-03-12 18:38:54.342941
4756,70,1473,49,46,1251,2889,2022-03-12 18:39:02.631509
4760,926,20721,561,523,7914,30645,2022-03-12 18:39:06.428761
42009,1,74,3,9,20,107,2022-03-12 19:46:43.738392
4772,348,12559,292,232,6291,19722,2022-03-12 18:39:14.029894
4773,125,605,77,134,1170,2111,2022-03-12 18:39:16.522974
4782,50,217,39,88,286,680,2022-03-12 18:39:17.959977
4790,29,222,8,53,345,657,2022-03-12 18:39:22.706136
4795,153,14851,136,183,2339,17662,2022-03-12 18:39:33.416334
4798,286,9541,185,168,4100,14280,2022-03-12 18:39:35.91354
4801,55,221,28,89,317,710,2022-03-12 18:39:39.722815
4804,213,2728,144,94,2159,5338,2022-03-12 18:39:41.834396
4807,61,510,41,76,432,1120,2022-03-12 18:39:43.359372
4814,4074,144124,1780,2092,14159,166229,2022-03-12 18:39:52.538063
4851,101,2709,87,84,1942,4923,2022-03-12 18:40:37.958673
4854,111,927,82,98,1108,2326,2022-03-12 18:40:42.971893
4855,49,756,48,49,665,1567,2022-03-12 18:40:44.858912
4872,1412,39413,1009,519,18257,60610,2022-03-12 18:40:49.362779
4876,192,1704,110,74,3463,5543,2022-03-12 18:40:53.957523
4879,3382,15887,3188,3113,31784,57354,2022-03-12 18:40:56.671329
4884,7430,57125,6335,6930,38483,116303,2022-03-12 18:40:59.413991
4886,799,23374,443,336,9305,34257,2022-03-12 18:41:01.91725
4890,25,1842,11,25,302,2205,2022-03-12 18:41:04.019962
4903,1694,16608,1390,1627,12348,33667,2022-03-12 18:41:16.142245
4905,31,181,21,93,325,651,2022-03-12 18:41:22.215724
4907,19,288,13,70,252,642,2022-03-12 18:41:23.562721
4910,97,7234,105,140,1950,9526,2022-03-12 18:41:28.183971
4921,138,3933,65,107,1568,5811,2022-03-12 18:41:35.383783
4923,89,749,56,106,939,1939,2022-03-12 18:41:37.099958
4926,70,1218,60,72,916,2336,2022-03-12 18:41:38.866488
4927,57,426,27,59,583,1152,2022-03-12 18:41:40.460256
4928,81,268,59,110,779,1297,2022-03-12 18:41:42.08129
4933,54,411,33,88,610,1196,2022-03-12 18:41:45.020016
4935,107,905,135,268,453,1868,2022-03-12 18:41:46.834733
4936,396,6142,541,1335,809,9223,2022-03-12 18:41:49.359828
4938,1286,40750,823,499,15060,58418,2022-03-12 18:41:52.557662
4939,142,1043,210,297,1337,3029,2022-03-12 18:41:54.255806
4941,27,355,14,41,419,856,2022-03-12 18:41:56.138483
4943,59,738,44,69,1043,1953,2022-03-12 18:41:58.095719
4975,8858,183190,6874,13448,59880,272250,2022-03-12 18:42:11.819683
4985,509,19383,359,288,8563,29102,2022-03-12 18:42:19.871612
4991,29,546,15,67,374,1031,2022-03-12 18:42:21.375578
4997,127,3801,95,98,1590,5711,2022-03-12 18:42:23.902831
42038,0,0,0,0,0,0,2022-03-12 19:46:44.929465
46364,0,0,0,0,0,0,2022-03-12 20:14:31.37213
46368,0,0,0,0,0,0,2022-03-12 20:14:32.638776
46377,0,0,0,0,0,0,2022-03-12 20:14:35.031773
4999,7525,140549,4243,5834,33279,191430,2022-03-12 18:42:27.382302
5002,48,329,24,65,705,1171,2022-03-12 18:42:28.970757
5006,31,789,13,60,274,1167,2022-03-12 18:42:33.646628
5013,45,305,12,60,313,735,2022-03-12 18:42:35.143822
5017,12,888,5,30,208,1143,2022-03-12 18:42:41.712726
5019,96,2788,83,81,1785,4833,2022-03-12 18:42:44.533359
5020,703,8154,446,961,5545,15809,2022-03-12 18:42:46.170457
5022,49,317,54,101,358,879,2022-03-12 18:42:47.73161
5023,84,380,70,115,1045,1694,2022-03-12 18:42:49.689714
5025,248,2687,116,120,2906,6077,2022-03-12 18:42:52.057336
5027,206,2859,209,529,1713,5516,2022-03-12 18:42:54.3116
5028,1877,50151,761,734,10853,64376,2022-03-12 18:42:56.990421
5029,329,14435,169,244,3594,18771,2022-03-12 18:42:57.23942
5030,8510,88190,7463,10668,47530,162361,2022-03-12 18:43:00.130918
5031,118,2402,69,74,1261,3924,2022-03-12 18:43:00.487015
5034,2518,41212,1676,1336,25384,72126,2022-03-12 18:43:05.964577
5036,65,1061,49,54,742,1971,2022-03-12 18:43:06.314581
5040,10349,122234,7265,5559,64473,209880,2022-03-12 18:43:09.633811
5041,2811,16021,2531,3321,16113,40797,2022-03-12 18:43:12.386533
5042,30168,192397,15667,15049,41365,294646,2022-03-12 18:43:15.782563
5043,61,1135,54,58,772,2080,2022-03-12 18:43:16.03556
5051,75,1492,56,79,1157,2859,2022-03-12 18:43:19.611529
5052,76,441,100,211,725,1553,2022-03-12 18:43:19.954529
42963,5,1,3,1,180348,180358,2022-03-12 19:48:05.562157
5053,144,2446,90,119,2884,5683,2022-03-12 18:43:20.191526
5056,72,2097,57,48,1046,3320,2022-03-12 18:43:20.518179
5071,76,392,59,123,385,1035,2022-03-12 18:43:23.232323
5074,1746,29447,1240,713,15049,48195,2022-03-12 18:43:30.27066
5075,237,1039,185,191,1395,3047,2022-03-12 18:43:32.554002
5079,7656,49883,6581,8471,40936,113527,2022-03-12 18:43:32.982361
5080,280,6042,116,96,3304,9838,2022-03-12 18:43:35.538092
5081,85684,770933,55495,40947,301056,1254115,2022-03-12 18:43:35.867119
5082,219,1141,122,236,1409,3127,2022-03-12 18:43:38.428049
5085,121,4829,51,119,2130,7250,2022-03-12 18:43:42.529331
5088,36,256,31,102,300,725,2022-03-12 18:43:44.030485
5089,17,103,12,62,150,344,2022-03-12 18:43:45.450098
5091,62,802,41,119,341,1365,2022-03-12 18:43:49.554662
5098,25,419,15,79,344,882,2022-03-12 18:43:53.623386
5104,41,500,36,101,314,992,2022-03-12 18:43:55.207096
5114,214483,2035296,95651,43413,418015,2806858,2022-03-12 18:43:58.400464
5116,350,19479,192,162,4816,24999,2022-03-12 18:44:01.760753
5118,2997,63188,2877,3001,22736,94799,2022-03-12 18:44:04.46483
5131,45,296,44,89,359,833,2022-03-12 18:44:08.134025
5132,323,2149,121,175,2389,5157,2022-03-12 18:44:11.481321
5136,42,651,38,47,767,1545,2022-03-12 18:44:14.740357
5140,21,124,15,54,193,407,2022-03-12 18:44:15.988547
5150,4604,47736,2856,3257,34503,92956,2022-03-12 18:44:22.664181
5152,444,41254,250,243,4702,46893,2022-03-12 18:44:26.918353
5153,181,835,132,148,1680,2976,2022-03-12 18:44:28.776348
5158,43,4057,25,43,628,4796,2022-03-12 18:44:36.837899
5163,807,22295,823,674,10682,35281,2022-03-12 18:44:43.450262
5164,61,1801,48,78,1104,3092,2022-03-12 18:44:46.019895
5177,5049,77010,2102,1437,53180,138778,2022-03-12 18:44:53.02745
5178,862,24627,402,486,11696,38073,2022-03-12 18:44:55.99234
5184,26,70,13,71,168,348,2022-03-12 18:44:57.438423
5189,34,348,28,102,208,720,2022-03-12 18:44:59.060541
5192,16,155,15,42,190,418,2022-03-12 18:45:00.631212
5199,241,3740,203,150,3466,7800,2022-03-12 18:45:08.60351
5200,175,1504,120,198,1126,3123,2022-03-12 18:45:11.6438
5201,40,562,28,90,192,912,2022-03-12 18:45:13.196905
5205,3493,130473,1758,673,50649,187046,2022-03-12 18:45:21.354987
5216,330,10078,257,195,4213,15073,2022-03-12 18:45:23.45675
5217,72,906,56,129,531,1694,2022-03-12 18:45:25.360591
5220,3395,20172,3729,5511,22461,55268,2022-03-12 18:45:25.68078
5223,23,446,16,90,115,690,2022-03-12 18:45:27.846871
5225,145,6134,97,110,2605,9091,2022-03-12 18:45:30.783694
5231,10512,132441,7897,10107,16815,177772,2022-03-12 18:45:37.343318
5232,45,427,35,95,807,1409,2022-03-12 18:45:39.160304
5233,749,20316,688,483,7870,30106,2022-03-12 18:45:41.610016
5235,100,256,76,120,507,1059,2022-03-12 18:45:45.669431
5237,35,522,34,44,382,1017,2022-03-12 18:45:47.000466
5238,43,503,63,77,1285,1971,2022-03-12 18:45:49.219481
5241,29,195,21,63,223,531,2022-03-12 18:45:51.770649
5246,45,579,25,71,486,1206,2022-03-12 18:45:56.133331
5250,113,774,92,151,1103,2233,2022-03-12 18:45:58.081481
5251,765,23028,305,232,8353,32683,2022-03-12 18:46:01.000468
5252,678,36098,361,262,7816,45215,2022-03-12 18:46:03.309935
5258,8419,181042,3181,1762,41422,235826,2022-03-12 18:46:04.210938
5260,26,128,7,42,143,346,2022-03-12 18:46:06.100381
5262,4472,71664,3420,3878,12459,95893,2022-03-12 18:46:09.312149
5263,9,589,4,23,129,754,2022-03-12 18:46:11.209821
5266,60,744,37,45,711,1597,2022-03-12 18:46:12.940823
5270,82,3507,57,114,1098,4858,2022-03-12 18:46:17.069098
5273,63,654,51,123,570,1461,2022-03-12 18:46:20.061467
5274,91,317,63,116,796,1383,2022-03-12 18:46:21.91608
5276,104,441,74,118,731,1468,2022-03-12 18:46:23.797084
5277,6884,172261,3207,3039,34520,219911,2022-03-12 18:46:26.683873
5278,63,152,23,86,462,786,2022-03-12 18:46:28.033928
5279,748,42205,428,247,8526,52154,2022-03-12 18:46:30.779131
5287,20,306,22,90,202,640,2022-03-12 18:46:32.168973
5289,37,688,33,63,446,1267,2022-03-12 18:46:34.48242
5290,103,3384,73,100,1119,4779,2022-03-12 18:46:38.839656
5291,289,5916,142,122,3509,9978,2022-03-12 18:46:42.528472
5293,54,623,32,73,584,1366,2022-03-12 18:46:45.993308
5296,71,1078,50,48,906,2153,2022-03-12 18:46:48.171853
5298,157,6740,107,161,2306,9471,2022-03-12 18:46:48.507852
5299,10,614,6,26,155,811,2022-03-12 18:46:48.855851
5303,41,272,23,75,399,810,2022-03-12 18:46:53.786038
5304,82,1191,66,236,637,2212,2022-03-12 18:46:55.896815
5305,199,6876,145,96,2566,9882,2022-03-12 18:46:56.825816
5306,1351,17601,832,507,9859,30150,2022-03-12 18:46:59.621078
5310,525,20015,265,241,7548,28594,2022-03-12 18:47:07.487957
5311,73,605,56,144,422,1300,2022-03-12 18:47:11.114592
5322,59,569,38,95,437,1198,2022-03-12 18:47:14.469614
5330,101,979,57,81,1172,2390,2022-03-12 18:47:16.350772
5333,463,11122,314,256,4954,17109,2022-03-12 18:47:20.942932
5337,1357,50140,846,1981,3654,57978,2022-03-12 18:47:23.691068
5341,14512,315205,9973,4934,98122,442746,2022-03-12 18:47:27.482924
5343,116,545,67,127,1048,1903,2022-03-12 18:47:32.19527
5348,178,9321,141,158,2376,12174,2022-03-12 18:47:37.007651
5353,132,523,126,103,719,1603,2022-03-12 18:47:39.225088
5356,10358,98198,8331,8098,82478,207463,2022-03-12 18:47:45.113576
5372,84,869,58,77,955,2043,2022-03-12 18:47:51.810772
5374,30,123,9,63,165,390,2022-03-12 18:47:53.183774
5375,35,553,48,185,235,1056,2022-03-12 18:47:55.260513
5395,73,368,51,77,610,1179,2022-03-12 18:48:00.132374
5396,25,300,24,55,343,747,2022-03-12 18:48:01.516971
5397,62,3676,31,117,350,4236,2022-03-12 18:48:03.391122
5415,85,1261,52,89,1742,3229,2022-03-12 18:48:05.598897
5420,4749,20687,3728,2647,45318,77129,2022-03-12 18:48:11.447861
5421,44,590,17,72,418,1141,2022-03-12 18:48:13.919085
5447,71,1485,41,92,1065,2754,2022-03-12 18:48:18.443775
5449,32,706,25,67,420,1250,2022-03-12 18:48:20.611768
5454,1325,10264,1106,1718,9505,23918,2022-03-12 18:48:23.650865
5460,894,45061,316,372,5767,52410,2022-03-12 18:48:26.376069
5462,115,6079,107,137,1222,7660,2022-03-12 18:48:28.614844
5468,15,100,11,62,168,356,2022-03-12 18:48:30.572957
5469,26,1203,11,47,523,1810,2022-03-12 18:48:32.748465
5472,13,399,19,33,270,734,2022-03-12 18:48:34.397097
5473,32,103,13,68,200,416,2022-03-12 18:48:35.759912
5474,26,349,33,109,273,790,2022-03-12 18:48:37.194949
5475,47,252,32,113,380,824,2022-03-12 18:48:39.059946
5476,83,381,72,149,658,1343,2022-03-12 18:48:41.085764
5477,27,152,14,68,259,520,2022-03-12 18:48:42.579388
5484,179,1312,225,149,1272,3137,2022-03-12 18:48:45.080481
5492,28,366,7,38,274,713,2022-03-12 18:48:46.876142
5493,249,8784,202,135,3138,12508,2022-03-12 18:48:49.932184
5494,330,2251,323,290,3175,6369,2022-03-12 18:48:52.240909
5501,86,1440,79,160,1153,2918,2022-03-12 18:48:54.810541
5503,22,272,17,77,338,726,2022-03-12 18:48:56.2028
5515,30,257,16,60,225,588,2022-03-12 18:49:03.355388
5520,128,1055,127,166,1227,2703,2022-03-12 18:49:06.153933
5521,591,27029,378,240,8249,36487,2022-03-12 18:49:10.336607
5525,10933,121881,9554,13755,43158,199281,2022-03-12 18:49:13.119212
5529,144,8736,127,168,2297,11472,2022-03-12 18:49:18.154483
5530,23054,202222,20124,19104,133820,398324,2022-03-12 18:49:18.533481
5534,39,256,44,108,295,742,2022-03-12 18:49:21.185196
5538,233,8853,193,135,4397,13811,2022-03-12 18:49:24.256912
5539,111,2045,74,103,1710,4043,2022-03-12 18:49:30.484236
5549,81,1644,54,71,905,2755,2022-03-12 18:49:33.486518
5554,67,768,35,77,865,1812,2022-03-12 18:49:36.462984
5564,67,490,49,124,341,1071,2022-03-12 18:49:38.385066
5584,69,884,37,41,773,1804,2022-03-12 18:49:47.558861
5585,116,1015,46,44,1046,2267,2022-03-12 18:49:48.997038
5593,1703,36702,1084,976,17797,58262,2022-03-12 18:49:51.747814
5594,14,93,8,66,111,292,2022-03-12 18:49:53.156917
5597,2878,15666,2184,2927,25486,49141,2022-03-12 18:49:55.811506
5600,32,278,21,84,221,636,2022-03-12 18:49:57.011508
5602,21,273,7,38,187,526,2022-03-12 18:49:58.4176
5618,128,313,153,209,619,1422,2022-03-12 18:50:00.040601
5622,56,1881,31,85,1008,3061,2022-03-12 18:50:04.234567
5624,61,3014,47,58,1021,4201,2022-03-12 18:50:06.52348
5628,43,308,42,126,306,825,2022-03-12 18:50:07.810484
5629,41,439,34,42,507,1063,2022-03-12 18:50:09.307989
5631,33,1027,8,55,208,1331,2022-03-12 18:50:12.173088
5632,17,1113,4,45,194,1373,2022-03-12 18:50:14.926285
5636,45,227,20,74,391,757,2022-03-12 18:50:17.520707
5640,63,446,35,77,537,1158,2022-03-12 18:50:19.404827
5648,81,451,39,89,595,1255,2022-03-12 18:50:23.006486
5652,45,747,40,43,646,1521,2022-03-12 18:50:24.755936
5656,45,2143,53,103,730,3074,2022-03-12 18:50:26.563692
5658,270,2495,225,211,1767,4968,2022-03-12 18:50:29.547869
5661,25,990,6,58,175,1254,2022-03-12 18:50:30.868199
5670,1010,7562,996,1342,7811,18721,2022-03-12 18:50:35.90238
5671,4868,42661,3686,4845,30249,86309,2022-03-12 18:50:38.987119
5675,2895,19470,2682,4258,13983,43288,2022-03-12 18:50:43.090652
5678,8513,68360,7878,7988,60538,153277,2022-03-12 18:50:48.112919
5680,44531,611728,29309,29565,213348,928481,2022-03-12 18:50:51.968659
5681,7650,346788,2812,1427,115103,473780,2022-03-12 18:50:55.641828
5682,16364,138271,11977,10545,127661,304818,2022-03-12 18:50:59.942995
5691,161,3609,123,78,2466,6437,2022-03-12 18:51:12.695641
5693,22,113,14,44,145,338,2022-03-12 18:51:14.172618
5702,1586,18071,1130,1176,14819,36782,2022-03-12 18:51:17.465952
46388,0,0,0,0,0,0,2022-03-12 20:14:38.717731
46395,0,0,0,0,0,0,2022-03-12 20:14:41.05365
46398,0,0,0,0,0,0,2022-03-12 20:14:42.593048
46399,0,0,0,0,0,0,2022-03-12 20:14:43.47067
5710,88,2695,56,85,1078,4002,2022-03-12 18:51:19.935617
5712,165,3710,126,203,1441,5645,2022-03-12 18:51:22.13135
5713,344,21072,295,158,6292,28161,2022-03-12 18:51:25.037675
5715,53,1226,43,57,653,2032,2022-03-12 18:51:26.94339
5717,696,25530,406,331,5132,32095,2022-03-12 18:51:29.624771
5719,1038,22506,391,477,3989,28401,2022-03-12 18:51:32.254023
5734,3759,38199,2426,2863,18682,65929,2022-03-12 18:51:39.640003
5753,102,3675,68,116,1545,5506,2022-03-12 18:51:48.016976
5760,1016,5615,724,810,8418,16583,2022-03-12 18:51:50.419761
5764,1166,71487,662,424,12916,86655,2022-03-12 18:51:57.780511
5774,1152,36620,310,394,6902,45378,2022-03-12 18:52:02.545317
5781,11590,98062,4882,5446,58636,178616,2022-03-12 18:52:04.611316
5783,27,341,26,54,386,834,2022-03-12 18:52:04.944325
5784,1064,21003,587,725,7657,31036,2022-03-12 18:52:06.973093
5785,54,1706,27,51,712,2550,2022-03-12 18:52:11.597421
5799,23,418,8,60,186,695,2022-03-12 18:52:23.740747
5802,82,1336,41,53,1813,3325,2022-03-12 18:52:24.028751
5809,57,112,41,73,466,749,2022-03-12 18:52:28.072813
5810,36,110,12,53,311,522,2022-03-12 18:52:28.328813
5811,15,907,5,45,95,1067,2022-03-12 18:52:28.575815
5812,16,936,4,42,104,1102,2022-03-12 18:52:28.818816
5821,34,214,19,111,151,529,2022-03-12 18:52:29.544845
5835,4940,28294,3958,5020,21347,63559,2022-03-12 18:52:33.846595
5838,19,775,5,39,130,968,2022-03-12 18:52:34.225595
5841,25,95,10,98,174,402,2022-03-12 18:52:34.598438
5842,16,857,7,38,204,1122,2022-03-12 18:52:34.843989
5849,91,1223,68,107,1251,2740,2022-03-12 18:52:37.492311
5854,141,1117,129,127,1106,2620,2022-03-12 18:52:39.803902
5859,112,2374,79,85,1968,4618,2022-03-12 18:52:40.069908
5862,27,510,22,46,388,993,2022-03-12 18:52:40.446009
5865,49,1155,31,38,568,1841,2022-03-12 18:52:40.764288
5872,15,752,3,40,112,922,2022-03-12 18:52:41.722804
5878,34,445,20,48,602,1149,2022-03-12 18:52:42.851
5900,38,268,18,65,496,885,2022-03-12 18:52:44.077003
5916,11,78,9,40,151,289,2022-03-12 18:52:45.25147
5925,44,873,20,45,597,1579,2022-03-12 18:52:46.455496
5933,36,395,24,58,420,933,2022-03-12 18:52:49.311016
5934,24,495,23,54,342,938,2022-03-12 18:52:49.619043
5936,37,424,28,47,596,1132,2022-03-12 18:52:50.069016
5953,114,1065,95,149,1110,2533,2022-03-12 18:52:51.356735
5967,202,4895,129,234,1312,6772,2022-03-12 18:52:52.402709
5987,11,104,8,39,115,277,2022-03-12 18:52:53.567798
6007,2598,117661,1198,565,31261,153283,2022-03-12 18:52:54.978446
6024,2150,12872,1954,1613,8663,27252,2022-03-12 18:52:56.105063
6045,44706,486430,28831,24892,203177,788036,2022-03-12 18:52:57.398622
6061,153,954,71,100,1545,2823,2022-03-12 18:52:58.427622
6069,145,1754,85,147,1495,3626,2022-03-12 18:53:00.107785
6074,22,232,14,91,247,606,2022-03-12 18:53:00.943346
6091,30,138,16,46,261,491,2022-03-12 18:53:02.114345
6112,1420,15793,1047,1272,10288,29820,2022-03-12 18:53:03.381698
6117,580,2331,491,1085,2958,7445,2022-03-12 18:53:04.543676
6137,33,1973,5,28,411,2450,2022-03-12 18:53:05.705113
6154,204,6710,121,165,2146,9346,2022-03-12 18:53:06.891886
6169,194,3745,138,117,3448,7642,2022-03-12 18:53:08.178891
6183,28,432,9,47,339,855,2022-03-12 18:53:09.210006
6202,33,428,14,66,323,864,2022-03-12 18:53:10.505203
6215,42,1684,31,51,695,2503,2022-03-12 18:53:11.801305
6230,87,195,37,62,901,1282,2022-03-12 18:53:12.936406
6262,99,540,86,158,640,1523,2022-03-12 18:53:14.201406
6272,28,206,20,59,626,939,2022-03-12 18:53:15.222837
6287,378,19253,236,216,4285,24368,2022-03-12 18:53:16.500331
6305,42,1504,28,41,787,2402,2022-03-12 18:53:21.107319
6310,35,560,22,65,405,1087,2022-03-12 18:53:21.452318
6311,43,297,23,105,349,817,2022-03-12 18:53:21.706319
6312,95,1528,81,61,1194,2959,2022-03-12 18:53:22.380316
6318,104,977,72,154,639,1946,2022-03-12 18:53:22.741317
6344,305,8309,196,115,5463,14388,2022-03-12 18:53:23.982887
6368,345,4047,200,193,5061,9846,2022-03-12 18:53:25.178553
6381,2686,51590,1680,1606,20768,78330,2022-03-12 18:53:26.343133
6399,134,10712,94,121,2452,13513,2022-03-12 18:53:27.646131
6421,4389,101645,2543,976,33572,143125,2022-03-12 18:53:30.804095
6425,784,10831,498,892,6970,19975,2022-03-12 18:53:31.170198
6447,41,160,15,45,371,632,2022-03-12 18:53:32.378198
6467,656,43522,266,308,4898,49650,2022-03-12 18:53:33.512366
6489,1082,33175,572,736,10115,45680,2022-03-12 18:53:34.697364
6511,91,1249,77,155,765,2337,2022-03-12 18:53:35.940458
6522,16,89,9,53,135,302,2022-03-12 18:53:37.200061
6535,26,3030,18,83,601,3758,2022-03-12 18:53:41.386331
6546,346,8644,126,459,2574,12149,2022-03-12 18:53:42.161345
6547,65356,1424008,40571,46932,286428,1863295,2022-03-12 18:53:42.504335
6554,49,676,17,51,622,1415,2022-03-12 18:53:43.057682
6573,9471,282903,6010,5665,79170,383219,2022-03-12 18:53:52.316599
6574,4632,42353,2972,3016,27644,80617,2022-03-12 18:54:03.398976
6582,481,3996,300,285,2299,7361,2022-03-12 18:54:13.121434
6586,3786,47354,2777,3241,15359,72517,2022-03-12 18:54:17.872584
6587,177,3427,105,123,2279,6111,2022-03-12 18:54:21.970871
6594,37392,225931,25336,15096,203154,506909,2022-03-12 18:54:26.544799
6604,340,1030,333,359,2359,4421,2022-03-12 18:54:29.579536
6607,47,2841,15,37,472,3412,2022-03-12 18:54:32.283728
6609,394,11621,310,691,1416,14432,2022-03-12 18:54:34.839847
6610,1647,41572,658,368,23284,67529,2022-03-12 18:54:37.459936
6624,916,25803,599,324,15675,43317,2022-03-12 18:54:37.710935
6625,37,254,48,126,490,955,2022-03-12 18:54:39.742737
6628,116,2922,74,106,1490,4708,2022-03-12 18:54:42.347615
6629,51,289,30,118,272,760,2022-03-12 18:54:43.977612
6630,18,160,6,70,171,425,2022-03-12 18:54:45.096644
6633,2244,27901,1362,1948,16035,49490,2022-03-12 18:54:48.183985
6634,2526,41199,1807,1468,18161,65161,2022-03-12 18:54:48.451989
6636,107,293,59,98,797,1354,2022-03-12 18:54:50.292723
6637,1617,102162,1085,497,30456,135817,2022-03-12 18:54:52.964124
6641,66,1901,18,41,913,2939,2022-03-12 18:54:55.156423
6645,2086,25582,1791,4681,11227,45367,2022-03-12 18:54:58.18823
6653,66,1280,57,69,996,2468,2022-03-12 18:55:00.877034
6654,67,6702,35,71,591,7466,2022-03-12 18:55:03.42164
6657,109,2694,85,70,1455,4413,2022-03-12 18:55:05.845232
6658,38,173,32,143,318,704,2022-03-12 18:55:07.409769
6667,15,1093,9,38,224,1379,2022-03-12 18:55:09.419902
6670,36,405,31,78,863,1413,2022-03-12 18:55:11.213489
6671,15,189,5,63,134,406,2022-03-12 18:55:12.532489
6672,68,277,72,132,454,1003,2022-03-12 18:55:14.120015
6676,1562,44486,1228,1225,10600,59101,2022-03-12 18:55:19.23424
6680,30,1001,11,53,570,1665,2022-03-12 18:55:21.111935
6682,7819,157303,5648,11989,39715,222474,2022-03-12 18:55:22.034306
6684,21,375,15,37,232,680,2022-03-12 18:55:23.36546
6701,15,142,10,83,161,411,2022-03-12 18:55:31.853849
6702,205558,875392,124904,178946,167823,1552623,2022-03-12 18:55:32.21585
6704,577,8625,378,342,4166,14088,2022-03-12 18:55:34.516085
6705,341,4116,179,144,2864,7644,2022-03-12 18:55:37.86218
6707,14392,393783,8484,11385,81190,509234,2022-03-12 18:55:42.204828
46402,0,0,0,0,0,0,2022-03-12 20:14:44.559434
46408,0,0,0,0,0,0,2022-03-12 20:14:50.751393
46409,0,0,0,0,0,0,2022-03-12 20:14:51.633788
46412,0,0,0,0,0,0,2022-03-12 20:14:54.664902
6712,956,9558,630,511,7392,19047,2022-03-12 18:55:46.954699
6713,149,3841,142,106,2111,6349,2022-03-12 18:55:54.978046
6714,256,15348,200,274,3652,19730,2022-03-12 18:55:58.585923
6718,65,653,50,96,876,1740,2022-03-12 18:56:00.427752
6721,60,1373,46,130,763,2372,2022-03-12 18:56:02.430377
6726,133,2103,117,145,1499,3997,2022-03-12 18:56:04.674374
6727,25,156,10,74,151,416,2022-03-12 18:56:06.063315
6728,26,340,11,51,324,752,2022-03-12 18:56:06.548314
6730,14,140,8,75,86,323,2022-03-12 18:56:08.247216
6733,53,740,44,59,777,1673,2022-03-12 18:56:12.255455
6734,46,786,44,59,800,1735,2022-03-12 18:56:14.437454
6736,91,4769,84,73,1625,6642,2022-03-12 18:56:16.825148
6741,103,2939,52,81,1475,4650,2022-03-12 18:56:19.122272
6746,88152,724477,71153,52101,332657,1268540,2022-03-12 18:56:24.51839
6747,9712,129799,7129,12092,49927,208659,2022-03-12 18:56:29.066357
6748,134,4411,77,75,1363,6060,2022-03-12 18:56:31.275674
6749,71,3571,56,105,1241,5044,2022-03-12 18:56:33.611146
6758,4425,17424,3187,3911,30257,59204,2022-03-12 18:56:34.456731
6759,9,135,5,48,104,301,2022-03-12 18:56:36.312576
6761,11,127,5,47,93,283,2022-03-12 18:56:38.065763
6762,10,131,5,51,108,305,2022-03-12 18:56:40.29891
6769,37,1763,14,51,208,2073,2022-03-12 18:56:45.350568
6773,8405,145974,7239,6788,53293,221699,2022-03-12 18:56:53.099263
6779,41,433,48,122,198,842,2022-03-12 18:57:00.458889
6783,254,6340,280,216,5752,12842,2022-03-12 18:57:00.835888
6787,498,4804,268,418,4986,10974,2022-03-12 18:57:01.08889
6791,1022,29983,558,426,9511,41500,2022-03-12 18:57:01.345886
6795,568,9770,400,192,6994,17924,2022-03-12 18:57:02.060962
6811,9939,175063,6405,4055,53224,248686,2022-03-12 18:57:03.352962
6830,14,723,3,43,103,886,2022-03-12 18:57:04.530144
6834,20,892,3,61,111,1087,2022-03-12 18:57:06.108886
6838,14,1097,6,56,136,1309,2022-03-12 18:57:06.847886
6846,13,496,4,38,101,652,2022-03-12 18:57:08.698054
6849,11,774,3,45,102,935,2022-03-12 18:57:10.177581
6850,10,667,10,43,136,866,2022-03-12 18:57:13.131656
6851,11,753,2,42,93,901,2022-03-12 18:57:13.444683
6852,15,1328,9,61,170,1583,2022-03-12 18:57:13.760662
6855,31,486,13,54,336,920,2022-03-12 18:57:14.080847
6868,25,150,19,88,366,648,2022-03-12 18:57:15.295631
6883,127,1899,76,75,1936,4113,2022-03-12 18:57:16.447251
6899,78,1145,47,105,661,2036,2022-03-12 18:57:17.614253
6917,30,137,25,81,354,627,2022-03-12 18:57:18.876909
6932,52,982,33,44,718,1829,2022-03-12 18:57:20.02318
6953,27,3287,21,60,381,3776,2022-03-12 18:57:22.450004
6970,50,244,40,100,404,838,2022-03-12 18:57:23.606
6980,1006,5200,902,1256,6615,14979,2022-03-12 18:57:27.877907
6981,43,151,25,66,306,591,2022-03-12 18:57:28.580958
6984,243,11688,207,165,3645,15948,2022-03-12 18:57:28.910931
6985,141,3628,83,158,2383,6393,2022-03-12 18:57:29.240961
6988,57,4265,73,111,620,5126,2022-03-12 18:57:29.677934
7014,225,3682,137,91,4237,8372,2022-03-12 18:57:31.053088
7024,16,1377,9,48,181,1631,2022-03-12 18:57:32.146193
7028,13,1038,7,44,135,1237,2022-03-12 18:57:33.200195
7048,71,826,47,153,419,1516,2022-03-12 18:57:34.565329
7062,816,15738,613,456,7541,25164,2022-03-12 18:57:35.621488
7090,21,198,9,41,194,463,2022-03-12 18:57:36.988688
7112,59,597,39,58,1072,1825,2022-03-12 18:57:38.062619
7144,116,1775,75,83,1802,3851,2022-03-12 18:57:39.220625
7164,11,422,16,31,196,676,2022-03-12 18:57:40.57272
7177,36,90,15,70,235,446,2022-03-12 18:57:41.834744
7222,488,17223,266,219,7039,25235,2022-03-12 18:57:42.84485
7248,122,3720,74,89,1951,5956,2022-03-12 18:57:44.085038
7261,302,3315,246,183,965,5011,2022-03-12 18:57:45.27516
7295,16,1557,10,33,243,1859,2022-03-12 18:57:46.425337
7314,30,485,16,62,435,1028,2022-03-12 18:57:47.722332
7337,525,45752,307,301,9577,56462,2022-03-12 18:57:48.902566
7374,32,280,36,102,379,829,2022-03-12 18:57:50.423692
7396,359,11028,251,182,5166,16986,2022-03-12 18:57:51.266666
7423,13,332,4,28,132,509,2022-03-12 18:57:52.504827
7449,7,261,5,29,82,384,2022-03-12 18:57:57.425735
7450,17,409,5,27,102,560,2022-03-12 18:57:57.775739
7451,18,581,7,31,131,768,2022-03-12 18:57:58.093735
7453,188,2693,111,124,1674,4790,2022-03-12 18:57:58.589764
7471,174,6794,92,190,1646,8896,2022-03-12 18:57:59.832762
7477,20,547,7,43,285,902,2022-03-12 18:58:02.774949
7479,97,221,49,108,745,1220,2022-03-12 18:58:03.116943
7482,49,683,25,47,582,1386,2022-03-12 18:58:03.438946
7496,25,694,18,62,344,1143,2022-03-12 18:58:04.476076
7510,52,499,23,62,778,1414,2022-03-12 18:58:05.703147
7525,25,97,20,65,214,421,2022-03-12 18:58:06.895508
7532,26,421,10,54,203,714,2022-03-12 18:58:08.111612
7559,925,23523,652,685,13579,39364,2022-03-12 18:58:09.995127
7568,656,6396,844,824,6687,15407,2022-03-12 18:58:10.436221
7590,7134,74147,4325,6120,37773,129499,2022-03-12 18:58:11.730195
7601,35,226,26,45,383,715,2022-03-12 18:58:12.994782
7625,22,165,11,74,233,505,2022-03-12 18:58:14.222462
7633,11,74,5,60,123,273,2022-03-12 18:58:15.300517
7654,173,4191,145,185,3437,8131,2022-03-12 18:58:16.525794
7667,35,668,29,61,514,1307,2022-03-12 18:58:17.731794
7695,333,58367,233,225,4415,63573,2022-03-12 18:58:18.899897
7713,10,208,8,48,95,369,2022-03-12 18:58:20.073955
7728,635,16783,356,277,11242,29293,2022-03-12 18:58:21.270201
7751,38,125,36,78,466,743,2022-03-12 18:58:22.441888
7771,15,320,5,59,166,565,2022-03-12 18:58:23.812887
7785,23475,137839,13985,8604,196766,380669,2022-03-12 18:58:24.927023
7808,26,221,23,104,257,631,2022-03-12 18:58:26.061114
7836,24,174,20,77,326,621,2022-03-12 18:58:27.247395
7862,41,625,21,63,322,1072,2022-03-12 18:58:28.564934
7897,473,12929,232,371,4520,18525,2022-03-12 18:58:29.760943
7953,29,1488,23,60,462,2062,2022-03-12 18:58:30.924304
7981,20,249,20,93,133,515,2022-03-12 18:58:34.254627
7982,22,103,6,52,420,603,2022-03-12 18:58:34.959652
7985,53,405,18,59,349,884,2022-03-12 18:58:35.285235
8017,88,1473,66,85,893,2605,2022-03-12 18:58:35.775233
8042,48,573,27,53,739,1440,2022-03-12 18:58:36.999376
8074,40121,1068368,19495,41576,153168,1322728,2022-03-12 18:58:38.23855
8098,393,6938,215,191,5567,13304,2022-03-12 18:58:39.379552
8123,107,372,85,137,939,1640,2022-03-12 18:58:40.531697
8140,41,796,44,119,209,1209,2022-03-12 18:58:41.687682
8153,25,285,25,65,364,764,2022-03-12 18:58:43.054943
8162,55,535,27,42,563,1222,2022-03-12 18:58:44.100939
8183,19,211,12,87,138,467,2022-03-12 18:58:45.375603
8194,48,295,41,128,491,1003,2022-03-12 18:58:46.530646
8211,350,9879,201,268,4135,14833,2022-03-12 18:58:47.774643
8220,31,247,21,101,189,589,2022-03-12 18:58:48.995131
8233,54,174,25,50,636,939,2022-03-12 18:58:50.180136
8244,35,28,11,76,124,274,2022-03-12 18:58:51.38187
8249,92,1677,40,62,1062,2933,2022-03-12 18:58:52.631169
8297,88,2555,47,105,1016,3811,2022-03-12 18:58:53.881145
8314,29,415,21,63,319,847,2022-03-12 18:58:54.980693
8336,155,0,80,174,227,636,2022-03-12 18:58:56.167244
8355,17,136,13,86,159,411,2022-03-12 18:58:59.087108
8356,17,141,12,81,161,412,2022-03-12 18:58:59.425108
8357,23,138,15,89,180,445,2022-03-12 18:58:59.988618
8363,63,3131,35,89,601,3919,2022-03-12 18:59:00.990778
8365,61,2175,46,94,614,2990,2022-03-12 18:59:02.178782
8375,57,286,72,134,390,939,2022-03-12 18:59:05.973445
8394,216,2444,379,423,2263,5725,2022-03-12 18:59:06.333576
8403,14,152,9,75,154,404,2022-03-12 18:59:06.947585
8407,7110,217730,3645,4024,36435,268944,2022-03-12 18:59:07.196585
8417,15,130,11,76,130,362,2022-03-12 18:59:08.304672
8431,40,364,23,39,399,865,2022-03-12 18:59:09.465673
8446,15,318,5,26,145,509,2022-03-12 18:59:11.841031
8449,4509,43394,3068,6370,24944,82285,2022-03-12 18:59:12.130031
8460,3867,173927,1561,1909,30197,211461,2022-03-12 18:59:13.006178
8481,962,16507,622,413,8870,27374,2022-03-12 18:59:14.15818
8494,16,126,4,62,116,324,2022-03-12 18:59:15.297842
8516,8545,281108,5515,5737,44838,345743,2022-03-12 18:59:16.613843
8526,46,1369,15,37,590,2057,2022-03-12 18:59:18.238844
8538,162,988,105,179,1177,2611,2022-03-12 18:59:18.986477
8551,41,662,25,61,481,1270,2022-03-12 18:59:20.238034
8567,10,50,5,56,77,198,2022-03-12 18:59:23.888316
8577,1601,59812,764,989,8420,71586,2022-03-12 18:59:24.48947
8584,76,741,37,63,1073,1990,2022-03-12 18:59:24.823444
8595,23,89,10,58,153,333,2022-03-12 18:59:25.171469
8619,334,7035,184,163,3265,10981,2022-03-12 18:59:26.213053
8634,1571,53726,378,569,7329,63573,2022-03-12 18:59:27.693228
8645,7,329,3,31,72,442,2022-03-12 18:59:28.981359
8660,7,168,5,39,66,285,2022-03-12 18:59:31.704663
8661,8,530,6,44,103,691,2022-03-12 18:59:32.138639
8663,15,615,12,49,240,931,2022-03-12 18:59:32.47072
8669,11,295,9,74,243,632,2022-03-12 18:59:33.390718
8679,9,199,5,38,57,308,2022-03-12 18:59:34.645131
8696,11,270,4,29,75,389,2022-03-12 18:59:35.770653
8709,86,3951,98,129,1772,6036,2022-03-12 18:59:36.985773
8722,18,580,0,31,144,773,2022-03-12 18:59:38.126912
8731,9,466,9,63,144,691,2022-03-12 18:59:39.403961
8752,9,225,5,30,53,322,2022-03-12 18:59:43.353714
8753,36,223,21,104,211,595,2022-03-12 18:59:43.702718
8763,30,266,25,94,231,646,2022-03-12 18:59:44.263716
8768,1856,67263,633,452,19111,89315,2022-03-12 18:59:45.397945
8782,14,544,7,35,161,761,2022-03-12 18:59:46.631012
8812,75,349,50,117,1095,1686,2022-03-12 18:59:50.26581
8815,43,873,37,116,342,1411,2022-03-12 18:59:50.561595
8829,45,154,27,107,212,545,2022-03-12 18:59:50.902598
8840,82,2578,57,63,1019,3799,2022-03-12 18:59:51.467637
8861,17613,290692,8872,22041,96557,435775,2022-03-12 18:59:52.719896
8889,49,721,24,51,525,1370,2022-03-12 18:59:53.856892
8899,28,218,28,100,285,659,2022-03-12 18:59:55.138518
8919,27,364,13,46,266,716,2022-03-12 18:59:56.155202
8937,16702,300953,10381,7802,80829,416667,2022-03-12 19:00:02.199624
8939,43,4311,20,47,812,5233,2022-03-12 19:00:02.559631
8949,40,808,26,62,502,1438,2022-03-12 19:00:02.807626
8950,81,1102,55,99,1413,2750,2022-03-12 19:00:03.141649
8955,21,90,18,52,295,476,2022-03-12 19:00:03.714623
8964,77,952,54,149,725,1957,2022-03-12 19:00:05.950413
8965,30,694,19,61,467,1271,2022-03-12 19:00:07.042802
8967,20,123,12,46,240,441,2022-03-12 19:00:07.487805
8995,887,12690,543,265,8357,22742,2022-03-12 19:00:08.524538
9014,1589,25803,778,750,9981,38901,2022-03-12 19:00:09.706529
9041,18824,443218,8649,17386,89400,577477,2022-03-12 19:00:10.911738
9061,35,144,30,75,296,580,2022-03-12 19:00:12.147235
9074,5983,101221,5206,4245,34545,151200,2022-03-12 19:00:13.367934
46414,0,0,0,0,0,0,2022-03-12 20:14:57.018483
46416,0,0,0,0,0,0,2022-03-12 20:14:59.790645
46417,0,0,0,0,0,0,2022-03-12 20:15:00.616767
46418,0,0,0,0,0,0,2022-03-12 20:15:01.438539
9100,135,825,95,99,1644,2798,2022-03-12 19:00:14.637335
9124,107,5553,78,97,1931,7766,2022-03-12 19:00:15.82497
9163,41,470,25,98,418,1052,2022-03-12 19:00:17.039113
9177,50,246,35,79,646,1056,2022-03-12 19:00:22.102422
9181,7914,237435,3810,4128,45209,298496,2022-03-12 19:00:22.382417
9200,66,994,48,86,516,1710,2022-03-12 19:00:22.63412
9204,427,8904,166,209,7003,16709,2022-03-12 19:00:23.351117
9232,360,6344,151,231,1747,8833,2022-03-12 19:00:24.515117
9253,140973,1370507,76409,45111,546082,2179082,2022-03-12 19:00:25.753907
9288,111,4604,70,133,1551,6469,2022-03-12 19:00:26.950078
9318,15,636,5,32,156,844,2022-03-12 19:00:28.111076
9335,412,8523,245,265,4315,13760,2022-03-12 19:00:29.280077
9344,27,426,22,41,329,845,2022-03-12 19:00:30.531597
9353,169,3222,132,124,2427,6074,2022-03-12 19:00:31.772216
9367,10589,215610,5621,12701,51726,296247,2022-03-12 19:00:32.931422
9385,40,329,14,54,312,749,2022-03-12 19:00:35.660682
9387,18,151,11,57,151,388,2022-03-12 19:00:36.003682
9389,24,272,14,52,206,568,2022-03-12 19:00:36.647344
9403,27,216,17,64,297,621,2022-03-12 19:00:37.852321
9421,23,269,3,23,206,524,2022-03-12 19:00:38.934432
9445,44,273,26,43,408,794,2022-03-12 19:00:40.168432
9471,1675,98567,839,610,16270,117961,2022-03-12 19:00:41.316911
9496,24,140,8,43,252,467,2022-03-12 19:00:42.57294
9509,61,941,23,56,678,1759,2022-03-12 19:00:43.825671
9520,42,176,36,105,344,703,2022-03-12 19:00:44.963759
9531,39,373,9,44,288,753,2022-03-12 19:00:46.129363
9544,257,19541,96,111,3301,23306,2022-03-12 19:00:47.360871
9562,21,60,8,86,126,301,2022-03-12 19:00:48.583871
9587,4178,48781,2360,6065,21798,83182,2022-03-12 19:00:49.766374
9611,2016,11948,700,388,5487,20539,2022-03-12 19:00:51.010659
9630,117,2266,103,113,1589,4188,2022-03-12 19:00:52.280655
9665,31,118,17,62,375,603,2022-03-12 19:00:53.371655
9690,364,13907,204,207,3913,18595,2022-03-12 19:00:54.611654
9723,318,8152,184,181,4339,13174,2022-03-12 19:00:55.827445
9736,5895,84811,3628,6681,32509,133524,2022-03-12 19:00:58.498536
9737,855,4577,779,1309,5829,13349,2022-03-12 19:00:58.773536
9745,552,18148,294,229,8301,27524,2022-03-12 19:00:59.346537
9759,22,221,14,46,262,565,2022-03-12 19:01:00.507661
9776,4374,51686,3574,5738,28355,93727,2022-03-12 19:01:01.756685
9790,2322,95901,1065,832,24183,124303,2022-03-12 19:01:02.919308
9798,102,2423,70,79,2150,4824,2022-03-12 19:01:04.15031
9812,17,95,7,65,131,315,2022-03-12 19:01:05.305236
9825,15,104,4,50,108,281,2022-03-12 19:01:06.495259
9850,16,403,7,53,125,604,2022-03-12 19:01:07.878227
9863,18306,78693,16962,15650,76778,206389,2022-03-12 19:01:08.964713
9878,24,207,13,54,211,509,2022-03-12 19:01:10.134708
9885,24,130,8,72,151,385,2022-03-12 19:01:11.309651
9902,16,60,3,36,65,180,2022-03-12 19:01:12.553217
9910,10,205,3,35,55,308,2022-03-12 19:01:13.834364
9925,560,41102,365,219,8022,50268,2022-03-12 19:01:15.074398
9936,13004,164172,5756,11164,61438,255534,2022-03-12 19:01:16.183946
9948,19,82,12,51,183,347,2022-03-12 19:01:17.398964
9957,17,211,17,42,538,825,2022-03-12 19:01:18.626939
9972,34,329,22,62,351,798,2022-03-12 19:01:19.896024
9981,7150,50882,6414,10005,27642,102093,2022-03-12 19:01:20.902311
9996,1845,3593,1750,1299,16355,24842,2022-03-12 19:01:22.385312
10012,8301,104892,5559,3951,54022,176725,2022-03-12 19:01:23.43065
10029,2130,121376,1014,402,37313,162235,2022-03-12 19:01:24.976017
10039,10,144,7,47,100,308,2022-03-12 19:01:25.771613
10055,56,1155,45,69,926,2251,2022-03-12 19:01:27.003728
10067,1678,198327,1103,535,26288,227931,2022-03-12 19:01:28.211753
10080,8605,295673,5338,4002,44914,358532,2022-03-12 19:01:29.471847
10104,67,906,39,63,657,1732,2022-03-12 19:01:30.518863
10115,34,594,13,71,424,1136,2022-03-12 19:01:34.69633
10116,53,2993,44,84,584,3758,2022-03-12 19:01:35.381213
10118,24,222,37,70,397,750,2022-03-12 19:01:35.648194
10119,10750,77841,5334,1849,22406,118180,2022-03-12 19:01:35.98019
10135,30,223,21,93,164,531,2022-03-12 19:01:36.535693
10155,7907,107021,5467,11454,44508,176357,2022-03-12 19:01:37.840321
10177,190,2192,160,276,1751,4569,2022-03-12 19:01:38.988876
10196,813,19496,297,277,6756,27639,2022-03-12 19:01:40.177895
10207,34,638,23,36,506,1237,2022-03-12 19:01:41.407606
10219,259,10652,136,140,3142,14329,2022-03-12 19:01:42.573579
10241,21,344,11,108,140,624,2022-03-12 19:01:43.814726
10250,44,750,35,177,140,1146,2022-03-12 19:01:45.025874
10263,59,2888,39,56,753,3795,2022-03-12 19:01:46.27106
10285,18,162,5,63,133,381,2022-03-12 19:01:47.360275
10306,83,585,56,58,1069,1851,2022-03-12 19:01:48.637262
10330,920,34067,514,1505,3678,40684,2022-03-12 19:01:49.872959
10347,94,334,50,248,456,1182,2022-03-12 19:01:51.077216
10354,54,776,38,60,816,1744,2022-03-12 19:01:52.146216
10361,79,1412,63,92,1503,3149,2022-03-12 19:01:53.43262
10379,8440,139622,4231,2223,71589,226105,2022-03-12 19:01:54.66562
10405,34,2451,25,52,557,3119,2022-03-12 19:01:55.915001
10435,32,310,19,53,463,877,2022-03-12 19:01:57.131642
10456,10230,78174,6496,11111,61151,167162,2022-03-12 19:01:58.137645
10470,671,23788,280,278,8661,33678,2022-03-12 19:01:59.542763
10585,8,483,2,31,65,589,2022-03-12 19:02:11.49064
10490,15329,173432,9100,16765,101224,315850,2022-03-12 19:02:00.573318
10504,346,8663,306,263,5631,15209,2022-03-12 19:02:01.951441
10516,86,2730,38,53,1269,4176,2022-03-12 19:02:03.084865
10531,147,6689,117,135,1996,9084,2022-03-12 19:02:07.342976
10532,295,8760,191,171,4319,13736,2022-03-12 19:02:07.620978
10533,38,137,22,84,231,512,2022-03-12 19:02:07.939978
10545,93,2583,53,84,1056,3869,2022-03-12 19:02:08.991541
10568,11396,110507,8563,9626,83306,223398,2022-03-12 19:02:10.288759
10602,16,69,8,44,175,312,2022-03-12 19:02:12.742638
10622,521,22667,377,214,8701,32480,2022-03-12 19:02:13.780021
10628,284,5207,189,138,3337,9155,2022-03-12 19:02:14.995458
10648,22,156,12,45,287,522,2022-03-12 19:02:16.566099
10674,11,496,3,27,121,658,2022-03-12 19:02:17.538163
10687,306,20113,140,211,4437,25207,2022-03-12 19:02:18.651185
10702,286,16626,123,139,3008,20182,2022-03-12 19:02:20.107529
10711,4942,120646,1758,1340,53526,182212,2022-03-12 19:02:23.359128
10713,575,27088,318,169,7917,36067,2022-03-12 19:02:24.384123
10714,538,25581,281,163,7696,34259,2022-03-12 19:02:25.340238
10715,572,24636,294,174,7844,33520,2022-03-12 19:02:25.61324
10716,515,23877,286,157,7828,32663,2022-03-12 19:02:25.85924
10731,173,7366,104,136,2379,10158,2022-03-12 19:02:27.021342
10741,17,101,11,45,204,378,2022-03-12 19:02:28.238521
10758,21,209,26,110,173,539,2022-03-12 19:02:29.394579
10775,151,2273,125,125,2502,5176,2022-03-12 19:02:30.761761
10797,51,93,12,111,171,438,2022-03-12 19:02:31.844153
10805,1141,82156,614,383,14779,99073,2022-03-12 19:02:33.083628
10819,91,2287,83,82,1517,4060,2022-03-12 19:02:34.29163
10832,156,2344,175,150,1728,4553,2022-03-12 19:02:35.481191
10850,16,82,10,61,85,254,2022-03-12 19:02:36.666194
10862,130,3149,112,137,1710,5238,2022-03-12 19:02:37.969431
10886,174,4089,114,147,2216,6740,2022-03-12 19:02:39.149992
10905,106,2020,83,99,1425,3733,2022-03-12 19:02:40.315551
10923,137,4683,85,89,1785,6779,2022-03-12 19:02:41.593725
10936,119,2039,72,64,1366,3660,2022-03-12 19:02:42.605699
10953,13,66,8,53,69,209,2022-03-12 19:02:43.925051
10987,18,143,14,70,142,387,2022-03-12 19:02:45.207971
11005,1842,24257,624,769,12529,40021,2022-03-12 19:02:46.229979
11043,27,305,14,37,334,717,2022-03-12 19:02:47.401024
11083,289,8065,159,206,2699,11418,2022-03-12 19:02:48.802028
11101,35,294,16,60,311,716,2022-03-12 19:02:49.803141
11179,7328,122248,3866,5205,39961,178608,2022-03-12 19:02:51.0837
11227,3639,28147,2520,3765,27966,66037,2022-03-12 19:02:52.342327
11241,6951,87798,4627,7534,32361,139271,2022-03-12 19:02:53.517444
11281,37,687,25,55,474,1278,2022-03-12 19:02:54.76195
11313,1563,24437,776,608,12848,40232,2022-03-12 19:02:55.846687
11371,2097,39671,1362,1410,11175,55715,2022-03-12 19:02:57.059249
11433,13966,208302,8869,10196,107592,348925,2022-03-12 19:02:58.19927
46422,0,0,0,0,4211,4211,2022-03-12 20:15:11.357909
46423,0,0,0,0,0,0,2022-03-12 20:15:12.256675
46424,0,0,0,0,0,0,2022-03-12 20:15:13.0213
46425,0,0,0,0,0,0,2022-03-12 20:15:13.941465
11491,2196,31503,1160,2439,13243,50541,2022-03-12 19:02:59.592661
11521,32,385,20,76,243,756,2022-03-12 19:03:04.031081
11525,22,86,11,66,157,342,2022-03-12 19:03:04.424078
11531,600,25254,327,225,9108,35514,2022-03-12 19:03:04.763079
11533,29,149,19,72,235,504,2022-03-12 19:03:05.013081
11543,22,1804,8,33,177,2044,2022-03-12 19:03:05.563891
11579,21,704,6,31,148,910,2022-03-12 19:03:06.735902
11615,367,9428,216,215,2340,12566,2022-03-12 19:03:08.070847
11661,79,1051,19,74,682,1905,2022-03-12 19:03:09.225985
11687,36,4261,9,54,406,4766,2022-03-12 19:03:10.401132
11701,1524,149345,881,499,22604,174853,2022-03-12 19:03:11.602385
11729,24,721,4,33,151,933,2022-03-12 19:03:12.771385
11751,6020,49808,3446,5311,41531,106116,2022-03-12 19:03:18.784506
11755,519,8438,247,323,7803,17330,2022-03-12 19:03:19.160505
11757,96343,2304192,31796,111740,144187,2688258,2022-03-12 19:03:19.515966
46426,0,0,0,0,0,0,2022-03-12 20:15:14.811464
46427,0,0,0,0,0,0,2022-03-12 20:15:15.945071
46428,0,0,0,0,0,0,2022-03-12 20:15:16.787493
46429,0,0,0,0,0,0,2022-03-12 20:15:17.635046
11763,3367,18382,1921,5781,20442,49893,2022-03-12 19:03:20.183964
11783,3624,70842,2724,3282,16191,96663,2022-03-12 19:03:21.25172
11793,140,5275,149,94,2746,8404,2022-03-12 19:03:22.442722
11837,6411,72331,3586,6943,34221,123492,2022-03-12 19:03:23.623719
11873,20,366,20,89,145,640,2022-03-12 19:03:25.027717
11915,26,2066,12,68,247,2419,2022-03-12 19:03:26.14853
11979,2594,130290,1332,978,46741,181935,2022-03-12 19:03:27.206573
12027,27,275,24,89,474,889,2022-03-12 19:03:28.510814
12039,36,153,24,91,435,739,2022-03-12 19:03:29.662385
12101,77,1776,34,87,1042,3016,2022-03-12 19:03:30.870971
12131,238,2936,169,191,2476,6010,2022-03-12 19:03:32.128618
12149,2218,33792,1867,3286,16773,57936,2022-03-12 19:03:33.340702
12187,633,35573,379,192,7408,44185,2022-03-12 19:03:34.498703
12237,244,1945,120,204,2529,5042,2022-03-12 19:03:35.69051
12291,14055,171243,10020,11974,81217,288509,2022-03-12 19:03:36.840511
12343,98,1971,82,65,1288,3504,2022-03-12 19:03:38.100193
12367,2580,19435,1734,3514,13324,40587,2022-03-12 19:03:39.286107
12401,35,301,10,39,388,773,2022-03-12 19:03:40.50836
12433,101,3078,60,52,1432,4723,2022-03-12 19:03:41.762362
12449,893,20099,490,533,7246,29261,2022-03-12 19:03:46.819585
12451,15,122,12,50,150,349,2022-03-12 19:03:47.099586
12455,174,5118,160,129,3058,8639,2022-03-12 19:03:47.421651
12461,5594,56777,3763,7267,30627,104028,2022-03-12 19:03:47.696648
12481,62,1033,37,64,423,1619,2022-03-12 19:03:48.41365
12503,699,41969,662,692,11359,55381,2022-03-12 19:03:49.633165
12565,1934,72243,838,467,26890,102372,2022-03-12 19:03:50.973763
12599,39,1234,18,46,300,1637,2022-03-12 19:03:57.925506
12603,38,774,5,58,208,1083,2022-03-12 19:03:58.268503
12611,1982,6399,1748,3636,9311,23076,2022-03-12 19:03:58.584506
12637,150,10602,73,122,1853,12800,2022-03-12 19:03:59.29051
12665,379,16064,250,187,6730,23610,2022-03-12 19:04:03.265659
12669,737,24455,458,283,7302,33235,2022-03-12 19:04:03.631189
12671,282,38586,205,214,4004,43291,2022-03-12 19:04:03.942194
12673,512,30874,270,138,5868,37662,2022-03-12 19:04:04.261188
12689,51,523,27,37,522,1160,2022-03-12 19:04:05.310776
12727,80,2136,72,72,967,3327,2022-03-12 19:04:06.652344
12759,15,83,2,54,88,242,2022-03-12 19:04:07.716979
12783,1640,55049,863,639,28929,87120,2022-03-12 19:04:08.867977
12807,14,135,8,69,124,350,2022-03-12 19:04:10.120424
12851,46,513,25,75,452,1111,2022-03-12 19:04:11.349037
12865,55,1534,34,91,697,2411,2022-03-12 19:04:12.574167
12883,8476,67657,7152,7195,66803,157283,2022-03-12 19:04:13.641246
12903,21,106,4,55,198,384,2022-03-12 19:04:14.828275
12935,26,1905,22,31,290,2274,2022-03-12 19:04:16.065069
12981,30,95,22,40,533,720,2022-03-12 19:04:17.215069
13055,2684,80380,1804,782,15250,100900,2022-03-12 19:04:18.502607
13093,616,29438,335,216,6945,37550,2022-03-12 19:04:22.066346
13103,18,45,8,52,236,359,2022-03-12 19:04:22.444347
13125,48493,280446,33446,30456,309748,702589,2022-03-12 19:04:23.154348
13161,15400,267725,6672,13838,68131,371766,2022-03-12 19:04:24.450922
13175,83,3035,47,64,1287,4516,2022-03-12 19:04:25.730028
13203,3654,24613,2527,1821,22789,55404,2022-03-12 19:04:27.021032
13245,567,6927,370,204,2500,10568,2022-03-12 19:04:28.117502
13261,1783,39462,1004,1589,5093,48931,2022-03-12 19:04:29.284445
13299,42,328,18,51,346,785,2022-03-12 19:04:30.486511
17563,28,177,20,31,303,559,2022-03-12 19:07:52.418919
13335,876,15034,367,222,14583,31082,2022-03-12 19:04:31.747817
13367,9408,123520,4374,7166,48473,192941,2022-03-12 19:04:33.015818
13403,1136,70260,550,369,13099,85414,2022-03-12 19:04:34.081933
13429,730,15606,440,279,9890,26945,2022-03-12 19:04:38.255812
13431,31,151,19,100,189,490,2022-03-12 19:04:38.538813
13433,41,120,24,78,186,449,2022-03-12 19:04:38.850813
13459,16,56,5,71,90,238,2022-03-12 19:04:39.98135
13501,9,81,9,52,83,234,2022-03-12 19:04:41.276905
13515,23,294,10,38,197,562,2022-03-12 19:04:42.437573
13553,15,111,4,64,215,409,2022-03-12 19:04:43.590148
13629,145,15393,61,91,2752,18442,2022-03-12 19:04:44.902181
13673,119,3399,44,57,1263,4882,2022-03-12 19:04:46.144909
13693,33,349,10,46,261,699,2022-03-12 19:04:47.255905
13759,55590,772937,32095,30125,217670,1108417,2022-03-12 19:04:48.505594
13807,1951,99948,800,737,25727,129163,2022-03-12 19:04:52.781035
17985,11,180,5,46,108,350,2022-03-12 19:08:44.113546
13817,24,120,14,68,224,450,2022-03-12 19:04:53.123032
13819,17,112,12,66,120,327,2022-03-12 19:04:53.385031
13833,493,16835,156,152,5194,22830,2022-03-12 19:04:54.461138
13857,15,285,7,20,112,439,2022-03-12 19:04:55.696276
13931,190,4965,170,161,3537,9023,2022-03-12 19:04:56.890309
13969,25,1500,14,44,369,1952,2022-03-12 19:05:01.448946
13971,33,2761,22,79,707,3602,2022-03-12 19:05:01.755448
13983,31,787,16,51,466,1351,2022-03-12 19:05:02.008421
13993,112,802,76,88,1848,2926,2022-03-12 19:05:02.271448
14039,31,94,24,43,639,831,2022-03-12 19:05:03.009425
14075,31727,296624,22359,21299,173395,545404,2022-03-12 19:05:04.189629
14131,11681,159856,7384,10015,74536,263472,2022-03-12 19:05:05.379186
14199,15207,162670,7787,13251,73010,271925,2022-03-12 19:05:06.631626
14247,32,737,14,45,341,1169,2022-03-12 19:05:10.555991
14249,16,211,12,51,242,532,2022-03-12 19:05:10.921968
46565,0,0,0,0,0,0,2022-03-12 20:16:11.012857
46570,0,0,0,0,0,0,2022-03-12 20:16:12.305595
46573,0,0,0,0,0,0,2022-03-12 20:16:13.990671
46584,0,0,0,0,0,0,2022-03-12 20:16:20.698679
14253,23,185,6,48,192,454,2022-03-12 19:05:11.272991
14267,407,7004,254,230,9694,17589,2022-03-12 19:05:14.548393
14277,1093,10858,819,1946,4609,19325,2022-03-12 19:05:15.074395
14283,3321,31270,2304,5770,20417,63082,2022-03-12 19:05:15.320992
14289,21779,417757,10903,16070,113169,579678,2022-03-12 19:05:15.574974
14345,23676,575595,12935,21247,141372,774825,2022-03-12 19:05:16.286557
14373,561,11529,222,183,7012,19507,2022-03-12 19:05:17.455063
46600,0,0,0,0,0,0,2022-03-12 20:16:24.344732
46603,0,0,0,0,0,0,2022-03-12 20:16:25.435651
46616,0,0,0,0,0,0,2022-03-12 20:16:26.661861
46620,0,0,0,0,0,0,2022-03-12 20:16:27.871074
14513,51887,625538,33099,27189,179365,917078,2022-03-12 19:05:18.699158
14563,387,1727,333,579,2185,5211,2022-03-12 19:05:19.876773
14631,9,101,5,64,129,308,2022-03-12 19:05:21.046889
14685,138,2754,113,101,1504,4610,2022-03-12 19:05:22.251466
14749,22093,328700,10708,15227,112074,488802,2022-03-12 19:05:26.088386
14751,18945,59577,12394,15729,24562,131207,2022-03-12 19:05:26.369394
14753,31615,16849,7407,3665,38835,98371,2022-03-12 19:05:27.328391
46624,0,0,0,0,0,0,2022-03-12 20:16:29.173659
46634,0,0,0,0,0,0,2022-03-12 20:16:31.441711
46638,0,0,0,0,0,0,2022-03-12 20:16:32.784884
46641,0,0,0,0,0,0,2022-03-12 20:16:33.960598
14765,8862,50630,5472,8947,29752,103663,2022-03-12 19:05:27.648331
14811,7551,91985,4460,5415,51720,161131,2022-03-12 19:05:28.222974
14827,1438,14582,830,1222,10112,28184,2022-03-12 19:05:29.464982
14889,204,3041,98,93,1901,5337,2022-03-12 19:05:30.634718
14949,46,1278,25,45,436,1830,2022-03-12 19:05:31.785807
15037,8324,257871,4268,6258,59975,336696,2022-03-12 19:05:33.168814
15061,5408,10128,3388,4140,14901,37965,2022-03-12 19:05:34.101958
46644,0,0,0,0,0,0,2022-03-12 20:16:35.02761
47593,0,0,0,0,0,0,2022-03-12 20:25:03.296575
47596,0,0,0,0,0,0,2022-03-12 20:25:04.466822
47599,0,0,0,0,0,0,2022-03-12 20:25:05.647263
15111,20,55,7,52,100,234,2022-03-12 19:05:35.515955
15137,16,270,11,57,127,481,2022-03-12 19:05:36.802299
15197,1842,91327,1059,599,29375,124202,2022-03-12 19:05:37.949856
15227,4291,80338,1657,692,71259,158237,2022-03-12 19:05:43.371929
15279,91,1050,36,47,942,2166,2022-03-12 19:05:43.729003
15291,164,6188,51,129,1170,7702,2022-03-12 19:05:44.068003
15307,102,3120,63,114,1227,4626,2022-03-12 19:05:44.612522
15313,473,6635,374,781,2968,11231,2022-03-12 19:05:44.985525
15377,4628,55336,2795,3616,24573,90948,2022-03-12 19:05:46.220304
15407,456,0,231,172,8154,9013,2022-03-12 19:05:47.274304
15451,22659,711571,8790,11303,54184,808507,2022-03-12 19:05:48.534468
15565,6459,89565,2841,4826,31632,135323,2022-03-12 19:05:50.989718
15591,301,13811,208,127,5378,19825,2022-03-12 19:05:53.202094
15605,6544,118363,3570,12560,25034,166071,2022-03-12 19:05:54.258239
15607,16,283,12,71,243,625,2022-03-12 19:05:54.577275
46769,0,0,0,0,0,0,2022-03-12 20:17:13.862501
46771,0,0,0,0,0,0,2022-03-12 20:17:14.975569
46773,0,0,0,0,0,0,2022-03-12 20:17:16.797898
46774,0,0,0,0,0,0,2022-03-12 20:17:19.524812
15651,1664,17835,1408,1361,11617,33885,2022-03-12 19:05:55.871553
15687,2490,103576,1430,1119,21166,129781,2022-03-12 19:05:57.08958
15729,1317,30595,654,578,8299,41443,2022-03-12 19:05:58.417636
15749,94,124,153,152,191,714,2022-03-12 19:05:59.518639
15775,3254,49215,1698,855,30528,85550,2022-03-12 19:06:00.859137
15785,198,9134,127,157,1953,11569,2022-03-12 19:06:01.984032
15807,282,11988,171,173,3742,16356,2022-03-12 19:06:03.57901
15811,1059,25592,834,405,6061,33951,2022-03-12 19:06:05.857381
15813,446,7399,222,140,7945,16152,2022-03-12 19:06:06.510394
15815,14,174,12,53,168,421,2022-03-12 19:06:07.144394
15823,12,204,8,69,166,459,2022-03-12 19:06:07.943394
15875,28,180,15,100,273,596,2022-03-12 19:06:09.375394
15883,1589,11370,1352,3415,7922,25648,2022-03-12 19:06:11.144573
15891,116,2966,55,75,1183,4395,2022-03-12 19:06:11.775603
15897,21,70,10,61,123,285,2022-03-12 19:06:13.028778
15913,17,167,19,71,155,429,2022-03-12 19:06:15.88904
15915,29,120,11,68,226,454,2022-03-12 19:06:16.726041
15925,59,4745,36,113,531,5484,2022-03-12 19:06:17.069042
15927,468,24442,278,159,5546,30893,2022-03-12 19:06:17.41605
15961,103,440,44,89,805,1481,2022-03-12 19:06:18.862146
15989,434,9849,223,134,2702,13342,2022-03-12 19:06:19.894401
16011,26365,260708,15297,18706,117152,438228,2022-03-12 19:06:21.124396
16041,14,115,8,49,123,309,2022-03-12 19:06:22.191846
16123,1523,19013,780,753,10196,32265,2022-03-12 19:06:23.529823
16163,12,196,4,60,114,386,2022-03-12 19:06:24.817858
16201,9801,77025,7299,16567,80100,190792,2022-03-12 19:06:25.940035
16241,1253,25367,642,628,6676,34566,2022-03-12 19:06:27.034035
16257,22,100,12,54,249,437,2022-03-12 19:06:28.133032
16319,67,2840,47,75,861,3890,2022-03-12 19:06:29.530085
16355,5670,55181,4202,8996,29542,103591,2022-03-12 19:06:30.770762
16381,103,2644,61,74,1716,4598,2022-03-12 19:06:32.028887
16395,359,15037,225,183,4401,20205,2022-03-12 19:06:33.19686
16415,52,837,50,88,958,1985,2022-03-12 19:06:34.424497
16436,211,11952,77,180,2420,14840,2022-03-12 19:06:35.576595
16458,22,140,6,61,203,432,2022-03-12 19:06:37.224989
16468,417,19490,296,196,4888,25287,2022-03-12 19:06:38.543892
16482,8,85,6,63,87,249,2022-03-12 19:06:39.416893
16498,174999,2894770,44701,51771,151724,3317965,2022-03-12 19:06:40.670187
16508,162,2657,99,122,1370,4410,2022-03-12 19:06:41.64219
16518,3781,39422,2403,5051,15562,66219,2022-03-12 19:06:43.335388
16524,13951,210483,7790,8860,67410,308494,2022-03-12 19:06:43.899384
16552,13,70,5,51,113,252,2022-03-12 19:06:45.104676
16562,16,114,8,56,121,315,2022-03-12 19:06:46.432389
16570,9,171,12,80,104,376,2022-03-12 19:06:47.461392
16590,17,114,5,57,161,354,2022-03-12 19:06:48.853181
16608,113,17858,38,154,1060,19223,2022-03-12 19:06:53.693797
16610,20,3925,7,50,278,4280,2022-03-12 19:06:54.173884
16614,134,3933,103,89,1838,6097,2022-03-12 19:06:54.560884
16620,12,112,5,42,98,269,2022-03-12 19:06:54.919883
16656,758,9766,228,225,4236,15213,2022-03-12 19:06:56.036677
16680,267,35240,210,232,4023,39972,2022-03-12 19:06:57.133186
16702,21,591,22,77,256,967,2022-03-12 19:06:58.516308
16718,100,1474,81,112,1657,3424,2022-03-12 19:06:59.671316
16738,54,2052,35,82,810,3033,2022-03-12 19:07:01.400669
16742,32423,360134,24003,43044,122416,582020,2022-03-12 19:07:03.791398
16746,11,63,1,49,66,190,2022-03-12 19:07:04.730507
16748,11,87,5,55,109,267,2022-03-12 19:07:05.099024
16754,9,57,2,53,66,187,2022-03-12 19:07:05.591622
16780,13,68,3,41,80,205,2022-03-12 19:07:06.645219
16798,20,206,11,56,275,568,2022-03-12 19:07:07.951196
16812,17,208,9,75,145,454,2022-03-12 19:07:09.201627
16828,19,109,3,51,100,282,2022-03-12 19:07:10.4605
16868,924,43506,444,219,12720,57813,2022-03-12 19:07:11.645507
16908,20,75,9,81,110,295,2022-03-12 19:07:12.790867
16934,2693,166613,1123,808,30178,201415,2022-03-12 19:07:14.000867
16988,13,124,5,64,78,284,2022-03-12 19:07:15.086909
17048,8,280,12,36,138,474,2022-03-12 19:07:17.785155
17068,27,1472,12,23,256,1790,2022-03-12 19:07:18.204844
17076,27,777,6,59,143,1012,2022-03-12 19:07:18.840844
17090,12,149,11,98,100,370,2022-03-12 19:07:19.958413
17113,60,3103,39,94,554,3850,2022-03-12 19:07:21.262099
17131,35,151,10,49,302,547,2022-03-12 19:07:22.426318
17157,1455,35189,600,585,9937,47766,2022-03-12 19:07:24.607521
17159,16,293,14,56,145,524,2022-03-12 19:07:25.684552
17161,20,259,10,62,163,514,2022-03-12 19:07:26.616733
17165,29,280,16,49,227,601,2022-03-12 19:07:27.195733
17187,1090,37962,529,313,17952,57846,2022-03-12 19:07:28.410846
17213,13,106,7,65,89,280,2022-03-12 19:07:29.780846
17219,13,160,7,63,96,339,2022-03-12 19:07:31.185167
17233,21,205,9,45,295,575,2022-03-12 19:07:32.13558
17249,712,5761,450,653,3985,11561,2022-03-12 19:07:33.597577
17263,14,90,9,62,110,285,2022-03-12 19:07:34.596648
17273,440,11519,266,260,4769,17254,2022-03-12 19:07:35.986242
17293,37,890,14,34,285,1260,2022-03-12 19:07:36.983393
17313,9,84,2,55,85,235,2022-03-12 19:07:38.070416
17325,71,367,39,113,1043,1633,2022-03-12 19:07:39.398992
17351,103,5010,65,52,1411,6641,2022-03-12 19:07:40.751883
17359,20,183,17,76,211,507,2022-03-12 19:07:41.663652
17395,217,4997,93,112,2739,8158,2022-03-12 19:07:42.898651
17419,250,4985,199,196,3221,8851,2022-03-12 19:07:44.335366
17437,480,13830,260,180,7459,22209,2022-03-12 19:07:45.36546
17445,16,120,12,78,166,392,2022-03-12 19:07:46.434609
17471,11,73,5,56,72,217,2022-03-12 19:07:47.691612
17485,11,181,8,42,138,380,2022-03-12 19:07:49.011212
17497,196,1108,133,222,1439,3098,2022-03-12 19:07:50.132212
17521,30,152,19,92,254,547,2022-03-12 19:07:51.411766
17603,27,210,3,60,212,512,2022-03-12 19:07:53.718943
17621,24,207,14,77,270,592,2022-03-12 19:07:57.101728
17623,13,106,10,78,100,307,2022-03-12 19:07:57.65272
17637,642,14317,448,494,6655,22556,2022-03-12 19:07:58.701183
17651,3062,22619,2414,4930,17857,50882,2022-03-12 19:07:59.894183
17665,11,87,4,52,117,271,2022-03-12 19:08:01.629547
17667,21,116,25,86,222,470,2022-03-12 19:08:03.695626
17669,28,112,12,86,169,407,2022-03-12 19:08:05.35139
17671,27,147,23,101,246,544,2022-03-12 19:08:05.956386
17673,20,93,14,66,229,422,2022-03-12 19:08:06.568532
17675,11,60,9,81,121,282,2022-03-12 19:08:07.148535
17681,1727,12759,1190,2971,8028,26675,2022-03-12 19:08:08.29927
17693,35,890,31,63,457,1476,2022-03-12 19:08:09.538271
17703,51,126,47,145,528,897,2022-03-12 19:08:10.632016
17719,23,366,9,55,248,701,2022-03-12 19:08:12.321212
17725,407,23966,287,180,4596,29436,2022-03-12 19:08:16.285706
17727,173,1651,181,124,1476,3605,2022-03-12 19:08:16.972734
17729,25005,366089,12025,17002,120668,540789,2022-03-12 19:08:17.695737
17731,585,6092,551,749,2452,10429,2022-03-12 19:08:18.135738
17741,6908,73539,3763,5808,48900,138918,2022-03-12 19:08:21.765709
17743,717,14679,328,331,6766,22821,2022-03-12 19:08:22.430073
17749,17,146,15,40,198,416,2022-03-12 19:08:23.213071
17753,22,159,9,43,199,432,2022-03-12 19:08:23.848073
26225,10,33,2,42,55,142,2022-03-12 19:18:21.491188
17777,8427,91840,4252,8932,41090,154541,2022-03-12 19:08:24.584694
17785,23,460,19,48,331,881,2022-03-12 19:08:25.202259
17811,55,3420,34,51,516,4076,2022-03-12 19:08:26.114804
17821,3238,24214,2231,4471,17415,51569,2022-03-12 19:08:27.460561
17831,7737,80096,4391,10130,31063,133417,2022-03-12 19:08:28.454149
17871,235,2819,112,86,2084,5336,2022-03-12 19:08:29.83915
17887,68,961,28,36,541,1634,2022-03-12 19:08:31.050858
17897,43,1245,16,43,475,1822,2022-03-12 19:08:32.125361
17917,301,2304,197,288,1253,4343,2022-03-12 19:08:33.389703
17951,21,370,7,45,154,597,2022-03-12 19:08:34.611402
17959,34,449,24,69,435,1011,2022-03-12 19:08:35.902963
17969,115,228,83,142,666,1234,2022-03-12 19:08:39.587216
17977,13,170,7,37,121,348,2022-03-12 19:08:40.55832
17979,14,157,8,40,110,329,2022-03-12 19:08:41.162345
17981,14,118,8,42,118,300,2022-03-12 19:08:41.749426
17983,12,202,9,47,114,384,2022-03-12 19:08:43.076545
17987,14,197,8,44,117,380,2022-03-12 19:08:44.810695
17991,33,195,12,55,340,635,2022-03-12 19:08:53.851597
18001,6047,113683,4019,5439,22873,152061,2022-03-12 19:08:54.603276
18003,22,450,11,61,280,824,2022-03-12 19:08:55.095274
18005,19,136,18,72,137,382,2022-03-12 19:08:55.596423
18029,14,214,7,44,120,399,2022-03-12 19:08:56.11742
18045,663,26553,322,195,7273,35006,2022-03-12 19:08:57.288426
18063,22,335,18,95,352,822,2022-03-12 19:08:58.503531
18085,17,280,4,45,139,485,2022-03-12 19:08:59.920526
18087,12,167,9,46,117,351,2022-03-12 19:09:00.892229
18115,33026,540710,17200,13059,144963,748958,2022-03-12 19:09:02.461475
18133,39,490,7,83,157,776,2022-03-12 19:09:03.365472
18153,53934,624314,31582,30089,287119,1027038,2022-03-12 19:09:04.719589
18179,15097,128919,9988,9057,44593,207654,2022-03-12 19:09:06.035598
18197,67,241,26,77,290,701,2022-03-12 19:09:10.168366
46777,0,0,0,0,0,0,2022-03-12 20:17:23.057624
46779,0,0,0,0,0,0,2022-03-12 20:17:25.894493
46781,0,0,0,0,0,0,2022-03-12 20:17:32.103314
46783,0,0,0,0,0,0,2022-03-12 20:17:32.915832
18199,56,215,24,73,209,577,2022-03-12 19:09:10.693737
18205,126,945,96,316,539,2022,2022-03-12 19:09:11.187737
18227,44,110,22,110,209,495,2022-03-12 19:09:11.793734
18229,9229,81564,7619,10843,64677,173932,2022-03-12 19:09:12.337737
18241,23,141,15,94,166,439,2022-03-12 19:09:13.041891
18273,17,178,8,37,117,357,2022-03-12 19:09:14.63407
18283,9,68,2,52,75,206,2022-03-12 19:09:17.524702
18295,3153,66030,1914,1917,14449,87463,2022-03-12 19:09:17.870702
18301,7,52,3,38,58,158,2022-03-12 19:09:18.263701
18307,21,108,4,60,118,311,2022-03-12 19:09:19.443853
18313,14,88,3,61,91,257,2022-03-12 19:09:20.722724
18317,7,60,1,39,62,169,2022-03-12 19:09:21.762719
18323,11,69,3,46,62,191,2022-03-12 19:09:22.594298
18339,13,76,2,59,90,240,2022-03-12 19:09:23.9873
18355,11,93,8,65,97,274,2022-03-12 19:09:25.316965
18377,13,129,4,66,99,311,2022-03-12 19:09:26.531058
18397,14334,320714,6678,2539,47266,391531,2022-03-12 19:09:27.445058
18429,461,20690,231,227,5854,27463,2022-03-12 19:09:28.762236
18449,71,1478,52,87,975,2663,2022-03-12 19:09:29.994749
18463,11,372,3,22,60,468,2022-03-12 19:09:31.41571
18475,19,60,6,51,108,244,2022-03-12 19:09:32.686906
18495,3196,18143,2196,4993,18190,46718,2022-03-12 19:09:33.675879
18521,21,101,12,38,126,298,2022-03-12 19:09:35.015517
18533,16,361,11,47,237,672,2022-03-12 19:09:38.648223
18549,90,1605,61,102,1241,3099,2022-03-12 19:09:39.409226
18557,46,516,25,62,530,1179,2022-03-12 19:09:39.983235
18561,9,356,3,28,55,451,2022-03-12 19:09:40.606224
18567,30,105,16,52,220,423,2022-03-12 19:09:41.373218
18573,16,79,5,55,105,260,2022-03-12 19:09:43.873757
18575,10,136,5,49,76,276,2022-03-12 19:09:44.888345
18577,14,99,8,41,76,238,2022-03-12 19:09:45.805414
18583,25,78,7,48,159,317,2022-03-12 19:09:46.422414
18587,13,268,10,47,152,490,2022-03-12 19:09:47.21849
18591,13,139,8,63,84,307,2022-03-12 19:09:48.065488
18603,34,719,30,67,391,1241,2022-03-12 19:09:49.174957
18631,19,65,15,36,184,319,2022-03-12 19:09:50.302555
18661,6044,86067,1182,519,16946,110758,2022-03-12 19:09:51.597039
18689,23645,112948,14936,10247,52222,213998,2022-03-12 19:09:52.795205
18723,32,389,9,32,213,675,2022-03-12 19:09:54.078206
18747,13,211,8,32,119,383,2022-03-12 19:09:57.898055
18753,2679,207239,985,533,25470,236906,2022-03-12 19:09:58.532054
18755,196,2743,189,221,1219,4568,2022-03-12 19:09:59.288141
18759,15,146,11,69,137,378,2022-03-12 19:10:01.309141
18767,4960,42938,3867,9014,23206,83985,2022-03-12 19:10:01.742153
18771,584,2215,501,1755,2505,7560,2022-03-12 19:10:02.244154
18773,14,64,5,54,81,218,2022-03-12 19:10:02.540151
18817,8,81,6,62,94,251,2022-03-12 19:10:03.445265
18829,12,159,6,43,115,335,2022-03-12 19:10:04.952813
18849,470,22168,279,165,7923,31005,2022-03-12 19:10:06.402816
18881,201,5317,243,313,3726,9800,2022-03-12 19:10:07.18096
18937,15,132,13,70,103,333,2022-03-12 19:10:08.24396
18983,16,79,12,71,92,270,2022-03-12 19:10:09.729322
19029,332,8042,219,204,3200,11997,2022-03-12 19:10:10.991043
19063,18,71,8,56,133,286,2022-03-12 19:10:11.87705
19087,20,130,8,78,108,344,2022-03-12 19:10:14.311738
19099,88,6077,84,113,1503,7865,2022-03-12 19:10:14.959906
19111,8625,176577,4896,4217,39157,233472,2022-03-12 19:10:15.769463
19123,1296,42174,387,426,7759,52042,2022-03-12 19:10:16.615498
19157,4220,7306,3507,5222,5564,25819,2022-03-12 19:10:17.954651
19171,53,292,35,75,261,716,2022-03-12 19:10:19.177763
19193,711,26675,366,206,13354,41312,2022-03-12 19:10:23.787896
19195,658,22841,372,191,13315,37377,2022-03-12 19:10:24.362898
19207,177,1241,148,208,1289,3063,2022-03-12 19:10:24.877895
19209,10,260,12,36,149,467,2022-03-12 19:10:25.475898
19211,892,29667,574,287,6707,38127,2022-03-12 19:10:25.769897
19221,14383,260847,6515,9039,82840,373624,2022-03-12 19:10:30.385504
19231,15,706,5,28,105,859,2022-03-12 19:10:30.751782
19233,17,850,11,42,214,1134,2022-03-12 19:10:31.334817
19235,12,655,2,23,116,808,2022-03-12 19:10:31.842887
19237,12,528,6,22,91,659,2022-03-12 19:10:32.324882
19261,276,7198,190,294,4612,12570,2022-03-12 19:10:33.218983
19297,77,2467,48,75,717,3384,2022-03-12 19:10:34.613516
19319,3788,43849,2213,2770,14329,66949,2022-03-12 19:10:35.862815
19363,3879,102894,2423,1220,22469,132885,2022-03-12 19:10:36.911951
19391,3314,31919,2995,2706,9486,50420,2022-03-12 19:10:38.403953
19429,11804,151837,7141,13414,62414,246610,2022-03-12 19:10:39.440977
19445,28,85,14,114,165,406,2022-03-12 19:10:40.811653
19463,10,60,2,48,59,179,2022-03-12 19:10:45.808121
19467,39,84,20,61,423,627,2022-03-12 19:10:46.767202
26227,11,35,2,42,57,147,2022-03-12 19:18:21.808162
19469,793,24670,331,343,8509,34646,2022-03-12 19:10:46.978461
19479,28,216,23,55,287,609,2022-03-12 19:10:47.403459
19481,14,432,4,23,94,567,2022-03-12 19:10:47.835463
19501,29,81,12,60,166,348,2022-03-12 19:10:48.93855
19515,23,91,12,50,187,363,2022-03-12 19:10:50.224801
19533,15,213,8,45,198,479,2022-03-12 19:10:51.458278
19557,18,173,13,69,97,370,2022-03-12 19:10:52.560302
19583,9,62,2,45,62,180,2022-03-12 19:10:53.714957
19619,54,806,34,77,486,1457,2022-03-12 19:10:54.832738
19671,2798,47227,2310,1067,14978,68380,2022-03-12 19:10:56.106838
19697,963,20533,684,304,9182,31666,2022-03-12 19:10:57.351273
19717,16,107,7,48,108,286,2022-03-12 19:10:58.505275
19751,15,102,4,57,113,291,2022-03-12 19:11:01.394472
19753,12,67,5,40,73,197,2022-03-12 19:11:01.828471
19755,48,352,36,104,183,723,2022-03-12 19:11:02.158475
19773,23,250,20,65,270,628,2022-03-12 19:11:03.15257
19815,77616,1711514,33350,48524,235110,2106114,2022-03-12 19:11:04.857764
19831,25,104,17,63,230,439,2022-03-12 19:11:06.91674
19839,19,76,10,50,132,287,2022-03-12 19:11:08.337739
19841,1310,18761,855,1448,8270,30644,2022-03-12 19:11:08.948737
19843,24,152,15,83,252,526,2022-03-12 19:11:09.401739
19873,15,89,14,62,154,334,2022-03-12 19:11:10.455342
19897,19,137,5,65,174,400,2022-03-12 19:11:11.669027
19917,12,83,5,57,107,264,2022-03-12 19:11:14.557653
19919,680,2889,512,772,6408,11261,2022-03-12 19:11:15.022807
19921,27,99,6,49,210,391,2022-03-12 19:11:15.285876
19947,31,158,24,93,250,556,2022-03-12 19:11:16.441908
19965,14,86,11,59,114,284,2022-03-12 19:11:17.584301
19987,21,76,12,79,109,297,2022-03-12 19:11:18.977951
19997,26,109,18,77,175,405,2022-03-12 19:11:19.982974
20021,3797,245596,1411,1746,30713,283263,2022-03-12 19:11:21.211151
20033,1924,27314,1245,2984,12806,46273,2022-03-12 19:11:22.505154
20053,3369,26011,2523,7355,15318,54576,2022-03-12 19:11:23.869888
20079,24,99,14,81,153,371,2022-03-12 19:11:25.047388
20087,27,103,9,59,152,350,2022-03-12 19:11:26.227451
20111,15,63,3,49,96,226,2022-03-12 19:11:27.272489
20127,24,107,16,70,159,376,2022-03-12 19:11:28.407494
20155,126,2178,89,137,1459,3989,2022-03-12 19:11:29.48963
20183,19,111,17,73,176,396,2022-03-12 19:11:30.776642
20205,9,77,7,60,80,233,2022-03-12 19:11:35.7244
20207,26,241,24,48,335,674,2022-03-12 19:11:36.104373
20221,376,11793,208,115,4518,17010,2022-03-12 19:11:36.479485
20225,19,173,10,55,213,470,2022-03-12 19:11:37.018605
20239,21,84,9,73,164,351,2022-03-12 19:11:38.171604
20365,283,17994,264,306,4360,23207,2022-03-12 19:11:39.491411
20423,349,20660,243,149,5969,27370,2022-03-12 19:11:44.011587
20431,7834,50348,5280,6386,48660,118508,2022-03-12 19:11:44.291588
20441,34,351,11,63,365,824,2022-03-12 19:11:44.568684
20449,1104,60435,556,475,18530,81100,2022-03-12 19:11:44.821687
20469,43,326,14,44,536,963,2022-03-12 19:11:45.61029
20509,4447,100560,2372,2310,34755,144444,2022-03-12 19:11:46.846268
20543,1057,28887,459,496,14027,44926,2022-03-12 19:11:48.002937
20587,39,377,16,62,290,784,2022-03-12 19:11:49.147421
20671,154,3507,72,57,2836,6626,2022-03-12 19:11:50.691027
20707,45,3005,28,52,491,3621,2022-03-12 19:11:51.668794
20755,13,89,10,78,168,358,2022-03-12 19:11:52.821794
20815,695,27508,245,355,8208,37011,2022-03-12 19:11:54.175643
20857,28,1648,14,25,201,1916,2022-03-12 19:11:55.297908
20899,45828,842294,15227,9047,66717,979113,2022-03-12 19:11:56.393934
20919,467,18243,194,313,4309,23526,2022-03-12 19:11:57.712038
20951,26,839,9,29,311,1214,2022-03-12 19:11:58.87404
20973,7972,65395,4630,6290,48823,133110,2022-03-12 19:12:00.096727
21019,12,57,4,55,64,192,2022-03-12 19:12:01.312694
21037,41,132,15,62,434,684,2022-03-12 19:12:02.492693
21067,1495,15557,846,2817,9388,30103,2022-03-12 19:12:03.679693
21089,22,621,8,27,210,888,2022-03-12 19:12:04.862697
21121,20,100,9,42,206,377,2022-03-12 19:12:06.24723
21177,8502,40336,6198,13032,25819,93887,2022-03-12 19:12:08.192369
21179,55,747,23,46,534,1405,2022-03-12 19:12:08.583346
21235,478,12646,294,370,5715,19503,2022-03-12 19:12:09.723343
21277,13,119,7,59,89,287,2022-03-12 19:12:10.925528
21325,986,11799,636,1002,5366,19789,2022-03-12 19:12:12.086696
21353,9773,88260,6754,13833,41625,160245,2022-03-12 19:12:13.308697
21415,1589,23452,1053,591,7569,34254,2022-03-12 19:12:14.646696
21433,14,152,12,86,193,457,2022-03-12 19:12:15.806044
21447,27,111,11,82,201,432,2022-03-12 19:12:17.060733
21473,1287,52956,556,335,19299,74433,2022-03-12 19:12:18.484296
21483,24,76,8,62,156,326,2022-03-12 19:12:22.27371
21485,12,72,6,54,91,235,2022-03-12 19:12:23.232718
21489,13,166,4,59,106,348,2022-03-12 19:12:29.077407
21491,23,119,8,70,112,332,2022-03-12 19:12:29.823517
21493,20,338,10,75,147,590,2022-03-12 19:12:30.486514
21495,478,4824,253,378,3713,9646,2022-03-12 19:12:31.499709
21497,202,3270,83,117,1883,5555,2022-03-12 19:12:35.942571
21507,8436,115426,6242,20290,37759,188153,2022-03-12 19:12:36.499568
21509,17,73,5,62,97,254,2022-03-12 19:12:38.551645
21511,11852,103723,7289,13511,66642,203017,2022-03-12 19:12:39.064647
46784,0,0,0,0,0,0,2022-03-12 20:17:33.691851
46785,0,0,0,0,0,0,2022-03-12 20:17:34.498021
46786,0,0,0,0,0,0,2022-03-12 20:17:35.374672
46788,0,0,0,0,0,0,2022-03-12 20:17:36.601183
21517,7,78,4,44,56,189,2022-03-12 19:12:39.604399
21523,59,1252,39,140,481,1971,2022-03-12 19:12:40.248989
21525,13,120,4,48,108,293,2022-03-12 19:12:40.862989
21541,944,20456,513,405,8994,31312,2022-03-12 19:12:46.206817
21545,16,90,8,45,157,316,2022-03-12 19:12:47.166818
21547,19,73,7,51,121,271,2022-03-12 19:12:47.946334
21549,17,111,9,67,155,359,2022-03-12 19:12:48.611329
21551,14,70,6,70,113,273,2022-03-12 19:12:49.228754
21553,11,80,4,70,71,236,2022-03-12 19:12:49.717758
21561,12609,119821,6330,7476,73921,220157,2022-03-12 19:12:53.871003
21563,6764,81735,3609,7695,32844,132647,2022-03-12 19:12:54.410004
21569,263,33172,179,201,4020,37835,2022-03-12 19:12:54.906105
21571,86,3735,82,116,1450,5469,2022-03-12 19:12:55.391293
21573,2120,25541,1017,859,12578,42115,2022-03-12 19:12:55.884297
21595,98,1644,66,136,1316,3260,2022-03-12 19:12:56.922295
21635,619,26763,277,180,7010,34849,2022-03-12 19:12:58.218967
21649,140,2762,66,61,1514,4543,2022-03-12 19:12:59.349969
21671,420,4696,387,656,2203,8362,2022-03-12 19:13:00.553124
21695,114,5356,102,131,1732,7435,2022-03-12 19:13:01.602319
21713,22,152,15,61,129,379,2022-03-12 19:13:02.915296
21743,6946,54861,4615,6409,43398,116229,2022-03-12 19:13:03.988294
21771,298,9415,109,161,2793,12776,2022-03-12 19:13:05.205993
21831,11,535,5,46,99,696,2022-03-12 19:13:07.596469
21853,185,4977,154,190,3239,8745,2022-03-12 19:13:08.825469
21875,40,831,11,35,354,1271,2022-03-12 19:13:09.963501
21933,12,113,3,64,77,269,2022-03-12 19:13:11.269107
21943,13,117,3,62,73,268,2022-03-12 19:13:12.422709
21959,14,111,7,63,76,271,2022-03-12 19:13:16.087363
21961,11,118,5,65,83,282,2022-03-12 19:13:16.594395
21967,12,104,7,67,86,276,2022-03-12 19:13:17.138399
21995,31798,552626,15193,16092,166660,782369,2022-03-12 19:13:18.323823
22037,13,88,3,61,57,222,2022-03-12 19:13:19.6515
22057,403,17786,203,129,5645,24166,2022-03-12 19:13:20.731501
22099,289,609,198,744,902,2742,2022-03-12 19:13:21.839502
22131,12,46,4,55,76,193,2022-03-12 19:13:23.301501
22157,12,859,9,45,140,1065,2022-03-12 19:13:24.554651
22167,11,368,11,31,137,558,2022-03-12 19:13:25.70186
22177,15,890,12,40,209,1166,2022-03-12 19:13:26.77186
22205,28,377,2,41,122,570,2022-03-12 19:13:27.980958
22239,14,196,9,40,157,416,2022-03-12 19:13:29.250954
22265,20665,281041,12026,11219,48644,373595,2022-03-12 19:13:30.504991
22293,16,300,8,30,126,480,2022-03-12 19:13:31.785621
22319,92349,2042360,31400,49660,207164,2422933,2022-03-12 19:13:32.862598
22345,23,233,7,55,114,432,2022-03-12 19:13:34.104721
22385,13,672,2,34,108,829,2022-03-12 19:13:35.199435
22417,17,361,4,36,88,506,2022-03-12 19:13:36.570026
22435,112,1803,68,85,1353,3421,2022-03-12 19:13:37.856106
29617,17,1104,8,50,146,1325,2022-03-12 19:20:58.364006
22445,12,196,5,44,115,372,2022-03-12 19:13:38.889104
22449,13,201,3,46,115,378,2022-03-12 19:13:40.023538
22465,42,100,20,93,341,596,2022-03-12 19:13:41.329128
22477,13,179,8,45,114,359,2022-03-12 19:13:42.453003
22487,19,240,4,52,127,442,2022-03-12 19:13:43.695229
22497,26,394,10,57,242,729,2022-03-12 19:13:44.957938
22511,19,195,26,107,135,482,2022-03-12 19:13:46.111328
22541,22,178,12,82,163,457,2022-03-12 19:13:47.289335
22567,13,144,2,40,82,281,2022-03-12 19:13:48.546934
22577,15,141,3,44,96,299,2022-03-12 19:13:49.757935
22593,12,168,6,41,92,319,2022-03-12 19:13:50.921105
22607,12,204,12,59,112,399,2022-03-12 19:13:52.755137
22609,10,130,4,45,67,256,2022-03-12 19:13:53.28116
22617,9,117,5,44,87,262,2022-03-12 19:13:54.403411
22627,9,115,5,44,97,270,2022-03-12 19:13:55.843116
22637,12,134,7,43,84,280,2022-03-12 19:13:57.069173
22643,10,85,6,42,86,229,2022-03-12 19:13:58.061473
22653,10,91,5,48,79,233,2022-03-12 19:13:59.486606
22661,171,4767,175,214,2531,7858,2022-03-12 19:14:00.647195
22671,19,211,10,64,192,496,2022-03-12 19:14:01.950789
22677,359,12069,170,157,4310,17065,2022-03-12 19:14:02.94879
22693,757,3717,541,697,3877,9589,2022-03-12 19:14:11.563032
22695,199,8515,169,194,2725,11802,2022-03-12 19:14:12.089031
22699,267,10926,176,225,3270,14864,2022-03-12 19:14:12.450033
22709,15,109,6,70,86,286,2022-03-12 19:14:12.941058
22711,10,62,4,59,75,210,2022-03-12 19:14:13.415032
22745,302,16081,175,159,3981,20698,2022-03-12 19:14:14.73643
22759,617,20860,366,189,7930,29962,2022-03-12 19:14:15.933643
22789,27332,372433,16277,9292,160138,585472,2022-03-12 19:14:17.434638
22817,1170,7584,863,1340,5704,16661,2022-03-12 19:14:18.104764
22839,1511,47135,395,219,18772,68032,2022-03-12 19:14:19.314761
22859,556,24743,391,226,7986,33902,2022-03-12 19:14:20.411782
22955,809,1564,812,1842,4278,9305,2022-03-12 19:14:21.710973
22979,19,117,9,51,170,366,2022-03-12 19:14:22.873973
22995,6,44,14,73,54,191,2022-03-12 19:14:23.99143
23007,9,75,10,78,111,283,2022-03-12 19:14:25.369042
23023,81,3003,60,112,1026,4282,2022-03-12 19:14:26.464647
23051,14,729,7,32,175,957,2022-03-12 19:14:27.610401
23063,36,1083,14,42,443,1618,2022-03-12 19:14:28.911376
23085,17,75,6,42,121,261,2022-03-12 19:14:30.160062
23115,211,3635,199,172,3477,7694,2022-03-12 19:14:31.432177
23133,4645,19179,3634,7056,19661,54175,2022-03-12 19:14:32.524181
23153,514,7158,314,172,4097,12255,2022-03-12 19:14:33.998093
23181,11,84,21,100,90,306,2022-03-12 19:14:35.092139
23189,36,648,40,116,291,1131,2022-03-12 19:14:36.191349
23213,320,2948,237,695,2336,6536,2022-03-12 19:14:37.317357
23245,12,99,3,56,87,257,2022-03-12 19:14:38.565234
23269,3214,44266,2132,1543,21731,72886,2022-03-12 19:14:39.782676
23277,32571,339817,15912,17374,161153,566827,2022-03-12 19:14:40.944305
23293,638,14888,258,188,8740,24712,2022-03-12 19:14:42.058279
23313,14,130,8,63,105,320,2022-03-12 19:14:43.532273
23321,35344,394102,21579,19045,82744,552814,2022-03-12 19:14:44.787537
23341,986,17117,738,788,6036,25665,2022-03-12 19:14:45.715548
23353,22,87,6,42,161,318,2022-03-12 19:14:47.117548
23367,73,1306,48,62,655,2144,2022-03-12 19:14:48.744637
30979,7,34,2,45,37,125,2022-03-12 19:24:14.319816
23375,104,229,86,229,997,1645,2022-03-12 19:14:52.695809
23383,803,48285,367,176,9555,59186,2022-03-12 19:14:53.528805
23385,2017,83836,934,351,27500,114638,2022-03-12 19:14:54.02129
23387,65,737,32,74,580,1488,2022-03-12 19:14:54.773296
23393,16,274,14,91,114,509,2022-03-12 19:14:55.264848
23399,514,13936,306,200,8117,23073,2022-03-12 19:14:56.140063
23405,456,5826,347,213,5512,12354,2022-03-12 19:14:56.881062
23433,589,8323,305,516,3605,13338,2022-03-12 19:15:28.459804
23439,109,3267,40,41,1279,4736,2022-03-12 19:15:28.865806
23441,649,48611,229,309,8273,58071,2022-03-12 19:15:29.336807
23447,754,33451,383,202,9433,44223,2022-03-12 19:15:29.82283
23515,14,175,7,50,120,366,2022-03-12 19:15:31.044158
23551,448,8086,241,394,2761,11930,2022-03-12 19:15:32.136134
23583,41,443,16,75,443,1018,2022-03-12 19:15:33.449138
23597,20,245,9,47,156,477,2022-03-12 19:15:34.559289
23615,19,178,15,49,278,539,2022-03-12 19:15:35.872103
23627,161,2146,114,173,2368,4962,2022-03-12 19:15:36.962127
23643,11,130,5,54,91,291,2022-03-12 19:15:38.076285
23675,14,95,20,70,230,429,2022-03-12 19:15:39.340283
23697,311,7523,227,219,3186,11466,2022-03-12 19:15:40.674402
23707,18,107,6,53,109,293,2022-03-12 19:15:41.72043
23725,1059,12820,505,277,8260,22921,2022-03-12 19:15:43.145584
23733,72,0,27,40,216,355,2022-03-12 19:15:44.23869
23753,53,465,32,60,560,1170,2022-03-12 19:15:45.610866
23765,11,116,10,47,169,353,2022-03-12 19:15:46.900225
23775,1817,67829,1015,1156,29631,101448,2022-03-12 19:15:48.048755
23787,621,5728,499,1151,3107,11106,2022-03-12 19:15:53.563311
23799,10,77,6,66,74,233,2022-03-12 19:15:54.13655
23801,9,53,4,54,90,210,2022-03-12 19:15:54.667546
23815,15,116,17,79,138,365,2022-03-12 19:15:55.445556
23819,20,91,7,45,198,361,2022-03-12 19:15:55.806583
23829,15,98,5,63,168,349,2022-03-12 19:15:56.496902
23847,30817,743811,11597,8283,112527,907035,2022-03-12 19:15:58.115062
23855,18,119,12,47,180,376,2022-03-12 19:16:01.703249
23857,23,93,9,66,106,297,2022-03-12 19:16:02.269644
23861,15,108,7,65,170,365,2022-03-12 19:16:02.833647
23863,13,57,5,51,76,202,2022-03-12 19:16:03.396672
23865,12,78,3,51,132,276,2022-03-12 19:16:04.156746
23869,8,37,6,36,85,172,2022-03-12 19:16:04.800761
23889,17,86,9,45,190,347,2022-03-12 19:16:06.015733
23909,12,193,4,45,97,351,2022-03-12 19:16:07.477747
23931,88,908,49,96,1131,2272,2022-03-12 19:16:08.392882
23969,14,107,15,88,158,382,2022-03-12 19:16:10.016879
23979,18,43,8,46,213,328,2022-03-12 19:16:11.064507
23989,764,15234,351,308,6124,22781,2022-03-12 19:16:12.184546
24023,0,0,0,0,1231,1231,2022-03-12 19:16:13.180528
24045,21,97,14,32,167,331,2022-03-12 19:16:14.520552
24071,20,374,27,65,335,821,2022-03-12 19:16:15.80165
46794,0,0,0,0,0,0,2022-03-12 20:17:39.022704
46809,0,0,0,0,0,0,2022-03-12 20:17:42.822058
46810,0,0,0,0,0,0,2022-03-12 20:17:44.091659
46812,0,0,0,0,0,0,2022-03-12 20:17:45.285677
24087,52,240,31,64,440,827,2022-03-12 19:16:17.061159
24121,15,70,8,43,78,214,2022-03-12 19:16:18.183292
24127,44,1015,19,31,600,1709,2022-03-12 19:16:19.383287
24159,15,100,7,50,188,360,2022-03-12 19:16:20.468055
24181,12,908,4,45,125,1094,2022-03-12 19:16:21.804057
24211,4021,72128,2029,4211,18648,101037,2022-03-12 19:16:22.905575
24259,26,187,11,42,171,437,2022-03-12 19:16:24.227751
24315,12,192,3,27,48,282,2022-03-12 19:16:25.319337
24371,107,2305,71,113,1581,4177,2022-03-12 19:16:26.568898
24417,53,271,46,105,423,898,2022-03-12 19:16:27.792874
24443,21,265,8,65,200,559,2022-03-12 19:16:28.989954
24457,137,1190,101,110,1218,2756,2022-03-12 19:16:30.14256
24475,2118,35831,1390,585,8621,48545,2022-03-12 19:16:31.444187
24531,2618,18030,965,1127,14255,36995,2022-03-12 19:16:32.800383
24573,20,123,25,108,112,388,2022-03-12 19:16:33.841359
24603,12,179,4,68,110,373,2022-03-12 19:16:35.043576
24629,5265,30318,4108,7451,27494,74636,2022-03-12 19:16:36.373316
24647,19,187,5,68,143,422,2022-03-12 19:16:37.515317
24675,29,353,14,77,255,728,2022-03-12 19:16:38.640889
24683,14,69,2,61,76,222,2022-03-12 19:16:39.728892
24703,22328,604017,8515,11246,57926,704032,2022-03-12 19:16:40.909004
24751,609,28088,305,234,7689,36925,2022-03-12 19:16:42.308003
24775,33,18,7,66,101,225,2022-03-12 19:16:43.373001
24791,6,65,6,55,62,194,2022-03-12 19:16:44.777054
24797,9,53,5,37,45,149,2022-03-12 19:16:45.825664
24809,11,90,5,52,70,228,2022-03-12 19:16:50.499449
24811,11,132,4,32,78,257,2022-03-12 19:16:51.100446
24817,108,581,64,90,579,1422,2022-03-12 19:16:51.729446
24819,15,70,4,49,148,286,2022-03-12 19:16:52.203916
24833,101821,1216396,63908,54440,239946,1676511,2022-03-12 19:16:53.855919
24835,284,4485,176,388,1545,6878,2022-03-12 19:16:54.454005
24845,67,45,23,143,217,495,2022-03-12 19:16:55.226711
24865,7,60,7,54,89,217,2022-03-12 19:16:56.705018
24877,16,151,11,46,136,360,2022-03-12 19:16:57.735017
24905,7,233,10,35,67,352,2022-03-12 19:17:01.879729
24909,844,5708,612,1282,4097,12543,2022-03-12 19:17:02.55771
24913,708,35424,343,186,8359,45020,2022-03-12 19:17:03.125729
24921,894,15917,451,297,11335,28894,2022-03-12 19:17:03.801705
24973,651,7598,554,321,7051,16175,2022-03-12 19:17:04.981788
24989,31,166,17,73,220,507,2022-03-12 19:17:06.205383
25011,934,26264,567,393,10348,38506,2022-03-12 19:17:07.329041
25033,24,236,11,52,189,512,2022-03-12 19:17:08.446491
25053,20,132,9,43,171,375,2022-03-12 19:17:09.801465
25065,28,363,19,45,346,801,2022-03-12 19:17:11.106435
25077,72,700,56,98,1287,2213,2022-03-12 19:17:12.195435
25087,37,440,23,66,331,897,2022-03-12 19:17:13.247594
25101,9,102,2,42,47,202,2022-03-12 19:17:14.534269
25149,10,170,2,37,86,305,2022-03-12 19:17:18.970946
25157,30710,541208,13606,24791,124688,735003,2022-03-12 19:17:19.353947
25159,19696,231190,9954,12669,101084,374593,2022-03-12 19:17:19.62592
25183,36681,305591,20055,23637,120585,506549,2022-03-12 19:17:20.414575
25267,50,532,28,52,392,1054,2022-03-12 19:17:21.694594
25291,24,830,14,59,488,1415,2022-03-12 19:17:22.994775
25313,836,23492,419,324,10561,35632,2022-03-12 19:17:24.351316
25341,861,9977,890,285,3425,15438,2022-03-12 19:17:25.312412
46814,0,0,0,0,0,0,2022-03-12 20:17:46.282714
46817,0,0,0,0,0,0,2022-03-12 20:17:47.366337
47602,0,0,0,0,0,0,2022-03-12 20:25:06.828435
47607,0,0,0,0,0,0,2022-03-12 20:25:08.783377
25389,1281,138870,355,320,8778,149604,2022-03-12 19:17:26.459494
25441,86,674,71,85,909,1825,2022-03-12 19:17:27.886497
25495,16,1212,7,22,165,1422,2022-03-12 19:17:28.988117
25537,7468,249934,2230,982,113360,373974,2022-03-12 19:17:30.263688
25547,11,96,5,42,64,218,2022-03-12 19:17:31.551685
25591,38,275,17,38,296,664,2022-03-12 19:17:32.650688
25607,8,36,4,57,59,164,2022-03-12 19:17:33.861693
25617,8,60,4,47,49,168,2022-03-12 19:17:35.061699
25635,208,2000,213,133,2300,4854,2022-03-12 19:17:36.190253
25681,13376,248977,6279,4204,53567,326403,2022-03-12 19:17:37.620698
25719,153,7382,82,73,1894,9584,2022-03-12 19:17:38.691698
25777,80931,1957422,16509,14155,161034,2230051,2022-03-12 19:17:39.613699
25833,87,384,44,80,1791,2386,2022-03-12 19:17:40.85858
25871,29,324,20,56,139,568,2022-03-12 19:17:42.300579
25889,25,373,12,52,253,715,2022-03-12 19:17:43.319579
25941,11,128,9,66,136,350,2022-03-12 19:17:44.626875
25967,17,448,11,70,97,643,2022-03-12 19:17:45.943987
25975,8,347,3,40,54,452,2022-03-12 19:17:46.912825
25987,20,62,7,53,178,320,2022-03-12 19:17:53.076382
25991,75,1567,24,57,706,2429,2022-03-12 19:17:53.641382
25999,159,1285,96,145,1327,3012,2022-03-12 19:17:54.019386
26009,7,114,3,33,51,208,2022-03-12 19:17:58.603527
26011,7,267,5,44,54,377,2022-03-12 19:17:59.084525
26013,9,254,6,57,53,379,2022-03-12 19:17:59.653629
26017,9,263,7,59,60,398,2022-03-12 19:18:03.757584
26019,234,3780,133,142,2331,6620,2022-03-12 19:18:04.140584
26023,1194,38407,470,286,12056,52413,2022-03-12 19:18:04.70071
26033,11,55,5,49,117,237,2022-03-12 19:18:05.170713
26057,784,25248,416,278,10346,37072,2022-03-12 19:18:06.308721
26089,8,54,5,57,50,174,2022-03-12 19:18:07.600903
26097,8,59,4,47,70,188,2022-03-12 19:18:08.593901
26107,10,33,4,47,58,152,2022-03-12 19:18:09.849903
26117,17,174,9,64,180,444,2022-03-12 19:18:11.002075
26139,9,34,2,45,55,145,2022-03-12 19:18:12.339073
26149,8,45,2,50,41,146,2022-03-12 19:18:13.552158
26159,25,106,10,50,224,415,2022-03-12 19:18:14.733183
26197,10,56,5,50,123,244,2022-03-12 19:18:15.903724
26219,8,31,2,51,49,141,2022-03-12 19:18:19.493402
26221,8,32,3,43,41,127,2022-03-12 19:18:20.585648
26223,11,61,3,43,55,173,2022-03-12 19:18:21.059648
26239,8,39,4,49,59,159,2022-03-12 19:18:23.075029
26251,7,35,3,39,44,128,2022-03-12 19:18:24.247029
26263,9,27,3,47,66,152,2022-03-12 19:18:25.530201
26275,9,36,3,49,74,171,2022-03-12 19:18:26.823906
26281,9,38,3,43,100,193,2022-03-12 19:18:27.910904
26293,8,33,4,42,47,134,2022-03-12 19:18:29.046558
26307,9,54,4,50,56,173,2022-03-12 19:18:30.357559
26319,7,35,2,46,42,132,2022-03-12 19:18:31.423955
26333,9,35,7,44,55,150,2022-03-12 19:18:32.712211
26347,14,140,5,36,102,297,2022-03-12 19:18:33.768211
26447,8,164,3,38,63,276,2022-03-12 19:18:35.055777
27375,18,72,11,74,182,357,2022-03-12 19:18:36.19341
27399,19,88,6,63,156,332,2022-03-12 19:18:37.483556
27441,5145,30633,3119,5381,32156,76434,2022-03-12 19:18:41.691721
27451,15,228,13,67,72,395,2022-03-12 19:18:42.987392
27453,10,140,9,49,55,263,2022-03-12 19:18:43.843066
27455,13,207,10,64,66,360,2022-03-12 19:18:44.246703
27457,14,200,10,79,69,372,2022-03-12 19:18:44.942028
27467,13,128,4,65,58,268,2022-03-12 19:18:47.23194
27491,13,132,6,65,110,326,2022-03-12 19:18:48.98457
27493,12,81,7,59,72,231,2022-03-12 19:18:49.317572
27495,13,158,8,60,103,342,2022-03-12 19:18:52.318384
27497,16,109,4,62,86,277,2022-03-12 19:18:52.606637
27501,12,114,4,59,75,264,2022-03-12 19:18:52.939638
27503,708,4714,508,2011,2879,10820,2022-03-12 19:18:53.22464
27551,15,73,11,58,78,235,2022-03-12 19:18:54.295639
27575,20,100,13,100,195,428,2022-03-12 19:18:59.510181
27577,11,94,15,95,110,325,2022-03-12 19:18:59.871182
27579,13,52,4,52,89,210,2022-03-12 19:19:00.121193
27613,450,4605,397,324,3240,9016,2022-03-12 19:19:00.773268
27653,56,2798,32,88,587,3561,2022-03-12 19:19:02.603267
27677,37,331,22,40,313,743,2022-03-12 19:19:03.322292
27721,103,196,69,86,463,917,2022-03-12 19:19:04.43927
27783,2944,35488,1266,4071,17572,61341,2022-03-12 19:19:06.120549
27789,23,840,10,30,171,1074,2022-03-12 19:19:07.609732
27811,44,221,22,69,237,593,2022-03-12 19:19:08.28873
27831,13965,246964,8135,3976,84679,357719,2022-03-12 19:19:09.191376
27847,11,44,4,42,56,157,2022-03-12 19:19:13.06879
27849,8,43,3,53,51,158,2022-03-12 19:19:13.37979
27851,9,45,2,52,67,175,2022-03-12 19:19:13.637793
27855,8,52,4,50,62,176,2022-03-12 19:19:14.148794
27911,3071,18728,2017,3104,13111,40031,2022-03-12 19:19:19.552062
27915,20,146,8,70,166,410,2022-03-12 19:19:19.863086
27921,8,40,4,44,60,156,2022-03-12 19:19:20.11406
27927,825,6703,409,1412,5321,14670,2022-03-12 19:19:20.357166
27947,5350,22628,3392,1891,27598,60859,2022-03-12 19:19:21.079169
27967,716,10142,328,179,6592,17957,2022-03-12 19:19:26.154956
27969,1113,13364,514,402,19890,35283,2022-03-12 19:19:26.514952
27989,20362,200661,12253,10126,153222,396624,2022-03-12 19:19:26.782106
27991,17796,193469,9770,8332,69635,299002,2022-03-12 19:19:27.102133
28013,7398,27645,3309,4201,27023,69576,2022-03-12 19:19:27.738111
28041,28,993,9,58,189,1277,2022-03-12 19:19:28.874727
28057,9,315,5,42,73,444,2022-03-12 19:19:30.131765
28085,41,1437,22,46,673,2219,2022-03-12 19:19:31.324828
28101,10,68,2,55,90,225,2022-03-12 19:19:32.565825
43242,0,14,2,6,11,33,2022-03-12 19:48:16.234362
28117,11,70,9,54,119,263,2022-03-12 19:19:33.84596
28143,25,469,7,58,221,780,2022-03-12 19:19:36.438987
28171,78763,1107959,33380,37078,186174,1443354,2022-03-12 19:19:37.355978
28211,1773,22084,793,766,28621,54037,2022-03-12 19:19:38.618979
28237,14,197,9,48,155,423,2022-03-12 19:19:39.748047
28263,14,102,8,39,141,304,2022-03-12 19:19:40.99216
28305,8,287,4,35,75,409,2022-03-12 19:19:44.555477
28339,23,1894,11,68,289,2285,2022-03-12 19:19:44.956479
28351,86,5475,25,58,830,6474,2022-03-12 19:19:47.951009
28353,8,50,3,31,51,143,2022-03-12 19:19:48.418011
28355,5,207,2,33,38,285,2022-03-12 19:19:48.823576
28367,30,291,17,59,339,736,2022-03-12 19:19:49.315579
28391,8987,74851,5124,12915,36717,138594,2022-03-12 19:19:50.68628
28427,26,94,14,39,184,357,2022-03-12 19:19:51.806345
28485,6,43,2,38,46,135,2022-03-12 19:19:52.969922
28549,8,37,2,44,43,134,2022-03-12 19:19:55.397125
28563,10,44,4,50,52,160,2022-03-12 19:19:56.568232
28577,7,26,2,42,41,118,2022-03-12 19:19:57.85472
28593,445,6317,267,176,4498,11703,2022-03-12 19:19:59.100866
28619,7600,55208,4663,12457,29393,109321,2022-03-12 19:20:00.185843
28631,23,365,2,33,115,538,2022-03-12 19:20:04.058682
28637,17,795,16,42,213,1083,2022-03-12 19:20:04.523216
28639,9,640,8,29,127,813,2022-03-12 19:20:04.817217
28641,9,690,5,31,200,935,2022-03-12 19:20:05.147918
28665,11,279,7,36,97,430,2022-03-12 19:20:06.241133
28685,18,213,2,37,154,424,2022-03-12 19:20:07.28687
28715,22,1024,6,23,181,1256,2022-03-12 19:20:08.621863
28755,6919,361765,1270,1665,32689,404308,2022-03-12 19:20:09.881986
28805,7949,252538,2364,827,105158,368836,2022-03-12 19:20:15.351212
28811,62,458,36,76,747,1379,2022-03-12 19:20:18.70378
28813,31,467,42,71,571,1182,2022-03-12 19:20:19.909706
28815,33,456,35,62,465,1051,2022-03-12 19:20:20.245303
28817,5403,42207,3520,6153,25960,83243,2022-03-12 19:20:20.502295
28827,7,226,8,45,73,359,2022-03-12 19:20:21.143589
28851,38443,1612575,5274,2547,236634,1895473,2022-03-12 19:20:22.92462
28869,265,3557,157,201,1538,5718,2022-03-12 19:20:23.509618
28911,33,603,30,82,573,1321,2022-03-12 19:20:24.753626
28929,873,7670,530,4088,5756,18917,2022-03-12 19:20:25.971669
28963,49,506,19,43,584,1201,2022-03-12 19:20:27.114743
28989,19,231,6,37,111,404,2022-03-12 19:20:28.362746
29035,332,3711,180,224,2075,6522,2022-03-12 19:20:29.52345
29095,14830,269323,6186,5133,69354,364826,2022-03-12 19:20:30.6926
29107,7,277,4,34,54,376,2022-03-12 19:20:31.993906
29163,2926,20505,2086,2786,20446,48749,2022-03-12 19:20:33.258021
29207,7,85,2,41,59,194,2022-03-12 19:20:34.34802
29249,11,122,6,35,95,269,2022-03-12 19:20:35.577082
29283,19,131,16,44,156,366,2022-03-12 19:20:36.76309
29325,1989,18222,1339,1448,16861,39859,2022-03-12 19:20:38.041565
29357,5,109,4,36,38,192,2022-03-12 19:20:39.127263
29371,11,42,3,40,51,147,2022-03-12 19:20:40.365878
29385,14,61,4,59,72,210,2022-03-12 19:20:41.69656
29397,11,172,4,36,56,279,2022-03-12 19:20:42.775566
29419,73,2399,74,115,1058,3719,2022-03-12 19:20:44.067184
29431,32,18,12,81,94,237,2022-03-12 19:20:45.170752
29455,6,283,1,37,43,370,2022-03-12 19:20:48.171311
29457,7,172,2,29,42,252,2022-03-12 19:20:48.875314
29459,9,183,1,32,32,257,2022-03-12 19:20:49.124867
29475,9,141,4,43,72,269,2022-03-12 19:20:49.972866
29489,11,52,4,56,48,171,2022-03-12 19:20:51.111896
29499,10,52,8,52,52,174,2022-03-12 19:20:52.358893
29515,42,472,44,74,729,1361,2022-03-12 19:20:53.58001
29541,10,95,7,47,73,232,2022-03-12 19:20:54.764011
29557,12,246,7,46,87,398,2022-03-12 19:20:56.015847
29603,43,84,16,93,185,421,2022-03-12 19:20:57.272007
29643,561,0,306,278,3598,4743,2022-03-12 19:20:59.549376
29657,18,260,9,44,229,560,2022-03-12 19:21:00.703373
29675,11,211,3,36,48,309,2022-03-12 19:21:01.956551
29707,30,1427,14,40,267,1778,2022-03-12 19:21:03.14106
29715,93,180,63,212,2011,2559,2022-03-12 19:21:04.27706
29738,20,80,8,64,102,274,2022-03-12 19:21:05.589843
29745,9,49,5,51,57,171,2022-03-12 19:21:06.75586
29752,14,150,9,65,116,354,2022-03-12 19:21:07.94852
29765,25,378,13,28,429,873,2022-03-12 19:21:09.232628
29770,13,508,5,22,114,662,2022-03-12 19:21:10.313375
29786,38135,475389,18567,24990,135435,692516,2022-03-12 19:21:11.610394
29797,8,123,4,38,61,234,2022-03-12 19:21:12.777394
29814,12,117,2,42,68,241,2022-03-12 19:21:14.02149
29830,302,3564,188,126,4358,8538,2022-03-12 19:21:17.228428
29831,401,3618,213,181,5178,9591,2022-03-12 19:21:17.547428
29832,13,83,10,65,90,261,2022-03-12 19:21:17.865432
29837,46,201,16,59,340,662,2022-03-12 19:21:18.728431
29854,18197,111065,11313,13615,50789,204979,2022-03-12 19:21:20.023005
29863,30,496,24,80,626,1256,2022-03-12 19:21:21.228752
29886,16,59,4,52,117,248,2022-03-12 19:21:22.483806
29898,12,152,5,33,70,272,2022-03-12 19:21:23.593905
29907,8,509,4,27,128,676,2022-03-12 19:21:24.860918
29921,8,207,3,46,61,325,2022-03-12 19:21:26.099255
29927,41,923,30,71,808,1873,2022-03-12 19:21:27.120821
29937,30,199,16,68,242,555,2022-03-12 19:21:28.405823
29948,6,73,7,82,76,244,2022-03-12 19:21:29.788976
29957,8,729,4,28,70,839,2022-03-12 19:21:56.355638
29961,15,205,5,37,114,376,2022-03-12 19:21:56.74063
29966,8,135,2,28,43,216,2022-03-12 19:22:23.372099
29970,9,154,1,31,49,244,2022-03-12 19:22:23.679095
29971,9,271,6,29,56,371,2022-03-12 19:22:24.026095
29974,5711,97611,2624,7030,20075,133051,2022-03-12 19:22:24.781102
29984,22,855,5,45,123,1050,2022-03-12 19:22:25.992974
29995,16,1419,8,35,150,1628,2022-03-12 19:22:27.102005
30014,7772,40036,4360,5434,32405,90007,2022-03-12 19:22:28.267117
30025,12,48,3,51,51,165,2022-03-12 19:22:29.355121
30039,322,3085,186,335,996,4924,2022-03-12 19:22:30.789234
30048,8,49,5,55,61,178,2022-03-12 19:22:31.819866
30055,6,42,1,35,46,130,2022-03-12 19:22:32.98386
30065,9,193,3,31,60,296,2022-03-12 19:22:36.210673
30066,26,242,14,36,204,522,2022-03-12 19:22:36.602695
30070,11,120,5,37,52,225,2022-03-12 19:22:36.846672
30076,6,225,2,32,44,309,2022-03-12 19:22:37.835772
30083,7,143,1,37,31,219,2022-03-12 19:22:39.004772
30092,10,447,3,34,43,537,2022-03-12 19:22:40.271315
30099,11,110,5,45,86,257,2022-03-12 19:22:44.448172
30100,437,10852,290,270,6204,18053,2022-03-12 19:22:44.873172
30103,44,1016,29,59,499,1647,2022-03-12 19:22:45.11718
30104,9,196,2,19,42,268,2022-03-12 19:22:45.361312
30107,7,69,2,47,61,186,2022-03-12 19:22:46.377253
30121,13,56,6,65,46,186,2022-03-12 19:22:47.361256
30133,19,335,7,34,268,663,2022-03-12 19:22:48.721319
30143,50,974,31,72,607,1734,2022-03-12 19:22:49.905426
30152,11,127,9,58,96,301,2022-03-12 19:22:51.168029
30158,7,92,4,34,58,195,2022-03-12 19:22:52.221276
30165,11,249,1,42,47,350,2022-03-12 19:22:53.471277
30177,13,316,7,60,96,492,2022-03-12 19:22:54.638286
30199,5,241,2,27,47,322,2022-03-12 19:22:55.846108
30207,9,97,2,43,44,195,2022-03-12 19:22:57.136113
30213,7,197,3,35,77,319,2022-03-12 19:22:58.213248
30234,13,1143,5,48,147,1356,2022-03-12 19:22:59.386272
30247,12,131,8,45,97,293,2022-03-12 19:23:02.090124
30249,36,117,17,49,322,541,2022-03-12 19:23:02.499122
30262,192,3102,75,131,1036,4536,2022-03-12 19:23:03.067122
30279,4758,76558,2270,1534,26803,111923,2022-03-12 19:23:04.263595
30298,28,262,10,65,242,607,2022-03-12 19:23:05.812319
30309,56,150,29,79,747,1061,2022-03-12 19:23:06.621318
30327,10,288,2,37,69,406,2022-03-12 19:23:08.007889
30334,9,252,4,38,77,380,2022-03-12 19:23:09.350889
30339,11,277,4,25,52,369,2022-03-12 19:23:10.456625
30344,1642,20775,939,700,9347,33403,2022-03-12 19:23:11.529648
30360,9,91,0,38,59,197,2022-03-12 19:23:12.773644
30370,8367,82044,3611,1075,21715,116812,2022-03-12 19:23:13.867283
30382,1791,7321,1100,3323,7843,21378,2022-03-12 19:23:14.997281
30393,9,218,1,23,58,309,2022-03-12 19:23:16.296982
30400,11,275,5,41,80,412,2022-03-12 19:23:17.544008
30409,11,51,8,57,63,190,2022-03-12 19:23:18.831084
30417,20,77,12,73,160,342,2022-03-12 19:23:19.945221
30428,5,423,4,21,48,501,2022-03-12 19:23:21.288306
30437,1587,25165,691,1545,7975,36963,2022-03-12 19:23:22.439688
30446,12,273,3,37,95,420,2022-03-12 19:23:23.589689
30457,17,113,18,94,112,354,2022-03-12 19:23:24.703837
30468,9,154,4,40,118,325,2022-03-12 19:23:25.878538
30484,63339,395567,23688,15305,240025,737924,2022-03-12 19:23:27.190539
30512,31,97,24,41,629,822,2022-03-12 19:23:28.485674
30531,104,2590,58,162,1665,4579,2022-03-12 19:23:29.722699
30544,25093,443376,8962,21390,82407,581228,2022-03-12 19:23:30.857813
47012,0,0,0,0,0,0,2022-03-12 20:19:14.564916
47015,0,0,0,0,0,0,2022-03-12 20:19:15.673982
47019,0,0,0,0,0,0,2022-03-12 20:19:16.978609
47608,0,0,0,0,0,0,2022-03-12 20:25:09.632445
30567,505,13447,193,220,3321,17686,2022-03-12 19:23:31.948814
30600,87,3737,41,71,1020,4956,2022-03-12 19:23:33.252812
30634,11,67,6,37,110,231,2022-03-12 19:23:34.442911
30651,780,2581,571,1444,1480,6856,2022-03-12 19:23:35.682685
30664,8,276,6,34,79,403,2022-03-12 19:23:36.861253
30679,705,3835,282,264,5109,10195,2022-03-12 19:23:41.353247
30686,81,2852,75,119,1101,4228,2022-03-12 19:23:41.620244
30694,101989,484461,24841,32438,51361,695090,2022-03-12 19:23:42.025897
30709,8125,99216,2420,1261,30799,141821,2022-03-12 19:23:42.831894
30732,13,145,10,71,147,386,2022-03-12 19:23:43.960391
30746,592,7468,316,991,3049,12416,2022-03-12 19:23:45.130364
30759,7,31,2,44,43,127,2022-03-12 19:23:46.426701
30765,7,31,1,44,39,122,2022-03-12 19:23:47.442704
30782,4399,45070,1857,7202,19520,78048,2022-03-12 19:23:48.748704
30814,10,255,7,32,71,375,2022-03-12 19:23:50.354439
30829,233,5474,157,202,3081,9147,2022-03-12 19:23:51.201463
30851,37,257,20,109,244,667,2022-03-12 19:23:52.397164
30864,8,165,3,29,44,249,2022-03-12 19:23:53.509164
30886,16,473,8,36,180,713,2022-03-12 19:23:57.477205
30892,15,98,12,91,110,326,2022-03-12 19:23:57.887531
30896,140,3053,107,102,2178,5580,2022-03-12 19:24:02.222364
30901,9117,48705,5207,7205,28440,98674,2022-03-12 19:24:02.855364
30902,1027,36765,465,261,11266,49784,2022-03-12 19:24:03.207357
30903,51,2645,31,57,616,3400,2022-03-12 19:24:03.589382
30913,292,6060,156,179,2615,9302,2022-03-12 19:24:04.806771
30921,70,500,46,46,1250,1912,2022-03-12 19:24:05.991024
30927,9,36,4,51,46,146,2022-03-12 19:24:07.279
30932,7,33,2,51,45,138,2022-03-12 19:24:08.441133
30941,9,27,2,52,57,147,2022-03-12 19:24:09.526145
30953,591,4365,658,396,4385,10395,2022-03-12 19:24:10.759936
30961,8,53,5,56,69,191,2022-03-12 19:24:11.942299
30973,8,123,15,85,81,312,2022-03-12 19:24:13.217297
30988,404,4562,279,112,2025,7382,2022-03-12 19:24:15.650471
30998,6,55,3,54,42,160,2022-03-12 19:24:16.945967
31003,7,48,2,51,55,163,2022-03-12 19:24:18.024051
31014,73,1437,22,70,505,2107,2022-03-12 19:24:19.239049
31020,12,51,5,56,69,193,2022-03-12 19:24:20.283821
31049,1609,16837,1032,2441,3009,24928,2022-03-12 19:24:21.459817
31064,130,1420,87,100,1196,2933,2022-03-12 19:24:25.835485
31065,175,1331,83,100,1128,2817,2022-03-12 19:24:26.138648
31068,93,1096,52,153,548,1942,2022-03-12 19:24:26.433625
31091,3249,36888,1271,2661,19691,63760,2022-03-12 19:24:31.852084
31096,1095,19436,799,369,7880,29579,2022-03-12 19:24:32.134484
31098,6224,81535,2884,2579,26106,119328,2022-03-12 19:24:32.452487
31108,106,2250,79,123,1166,3724,2022-03-12 19:24:35.639671
31111,35,1036,14,47,569,1701,2022-03-12 19:24:36.779458
31129,5,56,5,35,63,164,2022-03-12 19:24:37.880457
31144,71,2987,20,32,752,3862,2022-03-12 19:24:39.061805
31158,190,4075,121,102,2627,7115,2022-03-12 19:24:40.320518
31173,12807,229638,7273,4395,56698,310811,2022-03-12 19:24:41.482516
31202,21,364,17,67,274,743,2022-03-12 19:24:42.707053
31231,271,24376,193,174,4300,29314,2022-03-12 19:24:43.990383
31238,22,246,6,55,176,505,2022-03-12 19:24:45.157385
31245,6521,109765,2064,1012,71948,191310,2022-03-12 19:24:46.228929
31259,17,459,10,38,147,671,2022-03-12 19:24:47.417929
31267,5,423,7,40,112,587,2022-03-12 19:24:48.677605
31298,339,7867,260,214,3625,12305,2022-03-12 19:24:49.871605
31318,7870,48274,5428,18311,22222,102105,2022-03-12 19:24:51.169579
31338,20256,226698,6665,18867,52740,325226,2022-03-12 19:24:52.319703
31369,33,60,14,54,152,313,2022-03-12 19:24:53.545702
31380,4048,55120,1389,595,14531,75683,2022-03-12 19:24:54.759379
31410,69,250,52,125,444,940,2022-03-12 19:24:55.808979
31433,7266,32331,2826,3543,25744,71710,2022-03-12 19:24:57.219688
47128,0,0,0,0,0,0,2022-03-12 20:19:58.914757
47132,0,0,0,0,0,0,2022-03-12 20:20:00.203111
47136,0,0,0,0,0,0,2022-03-12 20:20:01.475773
47139,0,0,0,0,0,0,2022-03-12 20:20:02.748749
31448,283,7114,206,214,3260,11077,2022-03-12 19:24:58.391308
31464,7,61,2,42,47,159,2022-03-12 19:24:59.592281
31483,1338,52006,625,334,14966,69269,2022-03-12 19:25:04.362199
31485,152,2687,75,141,1712,4767,2022-03-12 19:25:04.739195
31486,102,1822,65,97,1817,3903,2022-03-12 19:25:05.060204
31490,3048,135275,761,486,21887,161457,2022-03-12 19:25:05.236833
31498,1886,16763,855,3569,7182,30255,2022-03-12 19:25:06.019807
31507,12,488,4,34,99,637,2022-03-12 19:25:07.214996
31513,6,467,4,28,48,553,2022-03-12 19:25:08.284112
31530,179,2202,163,136,3287,5967,2022-03-12 19:25:09.62711
31549,176,757,150,708,579,2370,2022-03-12 19:25:10.799773
31560,597,9051,357,374,3531,13910,2022-03-12 19:25:11.900773
31573,374,1716,282,748,1145,4265,2022-03-12 19:25:13.355516
31582,13,185,6,30,129,363,2022-03-12 19:25:14.559007
31588,10115,51513,5303,10868,22631,100430,2022-03-12 19:25:18.469279
31592,4706,93920,2085,2940,10260,113911,2022-03-12 19:25:18.806298
31598,502,10462,185,343,9134,20626,2022-03-12 19:25:19.329274
31617,140,913,90,80,3447,4670,2022-03-12 19:25:20.50442
31631,2239,1708,1216,3199,5923,14285,2022-03-12 19:25:21.61942
31639,10,127,0,36,49,222,2022-03-12 19:25:22.777642
31645,1021,35072,349,336,13362,50140,2022-03-12 19:25:24.055644
31667,94,1,42,98,205,440,2022-03-12 19:25:25.038811
31675,447,9645,354,356,8012,18814,2022-03-12 19:25:26.412595
31687,20,1808,10,46,237,2121,2022-03-12 19:25:30.379985
31688,12,587,3,29,60,691,2022-03-12 19:25:30.698985
31690,14,45,5,44,107,215,2022-03-12 19:25:31.170988
31697,7,36,4,41,44,132,2022-03-12 19:25:32.401164
31722,14583,537997,3755,5384,61818,623537,2022-03-12 19:25:34.814732
31746,15,80,7,69,92,263,2022-03-12 19:25:35.994313
31757,7189,289254,2122,913,81822,381300,2022-03-12 19:25:37.167708
31764,16890,185957,5801,7905,67034,283587,2022-03-12 19:25:38.341047
43252,0,12,0,10,11,33,2022-03-12 19:48:17.589361
31783,6169,43269,2888,1954,15519,69799,2022-03-12 19:25:39.640059
31804,5419,32595,3320,8443,20347,70124,2022-03-12 19:25:40.769015
31830,17,669,5,23,91,805,2022-03-12 19:25:42.027006
31845,18114,145397,6661,18028,61273,249473,2022-03-12 19:25:43.18355
31865,553,4109,277,490,2490,7919,2022-03-12 19:25:44.439702
31872,8,124,2,36,37,207,2022-03-12 19:25:45.671306
31882,7,111,2,38,37,195,2022-03-12 19:25:46.843707
31894,67,1097,34,68,768,2034,2022-03-12 19:25:48.079866
31909,118,6673,71,58,1434,8354,2022-03-12 19:25:49.290624
31923,91,1036,93,112,1372,2704,2022-03-12 19:25:53.271895
31924,12,59,3,53,56,183,2022-03-12 19:25:53.584918
31925,16,284,4,26,91,421,2022-03-12 19:25:53.8679
31926,22,174,8,21,196,421,2022-03-12 19:25:54.118922
31948,14,78,10,91,90,283,2022-03-12 19:25:55.233114
31972,14,321,4,29,96,464,2022-03-12 19:25:58.557217
31973,2803,28783,1187,639,13096,46508,2022-03-12 19:25:58.841212
31984,33,369,32,58,484,976,2022-03-12 19:25:59.995247
32010,17,134,7,49,107,314,2022-03-12 19:26:01.254278
32026,158,8669,87,126,1997,11037,2022-03-12 19:26:06.524815
32030,84,2135,16,78,702,3015,2022-03-12 19:26:06.959788
32031,56,1940,19,68,477,2560,2022-03-12 19:26:07.280814
32032,8763,44710,4303,8425,34902,101103,2022-03-12 19:26:07.629791
32038,1914,13006,1178,1124,10499,27721,2022-03-12 19:26:08.178814
32065,55,712,13,32,423,1235,2022-03-12 19:26:09.338952
32087,17,216,12,71,347,663,2022-03-12 19:26:10.596211
32107,13,137,8,47,177,382,2022-03-12 19:26:11.651204
32143,14,110,12,77,142,355,2022-03-12 19:26:14.413941
32144,38,115,6,45,201,405,2022-03-12 19:26:14.718943
32147,12,116,9,66,105,308,2022-03-12 19:26:15.469552
32153,515,15635,287,210,8183,24830,2022-03-12 19:26:16.647694
32171,3809,17487,1884,5742,21839,50761,2022-03-12 19:26:17.786683
32189,15816,214898,7670,7474,64571,310429,2022-03-12 19:26:18.946109
32214,3411,17133,2151,5375,14270,42340,2022-03-12 19:26:20.194108
32224,8,88,3,40,49,188,2022-03-12 19:26:21.52941
32229,6,58,2,50,30,146,2022-03-12 19:26:22.502112
32248,381,333,142,171,2590,3617,2022-03-12 19:26:23.838109
32256,20,383,10,36,193,642,2022-03-12 19:26:24.936252
32264,42,1131,22,56,389,1640,2022-03-12 19:26:26.115251
32276,15,48,4,54,101,222,2022-03-12 19:26:27.443469
32291,15,350,5,27,106,503,2022-03-12 19:26:28.605569
32298,12,505,5,24,69,615,2022-03-12 19:26:29.709569
32321,161,2406,92,87,2145,4891,2022-03-12 19:26:31.028807
32344,8,280,3,20,43,354,2022-03-12 19:26:32.311819
32359,79,2756,75,111,1094,4115,2022-03-12 19:26:33.463815
32369,12,46,4,52,86,200,2022-03-12 19:26:34.889395
32379,18412,175178,6316,29355,79076,308337,2022-03-12 19:26:35.64656
32397,104,597,55,66,1053,1875,2022-03-12 19:26:37.151839
32409,1004,20041,478,357,7746,29626,2022-03-12 19:26:38.237839
32419,9,60,4,54,58,185,2022-03-12 19:26:39.388411
32438,13171,118013,5691,23301,43574,203750,2022-03-12 19:26:40.543604
32461,107,1949,54,50,1739,3899,2022-03-12 19:26:41.769621
32476,154,1912,99,129,2540,4834,2022-03-12 19:26:43.107701
32491,4070,63943,1535,1005,42707,113260,2022-03-12 19:26:45.356881
32494,12066,70406,5726,12709,28435,129342,2022-03-12 19:26:47.976678
32502,166,1383,104,98,1667,3418,2022-03-12 19:26:48.337684
32503,74,580,26,55,619,1354,2022-03-12 19:26:48.696403
32511,220,1757,147,140,2473,4737,2022-03-12 19:26:49.366399
32542,49987,399467,31567,43846,140565,665432,2022-03-12 19:26:50.498317
32551,1226,51821,517,446,13029,67039,2022-03-12 19:26:51.371324
32559,14,69,1,38,52,174,2022-03-12 19:26:52.615317
32571,421,635,265,755,625,2701,2022-03-12 19:26:53.801344
32583,8,158,0,28,36,230,2022-03-12 19:26:54.949825
32600,33,884,10,35,275,1237,2022-03-12 19:26:56.142482
32732,7,93,0,35,43,178,2022-03-12 19:27:10.273605
32615,45584,507737,21236,25648,157678,757883,2022-03-12 19:27:01.74442
32618,6,243,1,23,35,308,2022-03-12 19:27:02.040423
32621,11,66,3,41,64,185,2022-03-12 19:27:02.312421
32627,8,31,5,57,60,161,2022-03-12 19:27:03.170452
32637,14,320,5,32,66,437,2022-03-12 19:27:04.341453
32663,55,165,26,108,331,685,2022-03-12 19:27:05.627919
32691,336,2148,233,366,1243,4326,2022-03-12 19:27:07.960039
32707,76,295,44,81,386,882,2022-03-12 19:27:09.257521
32739,77,1571,60,109,1136,2953,2022-03-12 19:27:11.475601
32751,36,410,13,57,217,733,2022-03-12 19:27:14.563219
32752,11,123,1,16,31,182,2022-03-12 19:27:14.863221
32755,6,265,2,18,54,345,2022-03-12 19:27:15.222351
32762,5,219,2,15,41,282,2022-03-12 19:27:16.473888
32767,7,266,4,23,40,340,2022-03-12 19:27:17.623944
32777,5,180,2,20,29,236,2022-03-12 19:27:18.659029
32788,8,179,4,20,34,245,2022-03-12 19:27:20.048029
32806,102,1663,59,118,1129,3071,2022-03-12 19:27:22.489688
32813,10,884,3,40,82,1019,2022-03-12 19:27:23.584065
32823,14,46,4,48,81,193,2022-03-12 19:27:24.83719
32831,247,1,111,101,160,620,2022-03-12 19:27:25.932791
32844,11,197,3,18,51,280,2022-03-12 19:27:27.157435
32854,10,459,3,21,71,564,2022-03-12 19:27:28.434407
32860,8,126,2,17,46,199,2022-03-12 19:27:29.5096
32869,611,21519,292,311,9693,32426,2022-03-12 19:27:30.673364
32884,10,61,4,58,70,203,2022-03-12 19:27:32.03936
32890,24,103,3,52,115,297,2022-03-12 19:27:33.138515
32901,34301,442610,14587,43387,97423,632308,2022-03-12 19:27:34.477548
32907,8,84,1,39,31,163,2022-03-12 19:27:35.963868
32924,9795,44130,5115,9152,51197,119389,2022-03-12 19:27:36.816107
32933,12,208,6,48,70,344,2022-03-12 19:27:37.957104
32946,106,2704,61,71,1543,4485,2022-03-12 19:27:39.14013
43258,0,8,1,7,15,31,2022-03-12 19:48:18.622026
32954,875,8659,620,643,4369,15166,2022-03-12 19:27:40.371678
32981,6348,36822,3012,20752,29340,96274,2022-03-12 19:27:41.600123
33002,19,76,11,93,104,303,2022-03-12 19:27:42.829229
33013,1747,15748,735,475,9306,28011,2022-03-12 19:27:43.979255
33026,434,952,243,1167,1676,4472,2022-03-12 19:27:45.21193
33035,234,7088,117,91,3653,11183,2022-03-12 19:27:46.435971
33045,989,5781,575,1271,4392,13008,2022-03-12 19:27:47.659539
33051,9052,81375,3785,2251,21086,117549,2022-03-12 19:27:48.923764
33069,319,11378,171,131,5025,17024,2022-03-12 19:27:49.980555
33080,4466,51599,1946,2040,14662,74713,2022-03-12 19:27:51.246747
33089,4529,34635,2543,4483,28049,74239,2022-03-12 19:27:52.42633
33105,49,554,26,68,478,1175,2022-03-12 19:27:53.568304
33115,8,74,2,47,58,189,2022-03-12 19:27:54.807718
33126,47,213,21,42,398,721,2022-03-12 19:27:56.064776
33135,14,82,12,86,84,278,2022-03-12 19:27:57.183778
33149,98,784,71,103,1201,2257,2022-03-12 19:28:00.772588
33150,69,651,58,106,967,1851,2022-03-12 19:28:01.100583
33151,38,257,39,57,628,1019,2022-03-12 19:28:01.352581
33155,189,4322,187,233,2827,7758,2022-03-12 19:28:01.919585
33174,7,55,1,48,54,165,2022-03-12 19:28:03.294194
33184,1841,5654,888,3575,10697,22655,2022-03-12 19:28:04.511192
33192,32,479,14,39,227,791,2022-03-12 19:28:05.523346
33200,10,56,5,58,58,187,2022-03-12 19:28:06.705323
33213,26,142,19,61,134,382,2022-03-12 19:28:07.998859
33222,3671,43759,1487,3442,12930,65289,2022-03-12 19:28:09.252974
33237,20,50,3,42,130,245,2022-03-12 19:28:10.489091
33245,308,2552,234,403,2728,6225,2022-03-12 19:28:11.633422
33262,20,50,10,93,99,272,2022-03-12 19:28:12.733398
33274,965,6349,626,2110,3078,13128,2022-03-12 19:28:13.821522
33282,12,653,5,39,82,791,2022-03-12 19:28:15.065796
33305,168,363,39,98,562,1230,2022-03-12 19:28:16.280356
33320,6,30,2,34,54,126,2022-03-12 19:28:17.497463
33341,1146,5961,735,2215,5385,15442,2022-03-12 19:28:18.828068
33352,112610,898656,49250,43832,345109,1449457,2022-03-12 19:28:19.93407
33366,36,309,20,42,237,644,2022-03-12 19:28:21.036322
33388,17,67,15,45,302,446,2022-03-12 19:28:22.237314
33400,8,171,1,19,38,237,2022-03-12 19:28:23.452023
33422,15,93,0,44,69,221,2022-03-12 19:28:24.658025
33446,851,6393,270,267,4742,12523,2022-03-12 19:28:25.87618
33465,15,75,4,36,86,216,2022-03-12 19:28:27.129387
33485,9,86,1,47,53,196,2022-03-12 19:28:28.364379
33498,26,476,6,51,191,750,2022-03-12 19:28:29.447546
33508,164,461,67,128,1040,1860,2022-03-12 19:28:30.886896
33522,172,2548,73,116,1796,4705,2022-03-12 19:28:31.899911
33531,3956,11322,1842,4598,13875,35593,2022-03-12 19:28:33.116444
33539,13,41,3,45,58,160,2022-03-12 19:28:34.362471
33544,15,451,16,67,215,764,2022-03-12 19:28:35.456129
33552,13,231,15,43,136,438,2022-03-12 19:28:36.684153
33572,610,1700,303,932,4539,8084,2022-03-12 19:28:37.977125
33599,86,88,27,67,535,803,2022-03-12 19:28:39.082141
33607,18,46,9,50,141,264,2022-03-12 19:28:40.35078
33662,13,79,12,80,102,286,2022-03-12 19:28:41.511858
33674,18375,537809,5700,5460,180949,748293,2022-03-12 19:28:42.659855
33691,8,86,4,43,62,203,2022-03-12 19:28:43.862057
33698,15,254,2,21,84,376,2022-03-12 19:28:45.368307
33706,4,30,2,21,25,82,2022-03-12 19:28:46.519303
33717,14,108,10,27,146,305,2022-03-12 19:28:47.989884
33726,3613,13839,1601,2804,15185,37042,2022-03-12 19:28:48.785049
33734,30,1035,13,47,258,1383,2022-03-12 19:28:49.864234
33753,12,100,5,47,82,246,2022-03-12 19:28:51.093503
33762,58,97,20,52,387,614,2022-03-12 19:28:54.039638
33763,39,71,10,52,173,345,2022-03-12 19:28:54.257633
33771,5182,25458,2709,10293,18390,62032,2022-03-12 19:28:54.914691
33779,38,265,18,67,315,703,2022-03-12 19:28:55.976773
33792,11,60,7,48,69,195,2022-03-12 19:28:57.058801
33811,453,9457,165,212,3022,13309,2022-03-12 19:28:58.4688
33824,7,23,2,45,45,122,2022-03-12 19:29:03.571853
33826,8,22,3,44,40,117,2022-03-12 19:29:03.771855
33828,26,169,15,40,217,467,2022-03-12 19:29:19.125783
33831,6,32,4,43,66,151,2022-03-12 19:29:19.310786
33834,13582,50830,5452,18039,45783,133686,2022-03-12 19:29:19.468783
33843,12,88,0,31,54,185,2022-03-12 19:29:20.387291
33856,11,39,2,36,68,156,2022-03-12 19:29:24.19254
33857,15,38,3,42,68,166,2022-03-12 19:29:24.387516
33858,12,114,1,23,47,197,2022-03-12 19:29:24.556516
33862,8,105,5,31,58,207,2022-03-12 19:29:25.171318
33874,19,245,18,50,235,567,2022-03-12 19:29:26.384895
33881,20,180,13,50,207,470,2022-03-12 19:29:27.775068
33888,10,112,2,35,51,210,2022-03-12 19:29:28.877025
33899,4854,22366,2188,2547,22387,54342,2022-03-12 19:29:29.942139
33909,11,488,7,18,92,616,2022-03-12 19:30:04.153584
33910,10,476,5,18,112,621,2022-03-12 19:30:04.351592
33911,27,840,19,68,373,1327,2022-03-12 19:30:04.538588
33912,21,652,23,69,342,1107,2022-03-12 19:30:04.701589
33925,105,194,33,74,372,778,2022-03-12 19:30:23.077006
33926,24828,198114,8375,11211,83846,326374,2022-03-12 19:30:23.322004
33927,9,124,2,36,54,225,2022-03-12 19:30:23.506004
33929,2929,120094,1008,615,31466,156112,2022-03-12 19:30:23.685006
33939,20,101,5,22,101,249,2022-03-12 19:30:24.636519
33949,532,18749,220,134,7517,27152,2022-03-12 19:30:25.7288
33972,293,398,48,57,1712,2508,2022-03-12 19:30:26.950824
33988,19698,247439,7830,9289,88237,372493,2022-03-12 19:30:43.08273
33994,618,5702,326,242,10144,17032,2022-03-12 19:30:43.941757
33997,134,1920,76,115,1700,3945,2022-03-12 19:30:44.104762
33998,11,77,7,37,129,261,2022-03-12 19:30:44.30173
34008,247,2525,143,179,4722,7816,2022-03-12 19:30:45.209372
34022,128,0,33,71,679,911,2022-03-12 19:31:24.044998
34028,1019,4259,582,2663,4633,13156,2022-03-12 19:31:24.551995
34032,123,1280,64,111,2452,4030,2022-03-12 19:31:38.178461
34034,15137,40947,9371,13354,11488,90297,2022-03-12 19:31:38.521469
34036,1093,18682,404,488,5676,26343,2022-03-12 19:31:38.764464
34037,8,87,3,34,52,184,2022-03-12 19:31:38.933464
34050,46,589,14,48,409,1106,2022-03-12 19:31:39.680464
34078,10,53,3,62,45,173,2022-03-12 19:31:40.770609
34092,42,0,9,57,79,187,2022-03-12 19:31:42.208739
34106,1680,9099,885,771,8439,20874,2022-03-12 19:31:43.174738
34119,6,83,2,26,32,149,2022-03-12 19:31:44.529933
34129,59,134,29,95,271,588,2022-03-12 19:31:45.697464
34153,20,264,6,35,131,456,2022-03-12 19:31:46.837109
34167,295,1814,107,90,4235,6541,2022-03-12 19:31:48.197334
34183,9,31,2,43,37,122,2022-03-12 19:31:50.696094
34189,6,24,4,33,39,106,2022-03-12 19:31:51.601094
34223,167,807,98,993,1059,3124,2022-03-12 19:31:54.111474
34235,25,39,7,95,97,263,2022-03-12 19:31:55.422058
34243,60,683,40,49,555,1387,2022-03-12 19:31:56.611236
34258,13,31,5,42,112,203,2022-03-12 19:31:57.667261
34280,31148,397042,12287,25264,102843,568584,2022-03-12 19:31:59.094234
34290,1409,3599,772,717,3552,10049,2022-03-12 19:32:00.215986
34300,6052,68846,1491,2639,28156,107184,2022-03-12 19:32:01.216984
34318,158,3015,96,102,2019,5390,2022-03-12 19:32:02.411591
34337,512,4072,234,815,2485,8118,2022-03-12 19:32:03.811593
34350,8511,50939,5859,11344,31744,108397,2022-03-12 19:32:04.894614
34366,22,656,12,55,276,1021,2022-03-12 19:32:06.004286
34374,433,6534,227,177,6034,13405,2022-03-12 19:32:07.239284
34393,1357,11230,605,2990,8211,24393,2022-03-12 19:32:08.47378
34412,61,1713,26,65,708,2573,2022-03-12 19:32:09.881807
34418,6,212,1,14,39,272,2022-03-12 19:32:10.838084
34428,1922,32610,746,845,25675,61798,2022-03-12 19:32:12.238099
34440,1768,42055,797,638,33676,78934,2022-03-12 19:32:16.584444
34443,26277,192617,10646,15095,50069,294704,2022-03-12 19:32:16.81947
34445,1429,17562,612,455,16258,36316,2022-03-12 19:32:16.984447
34447,1733,19346,748,462,9009,31298,2022-03-12 19:32:17.163449
34455,579,1416,175,204,4889,7263,2022-03-12 19:32:18.087003
34474,1259,4600,579,1568,8064,16070,2022-03-12 19:32:19.318999
34489,69,802,36,85,824,1816,2022-03-12 19:32:20.726553
43266,0,10,2,6,10,28,2022-03-12 19:48:19.838041
34501,4280,44058,1507,3312,18302,71459,2022-03-12 19:32:21.667552
34519,28,273,31,83,382,797,2022-03-12 19:32:22.896675
34534,1149,25345,493,241,11635,38863,2022-03-12 19:32:27.224807
34535,811,748,369,239,4368,6535,2022-03-12 19:32:27.602805
34537,3133,49242,1091,554,47531,101551,2022-03-12 19:32:27.771804
34538,111,1370,46,70,904,2501,2022-03-12 19:32:27.947807
34544,2686,66916,903,412,33799,104716,2022-03-12 19:32:28.853588
34674,21,50,13,25,298,407,2022-03-12 19:32:38.616071
34566,391493,14,93805,157770,84269,727351,2022-03-12 19:32:30.078763
34599,64778,695719,26056,15781,294450,1096784,2022-03-12 19:32:31.318381
34612,33426,385009,10447,5567,80851,515300,2022-03-12 19:32:32.462983
34625,29,294,13,45,143,524,2022-03-12 19:32:33.72101
34634,9,279,4,16,71,379,2022-03-12 19:32:34.956609
34651,15,122,2,33,64,236,2022-03-12 19:32:36.041259
34664,13,57,5,53,54,182,2022-03-12 19:32:37.352558
47141,0,0,0,0,0,0,2022-03-12 20:20:03.761025
47145,0,0,0,0,0,0,2022-03-12 20:20:05.092904
47148,0,0,0,0,0,0,2022-03-12 20:20:06.577889
47149,0,0,0,0,0,0,2022-03-12 20:20:07.422914
34688,14,62,3,22,103,204,2022-03-12 19:32:39.768071
34693,9,57,3,28,57,154,2022-03-12 19:32:40.913286
34701,10,41,3,44,57,155,2022-03-12 19:32:42.159427
34711,7,57,2,38,42,146,2022-03-12 19:32:43.249437
34722,10,97,4,21,37,169,2022-03-12 19:32:44.477576
34741,93,166,50,174,453,936,2022-03-12 19:32:45.841196
34746,63,93,8,59,203,426,2022-03-12 19:32:46.91978
34762,33,195,25,68,432,753,2022-03-12 19:32:48.12697
34776,312,2999,157,131,3896,7495,2022-03-12 19:32:49.579209
34785,17,183,1,18,81,300,2022-03-12 19:32:50.451417
34802,82,1909,19,41,714,2765,2022-03-12 19:32:51.809427
34818,478,1764,240,227,2018,4727,2022-03-12 19:32:52.887549
34832,0,0,0,0,3931,3931,2022-03-12 19:32:54.186203
34843,20,89,10,51,110,280,2022-03-12 19:32:55.289251
34855,1583,50210,767,335,10746,63641,2022-03-12 19:32:56.517621
34861,9,104,3,16,39,171,2022-03-12 19:32:57.807621
47155,0,0,0,0,0,0,2022-03-12 20:20:09.772554
47613,0,0,0,0,0,0,2022-03-12 20:25:12.959199
47909,0,0,0,0,0,0,2022-03-12 20:28:00.09337
34868,8,62,4,28,78,180,2022-03-12 19:32:59.074733
34881,22715,289480,9274,22436,82485,426390,2022-03-12 19:33:00.047257
34900,0,0,0,0,4772,4772,2022-03-12 19:33:01.310653
34910,9,331,5,18,60,423,2022-03-12 19:33:02.528766
34926,16,39,5,33,82,175,2022-03-12 19:33:03.748762
34934,23460,202522,9586,20410,94934,350912,2022-03-12 19:33:04.85428
34946,19,117,3,41,107,287,2022-03-12 19:33:06.087402
34960,34,98,17,28,283,460,2022-03-12 19:33:07.364538
47394,0,0,0,0,0,0,2022-03-12 20:23:38.171445
47753,0,0,0,0,0,0,2022-03-12 20:27:04.379463
47770,0,0,0,0,0,0,2022-03-12 20:27:10.465214
34973,6083,62270,2832,2498,28143,101826,2022-03-12 19:33:08.460019
34985,67,100,28,76,365,636,2022-03-12 19:33:09.705021
35003,10,136,4,44,43,237,2022-03-12 19:33:10.929714
35018,55,269,46,55,928,1353,2022-03-12 19:33:12.174709
35026,9,45,1,41,38,134,2022-03-12 19:33:13.376057
35032,7,60,5,47,65,184,2022-03-12 19:33:14.780986
35038,9,62,5,50,49,175,2022-03-12 19:33:15.777574
35048,8,56,5,38,41,148,2022-03-12 19:33:16.949051
35055,10,19,1,39,38,107,2022-03-12 19:33:18.156053
35063,124,1344,80,82,1371,3001,2022-03-12 19:33:19.404198
35074,16,87,11,35,171,320,2022-03-12 19:33:20.481862
35084,6,29,2,36,44,117,2022-03-12 19:33:21.72785
35098,6,28,2,41,40,117,2022-03-12 19:33:22.950242
35105,9,25,3,33,56,126,2022-03-12 19:33:24.171238
35113,112,498,72,189,967,1838,2022-03-12 19:33:25.373455
35122,935,9255,505,601,11570,22866,2022-03-12 19:33:26.584587
35138,26,60,8,52,178,324,2022-03-12 19:33:29.06623
35147,5,29,1,44,40,119,2022-03-12 19:33:30.134231
35153,6,18,2,39,31,96,2022-03-12 19:33:31.48238
35161,6,23,3,33,32,97,2022-03-12 19:33:32.604539
35168,7,21,1,39,34,102,2022-03-12 19:33:33.689538
35176,8,38,5,42,48,141,2022-03-12 19:33:34.956069
35203,20560,339361,5185,28338,52510,445954,2022-03-12 19:33:36.172592
35220,8057,26194,3643,7038,17339,62271,2022-03-12 19:33:37.46172
35230,173,349,61,98,1349,2030,2022-03-12 19:33:38.642341
35240,13495,82068,6924,7824,70854,181165,2022-03-12 19:33:39.752368
35251,4128,12899,1543,5478,15553,39601,2022-03-12 19:33:40.991886
35266,19,81,10,48,163,321,2022-03-12 19:33:42.205403
35277,7,28,2,35,44,116,2022-03-12 19:33:43.589525
35280,6,28,1,37,33,105,2022-03-12 19:33:44.528148
35295,16,49,8,84,64,221,2022-03-12 19:33:45.940302
35303,100,219,49,105,491,964,2022-03-12 19:33:46.978746
35309,26,49,10,58,87,230,2022-03-12 19:33:48.214746
35317,18,70,8,67,93,256,2022-03-12 19:33:49.345364
35329,68,911,37,58,855,1929,2022-03-12 19:33:50.695133
35338,2515,82971,788,500,19724,106498,2022-03-12 19:33:51.819122
35353,30,161,6,33,124,354,2022-03-12 19:33:52.989837
35370,495,8004,213,246,3500,12458,2022-03-12 19:33:54.309833
35383,49,331,22,111,233,746,2022-03-12 19:33:55.365605
35394,9,255,5,32,98,399,2022-03-12 19:33:56.619686
35403,14,258,4,33,54,363,2022-03-12 19:33:57.699682
35411,212,290,41,110,1010,1663,2022-03-12 19:33:59.133805
35424,360,2268,214,124,7707,10673,2022-03-12 19:34:00.399891
35442,11,103,1,35,50,200,2022-03-12 19:34:01.325374
35454,8,91,3,26,61,189,2022-03-12 19:34:02.558326
35473,99,1548,71,84,1310,3112,2022-03-12 19:34:03.782325
35488,7,44,3,44,44,142,2022-03-12 19:34:05.670061
35491,13,77,14,87,73,264,2022-03-12 19:34:06.182063
35501,61,356,29,48,597,1091,2022-03-12 19:34:10.634283
35502,20,145,2,22,96,285,2022-03-12 19:34:10.829281
35503,5681,27349,2946,3547,29864,69387,2022-03-12 19:34:10.994284
35504,23,111,10,29,279,452,2022-03-12 19:34:11.37128
35511,6,132,1,16,34,189,2022-03-12 19:34:12.149281
35522,144,2766,54,46,1276,4286,2022-03-12 19:34:13.371469
35532,8,91,0,15,29,143,2022-03-12 19:34:14.650596
35540,5856,30358,2575,5207,29483,73479,2022-03-12 19:34:15.844711
35553,6,225,2,23,35,291,2022-03-12 19:34:16.924385
35574,14,55,3,44,61,177,2022-03-12 19:34:18.595431
35585,18,728,10,17,228,1001,2022-03-12 19:34:19.424458
35594,45,77,19,50,503,694,2022-03-12 19:34:20.721208
35611,8,47,5,36,49,145,2022-03-12 19:34:22.176213
35619,8,41,5,31,59,144,2022-03-12 19:34:23.023341
35629,3526,24841,1112,4867,12861,47207,2022-03-12 19:34:24.245344
35642,16,182,9,48,76,331,2022-03-12 19:34:25.333486
35652,38,433,18,74,376,939,2022-03-12 19:34:26.840113
35667,9,240,1,28,56,334,2022-03-12 19:34:29.387461
35668,9,112,1,20,32,174,2022-03-12 19:34:29.619462
35672,1077,9313,394,350,8705,19839,2022-03-12 19:34:30.352094
35681,10,94,9,37,327,477,2022-03-12 19:34:31.402623
35696,48,0,21,72,111,252,2022-03-12 19:34:32.670752
35703,7,29,2,44,34,116,2022-03-12 19:34:33.804751
35714,1016,14785,380,483,6385,23049,2022-03-12 19:34:35.012891
35734,10,208,5,17,38,278,2022-03-12 19:34:36.246475
35747,10,221,1,26,43,301,2022-03-12 19:34:37.453645
35770,1016,817,635,428,3522,6418,2022-03-12 19:34:38.548672
35784,7,182,3,28,46,266,2022-03-12 19:34:39.802809
35800,12,550,11,24,137,734,2022-03-12 19:34:42.879566
35805,108,811,62,97,1305,2383,2022-03-12 19:34:43.069566
35809,11,491,15,22,113,652,2022-03-12 19:34:43.406594
35834,3588,27606,1760,3688,16920,53562,2022-03-12 19:34:44.608165
35848,5567,135623,1553,1017,86984,230744,2022-03-12 19:34:46.398809
35854,0,0,0,0,1498,1498,2022-03-12 19:34:47.09343
35880,145,1746,85,150,2918,5044,2022-03-12 19:34:48.203407
35913,12,42,4,36,68,162,2022-03-12 19:34:49.465092
35933,34,318,8,39,170,569,2022-03-12 19:34:50.750837
35958,13,159,1,31,48,252,2022-03-12 19:34:51.970838
35968,56245,515545,19709,16206,173640,781345,2022-03-12 19:34:53.150865
35979,12,182,2,18,41,255,2022-03-12 19:34:54.22286
47432,0,0,0,0,0,0,2022-03-12 20:24:02.667997
47436,0,0,0,0,0,0,2022-03-12 20:24:04.599757
47438,0,0,0,0,0,0,2022-03-12 20:24:05.684527
35992,16,339,7,24,166,552,2022-03-12 19:34:55.441198
36003,15,61,5,49,55,185,2022-03-12 19:34:59.247352
36005,0,0,0,0,2536,2536,2022-03-12 19:34:59.448347
36006,0,0,0,0,6509,6509,2022-03-12 19:34:59.686358
36016,14,73,11,42,73,213,2022-03-12 19:35:00.169355
36030,10,386,11,30,174,611,2022-03-12 19:35:01.614607
36038,23315,267648,8126,9685,92464,401238,2022-03-12 19:35:02.614611
36057,6,92,1,21,24,144,2022-03-12 19:35:05.10722
36061,12,209,3,14,40,278,2022-03-12 19:35:05.500321
47441,0,0,0,0,0,0,2022-03-12 20:24:07.462469
47442,0,0,0,0,0,0,2022-03-12 20:24:08.918992
36066,9,144,2,11,51,217,2022-03-12 19:35:07.472421
36067,5,184,2,13,36,240,2022-03-12 19:35:07.669411
36074,7,263,4,18,41,333,2022-03-12 19:35:09.108576
36081,8,125,2,11,31,177,2022-03-12 19:35:09.928088
36088,12,212,2,17,50,293,2022-03-12 19:35:11.059762
36096,7,283,6,16,39,351,2022-03-12 19:35:12.396762
36103,9,150,1,11,32,203,2022-03-12 19:35:13.440947
36114,11,166,1,10,33,221,2022-03-12 19:35:14.677946
36125,320,14760,96,126,2598,17900,2022-03-12 19:35:15.800601
36145,35,380,13,44,339,811,2022-03-12 19:35:17.044686
36159,8,423,2,18,41,492,2022-03-12 19:35:18.274683
36167,5,56,3,25,46,135,2022-03-12 19:35:19.407801
36182,15,409,12,47,149,632,2022-03-12 19:35:20.773284
36196,316,2541,131,228,1362,4578,2022-03-12 19:35:21.847805
36223,121,1167,53,68,1189,2598,2022-03-12 19:35:25.49225
36226,72,177,40,66,401,756,2022-03-12 19:35:28.141932
36228,58,1255,32,80,647,2072,2022-03-12 19:35:28.318934
36229,13,242,5,27,86,373,2022-03-12 19:35:28.484934
36233,9,65,1,24,42,141,2022-03-12 19:35:31.977008
36234,7,44,11,46,73,181,2022-03-12 19:35:32.463034
36239,175,2418,90,129,1844,4656,2022-03-12 19:35:32.630011
36245,4837,34750,1938,8958,21722,72205,2022-03-12 19:35:33.259454
36250,339,6846,186,226,6595,14192,2022-03-12 19:35:34.428454
36267,2691,10472,975,3200,8425,25763,2022-03-12 19:35:35.647174
36274,5,39,3,38,42,127,2022-03-12 19:35:36.862532
36287,16,430,14,41,175,676,2022-03-12 19:35:37.944529
36296,30725,255997,11492,9535,121187,428936,2022-03-12 19:35:39.179585
36308,791,20965,203,124,8865,30948,2022-03-12 19:35:40.556588
36313,7,17,2,37,55,118,2022-03-12 19:35:41.613149
36323,6,14,3,35,29,87,2022-03-12 19:35:42.986279
36344,269,1325,165,133,3894,5786,2022-03-12 19:35:44.237302
36352,5,85,3,19,21,133,2022-03-12 19:35:47.629896
36353,7,73,2,26,25,133,2022-03-12 19:35:47.836896
36359,7,93,1,13,25,139,2022-03-12 19:35:48.757897
36372,7,130,0,19,22,178,2022-03-12 19:35:50.049514
36380,7,38,4,41,34,124,2022-03-12 19:35:51.235733
36387,8,106,2,20,30,166,2022-03-12 19:35:52.516247
36392,10,143,3,29,40,225,2022-03-12 19:35:53.880397
36399,9,108,2,27,27,173,2022-03-12 19:35:57.358349
36400,7,109,0,21,26,163,2022-03-12 19:35:57.704352
36407,29315,338193,6241,24991,64551,463291,2022-03-12 19:35:58.45435
36425,34,249,9,56,119,467,2022-03-12 19:35:59.840465
36436,108,1363,54,95,1755,3375,2022-03-12 19:36:00.959688
36455,2889,9754,916,1263,13726,28548,2022-03-12 19:36:02.040688
36474,71904,626268,19347,26997,123055,867571,2022-03-12 19:36:03.288188
36491,717,5339,145,259,2149,8609,2022-03-12 19:36:04.372189
36502,560,4587,262,323,3548,9280,2022-03-12 19:36:05.602513
47444,0,0,0,0,0,0,2022-03-12 20:24:10.550024
47446,0,0,0,0,0,0,2022-03-12 20:24:11.585873
47449,0,0,0,0,0,0,2022-03-12 20:24:12.776317
47453,0,0,0,0,0,0,2022-03-12 20:24:14.092714
36520,53,1380,19,88,253,1793,2022-03-12 19:36:06.962403
36530,11,122,8,50,54,245,2022-03-12 19:36:08.145836
36544,223,797,78,97,1431,2626,2022-03-12 19:36:12.184765
36545,412,3311,161,154,2551,6589,2022-03-12 19:36:12.397767
36550,11,65,7,43,52,178,2022-03-12 19:36:14.345433
36551,12,68,10,57,58,205,2022-03-12 19:36:14.616465
36560,1221,23628,603,432,11872,37756,2022-03-12 19:36:17.244145
36563,35342,277871,11922,11121,107043,443299,2022-03-12 19:36:17.612144
36574,10,144,2,34,84,274,2022-03-12 19:36:19.356522
36579,9,92,1,22,41,165,2022-03-12 19:36:20.003518
36587,4676,23027,1873,2256,25087,56919,2022-03-12 19:36:21.251057
36597,28,851,5,16,136,1036,2022-03-12 19:36:22.465058
36605,39,805,16,15,195,1070,2022-03-12 19:36:23.857376
36616,1138,53119,525,605,21475,76862,2022-03-12 19:36:24.819376
36625,363,7376,233,159,5594,13725,2022-03-12 19:36:26.053585
36637,171,1690,44,125,1054,3084,2022-03-12 19:36:27.27556
36646,53,508,27,66,554,1208,2022-03-12 19:36:28.56556
36657,20,66,8,58,74,226,2022-03-12 19:36:29.66768
36670,10,188,0,21,42,261,2022-03-12 19:36:30.909918
36677,11,108,3,25,57,204,2022-03-12 19:36:32.008919
36688,2408,53169,768,515,21581,78441,2022-03-12 19:36:33.373026
36712,11,183,2,43,90,329,2022-03-12 19:36:36.798264
36714,56,474,28,58,752,1368,2022-03-12 19:36:37.012261
36722,373,158,117,155,2588,3391,2022-03-12 19:36:38.193485
36731,15,197,2,29,100,343,2022-03-12 19:36:41.190488
36735,6,54,9,38,45,152,2022-03-12 19:36:41.704523
36746,11,619,5,39,94,768,2022-03-12 19:36:42.794525
36756,96,2469,84,152,1388,4189,2022-03-12 19:36:44.016204
36765,9,170,1,8,42,230,2022-03-12 19:36:45.24634
36780,5,211,0,11,53,280,2022-03-12 19:36:46.575333
36791,164,879,51,61,569,1724,2022-03-12 19:36:47.633421
36803,651,8254,355,170,13575,23005,2022-03-12 19:36:48.904423
36811,7,113,1,23,38,182,2022-03-12 19:36:50.141212
36820,7,103,0,22,40,172,2022-03-12 19:36:51.265681
36833,503,9689,306,193,8386,19077,2022-03-12 19:36:52.487703
36846,6,111,3,18,34,172,2022-03-12 19:36:53.795832
36858,171,740,84,109,3638,4742,2022-03-12 19:36:54.936836
36866,60,57,26,55,336,534,2022-03-12 19:36:56.098726
36883,17,150,2,37,126,332,2022-03-12 19:36:57.490867
36896,8141,523974,1820,1310,85068,620313,2022-03-12 19:36:58.420868
36913,56,1217,29,64,662,2028,2022-03-12 19:36:59.640967
36923,1648,40155,514,666,17335,60318,2022-03-12 19:37:00.843692
36945,1017,3942,411,2853,7666,15889,2022-03-12 19:37:02.138191
36955,43,366,23,70,843,1345,2022-03-12 19:37:03.362302
36970,6,44,4,34,25,113,2022-03-12 19:37:04.588327
36990,1608,36330,647,263,25630,64478,2022-03-12 19:37:07.925847
36991,56,963,28,39,748,1834,2022-03-12 19:37:08.127847
37007,11125,54237,4495,7405,26004,103266,2022-03-12 19:37:09.332169
37018,11,93,1,24,50,179,2022-03-12 19:37:10.547834
37028,14,79,9,44,80,226,2022-03-12 19:37:11.621807
37045,580,6251,226,212,5073,12342,2022-03-12 19:37:12.834809
37055,5004,146464,1631,731,64875,218705,2022-03-12 19:37:18.843375
37058,66,114,21,36,335,572,2022-03-12 19:37:19.045379
37059,7,103,0,16,26,152,2022-03-12 19:37:19.37599
37060,6,42,2,33,32,115,2022-03-12 19:37:19.545988
37069,6,96,3,20,29,154,2022-03-12 19:37:20.323558
37082,36,424,20,48,473,1001,2022-03-12 19:37:21.55338
37098,8,89,4,48,43,192,2022-03-12 19:37:22.684357
37106,1269,9910,443,1298,6910,19830,2022-03-12 19:37:24.109232
37124,44,379,20,55,478,976,2022-03-12 19:37:25.108798
37142,89,0,34,44,72,239,2022-03-12 19:37:29.72413
37143,12,223,13,81,122,451,2022-03-12 19:37:32.701847
37144,11,81,6,47,72,217,2022-03-12 19:37:33.021849
37145,7,135,4,30,59,235,2022-03-12 19:37:33.276851
37146,16,55,7,29,149,256,2022-03-12 19:37:33.443467
37150,2440,10694,492,807,6947,21380,2022-03-12 19:37:34.158469
37167,28,49,11,29,214,331,2022-03-12 19:37:35.399845
37177,35,201,15,39,435,725,2022-03-12 19:37:38.059447
37178,710,931,287,436,2457,4821,2022-03-12 19:37:38.265446
37184,202,1830,61,94,743,2930,2022-03-12 19:37:38.981473
37191,7,121,1,24,35,188,2022-03-12 19:37:40.082666
37202,20354,76781,9179,21099,52033,179446,2022-03-12 19:37:41.283731
37215,28,181,17,35,408,669,2022-03-12 19:37:42.646837
37225,17,90,8,48,173,336,2022-03-12 19:37:43.795957
37245,3035,13094,984,2555,6077,25745,2022-03-12 19:37:44.89498
37259,11485,78219,5238,11380,37128,143450,2022-03-12 19:37:46.192697
37272,613,2264,244,169,5834,9124,2022-03-12 19:37:47.418726
37283,804,6856,318,690,1920,10588,2022-03-12 19:37:48.63873
37293,506,831,171,229,1655,3392,2022-03-12 19:37:49.725911
37307,476,6725,294,133,9597,17225,2022-03-12 19:37:50.944708
37326,6,94,4,20,56,180,2022-03-12 19:37:52.158815
37343,38,0,10,50,86,184,2022-03-12 19:37:53.394813
37351,6,106,2,21,33,168,2022-03-12 19:37:54.624978
37362,432,8238,346,333,5758,15107,2022-03-12 19:37:55.727279
37379,9995,57722,3265,1628,42830,115440,2022-03-12 19:37:57.051846
37391,10,123,3,42,51,229,2022-03-12 19:37:58.194843
37402,796,15669,396,375,9894,27130,2022-03-12 19:37:59.639293
37409,39,79,29,38,113,298,2022-03-12 19:38:00.590894
37424,156,1762,57,131,1208,3314,2022-03-12 19:38:03.816431
37428,22,34,10,72,87,225,2022-03-12 19:38:04.178407
37440,1824,45204,872,347,39754,88001,2022-03-12 19:38:05.413001
37451,20785,58200,13057,23368,85570,200980,2022-03-12 19:38:06.630345
37461,7,94,1,15,24,141,2022-03-12 19:38:08.516984
37464,7,105,1,20,55,188,2022-03-12 19:38:09.11501
37476,1319,4876,652,919,2402,10168,2022-03-12 19:38:10.178493
37491,7282,94629,2217,1358,51722,157208,2022-03-12 19:38:11.397494
37504,1023,14290,550,695,10977,27535,2022-03-12 19:38:12.625618
37514,2161,40717,793,891,42273,86835,2022-03-12 19:38:13.842013
37525,10875,48279,5140,8795,49449,122538,2022-03-12 19:38:14.992986
37533,4,141,1,9,30,185,2022-03-12 19:38:16.289809
37540,4,146,1,11,27,189,2022-03-12 19:38:17.348318
37546,6,187,0,19,53,265,2022-03-12 19:38:18.78849
37552,11,177,3,19,83,293,2022-03-12 19:38:19.7965
37563,1061,1703,450,474,5115,8803,2022-03-12 19:38:20.9995
37579,8155,43685,3532,6340,29677,91389,2022-03-12 19:38:22.213132
37590,214,3404,111,208,3886,7823,2022-03-12 19:38:24.673309
37591,7,45,7,33,101,193,2022-03-12 19:38:24.877332
37599,3385,11418,1220,3332,12923,32278,2022-03-12 19:38:25.782848
37607,6,194,3,14,50,267,2022-03-12 19:38:27.059848
37618,1417,8158,361,406,6993,17335,2022-03-12 19:38:28.179957
37639,7,131,1,16,41,196,2022-03-12 19:38:29.474971
37651,1682,40372,815,645,16729,60243,2022-03-12 19:38:30.626886
37664,11,115,9,55,129,319,2022-03-12 19:38:31.736069
37672,170,2117,50,91,826,3254,2022-03-12 19:38:32.960043
37686,7,31,2,40,37,117,2022-03-12 19:38:34.197202
37694,6,67,3,15,23,114,2022-03-12 19:38:35.505852
37698,5,43,5,40,50,143,2022-03-12 19:38:36.541556
37717,69,319,27,40,559,1014,2022-03-12 19:38:37.910938
37730,8,119,2,19,68,216,2022-03-12 19:38:39.662954
37733,7,175,2,25,73,282,2022-03-12 19:38:42.256792
37735,580,6975,181,448,4195,12379,2022-03-12 19:38:44.298007
37736,570,1384,208,290,2203,4655,2022-03-12 19:38:44.48503
37742,16,1284,7,32,170,1509,2022-03-12 19:38:48.634379
37744,19391,160646,4994,32227,40184,257442,2022-03-12 19:38:48.847385
37747,602,3277,188,799,3505,8371,2022-03-12 19:38:49.182381
37753,14,139,1,36,92,282,2022-03-12 19:38:50.08941
37773,523,12668,218,151,12427,25987,2022-03-12 19:38:51.157699
37784,69,872,6,33,567,1547,2022-03-12 19:38:52.378642
37799,29791,530242,11085,32395,95049,698562,2022-03-12 19:38:53.463617
37818,103,61,45,74,674,957,2022-03-12 19:38:54.786215
37831,799,24212,420,576,9097,35104,2022-03-12 19:38:55.931026
37853,9,148,1,17,47,222,2022-03-12 19:38:57.168039
37863,61,1617,20,48,464,2210,2022-03-12 19:38:58.271209
37875,7,82,4,22,47,162,2022-03-12 19:38:59.536184
37886,138,897,47,81,1301,2464,2022-03-12 19:39:01.252896
43275,0,10,2,11,10,33,2022-03-12 19:48:21.04677
37891,5,29,3,38,23,98,2022-03-12 19:39:01.892379
37904,50,37,25,63,484,659,2022-03-12 19:39:03.201382
37916,365,4755,209,137,5099,10565,2022-03-12 19:39:04.298501
37928,65,136,17,41,243,502,2022-03-12 19:39:05.507068
37937,321,1947,67,145,794,3274,2022-03-12 19:39:06.75763
37947,7,146,1,13,38,205,2022-03-12 19:39:07.977736
37956,7807,103670,3327,4219,34492,153515,2022-03-12 19:39:09.058762
37966,196,14940,152,224,4673,20185,2022-03-12 19:39:10.298599
37975,2242,24405,1148,1238,12925,41958,2022-03-12 19:39:14.484733
37976,36776,229319,19273,30455,105563,421386,2022-03-12 19:39:14.692732
37978,8,94,13,53,139,307,2022-03-12 19:39:14.852732
37980,574,680,258,414,2026,3952,2022-03-12 19:39:15.20373
37987,10949,187512,3509,857,201083,403910,2022-03-12 19:39:16.284131
37996,508,29810,271,140,10165,40894,2022-03-12 19:39:17.525239
38004,1030,6123,454,1208,7557,16372,2022-03-12 19:39:18.763756
38012,16,207,14,36,584,857,2022-03-12 19:39:20.31249
38017,61,689,22,73,541,1386,2022-03-12 19:39:21.107466
38025,53,0,25,73,151,302,2022-03-12 19:39:22.366074
38044,1,166,0,13,30,210,2022-03-12 19:39:23.599048
38052,28,1038,18,41,255,1380,2022-03-12 19:39:24.80829
38060,8,59,7,41,147,262,2022-03-12 19:39:25.875007
38069,13,80,2,46,73,214,2022-03-12 19:39:29.371681
38070,7,160,6,48,52,273,2022-03-12 19:39:29.566696
38071,5,119,7,40,44,215,2022-03-12 19:39:29.738696
38081,702,15408,255,157,9944,26466,2022-03-12 19:39:30.809535
38088,909,16793,316,262,15323,33603,2022-03-12 19:39:31.889108
38097,36,0,21,35,71,163,2022-03-12 19:39:33.133101
38112,76,151,38,54,378,697,2022-03-12 19:39:34.378264
38123,4,97,1,53,32,187,2022-03-12 19:39:35.591926
38131,6,98,2,62,36,204,2022-03-12 19:39:36.95493
38137,4,81,2,43,36,166,2022-03-12 19:39:37.928141
38147,22,45,10,115,191,383,2022-03-12 19:39:39.18314
38162,675,3254,335,1993,3669,9926,2022-03-12 19:39:40.414068
38177,95,869,61,70,1049,2144,2022-03-12 19:39:41.661042
38194,4,40,4,49,62,159,2022-03-12 19:39:42.714927
38211,61,381,36,75,630,1183,2022-03-12 19:39:43.933485
38246,4,47,4,27,57,139,2022-03-12 19:39:46.309065
38249,3513,144273,802,536,23891,173015,2022-03-12 19:39:46.538579
38262,1083,3865,281,682,3538,9449,2022-03-12 19:39:47.689577
38276,3636,19206,1877,4787,13103,42609,2022-03-12 19:39:48.764289
38295,4049,24928,1449,5756,18197,54379,2022-03-12 19:39:49.972421
38307,5,91,4,11,24,135,2022-03-12 19:39:53.41305
38308,3,74,3,16,24,120,2022-03-12 19:39:53.62905
38309,3,86,3,15,27,134,2022-03-12 19:39:53.791051
38320,3,74,4,14,21,116,2022-03-12 19:39:54.712693
38328,15886,49769,6571,16073,52132,140431,2022-03-12 19:39:56.122332
38338,3,99,2,22,59,185,2022-03-12 19:39:57.377431
38353,6,242,1,30,60,339,2022-03-12 19:39:58.432595
38362,2,111,2,10,24,149,2022-03-12 19:39:59.548634
38376,8,156,1,19,44,228,2022-03-12 19:40:00.792385
38389,612,6182,293,430,4828,12345,2022-03-12 19:40:02.292397
38398,3,65,2,28,40,138,2022-03-12 19:40:03.252394
38411,42,404,15,35,494,990,2022-03-12 19:40:04.361395
38424,10,211,1,24,61,307,2022-03-12 19:40:05.72499
38435,470,4837,117,162,1235,6821,2022-03-12 19:40:06.807996
38451,36,0,11,61,73,181,2022-03-12 19:40:08.216992
38471,12,225,1,35,120,393,2022-03-12 19:40:09.140996
38480,13524,97861,5463,7176,71699,195723,2022-03-12 19:40:10.37197
38489,68,523,22,55,510,1178,2022-03-12 19:40:11.613969
38498,9,281,5,22,41,358,2022-03-12 19:40:12.891116
38506,6,132,2,18,52,210,2022-03-12 19:40:13.973093
38524,67339,1549361,7391,4721,119079,1747891,2022-03-12 19:40:15.292932
38528,2220,30491,537,573,7484,41305,2022-03-12 19:40:16.341542
38538,10,58,3,32,52,155,2022-03-12 19:40:17.552538
38554,12,220,4,44,68,348,2022-03-12 19:40:18.797667
38562,29,190,24,67,666,976,2022-03-12 19:40:19.938702
38578,1423,2875,638,678,3432,9046,2022-03-12 19:40:21.205764
38606,74,392,36,50,687,1239,2022-03-12 19:40:22.453126
38618,3,40,5,36,95,179,2022-03-12 19:40:23.662104
38628,2006,11633,1087,2587,9471,26784,2022-03-12 19:40:24.810311
38646,28,142,15,70,543,798,2022-03-12 19:40:28.192168
38647,25,133,15,69,479,721,2022-03-12 19:40:28.425188
38648,27,122,14,64,471,698,2022-03-12 19:40:28.752164
38659,32353,357374,9098,13879,76933,489637,2022-03-12 19:40:29.53317
38672,50,1052,48,80,944,2174,2022-03-12 19:40:31.105391
38680,69339,340247,29118,23946,170103,632753,2022-03-12 19:40:32.024396
38693,405,9241,210,247,5492,15595,2022-03-12 19:40:33.274395
38705,17,69,13,63,250,412,2022-03-12 19:40:37.972221
38707,2710,10039,1336,4994,11336,30415,2022-03-12 19:40:38.166404
38710,819,9171,466,140,7212,17808,2022-03-12 19:40:38.480401
38711,49,55,22,60,179,365,2022-03-12 19:40:38.647401
38717,0,1,1,0,4061,4063,2022-03-12 19:40:39.405428
38735,4828,63357,2542,7273,31906,109906,2022-03-12 19:40:44.744402
38738,4,94,3,32,34,167,2022-03-12 19:40:44.947402
38739,67,842,41,59,1133,2142,2022-03-12 19:40:45.288466
38744,182,597,38,94,1110,2021,2022-03-12 19:40:46.056465
38757,7,153,2,12,56,230,2022-03-12 19:40:47.151606
38767,177,2000,89,160,1432,3858,2022-03-12 19:40:48.35809
43822,0,0,0,0,0,0,2022-03-12 19:49:31.936926
43830,0,0,0,0,0,0,2022-03-12 19:49:33.168139
43838,0,0,0,0,0,0,2022-03-12 19:49:34.373834
38776,60,0,21,151,126,358,2022-03-12 19:40:49.726598
38787,12477,83998,4426,6610,54217,161728,2022-03-12 19:40:50.828605
38797,1736,18385,416,1048,6505,28090,2022-03-12 19:40:52.045618
38809,9,563,4,12,110,698,2022-03-12 19:40:53.275048
38818,4,164,2,11,54,235,2022-03-12 19:40:54.488646
38828,6,32,5,38,71,152,2022-03-12 19:40:55.561329
38850,69,1415,50,99,1255,2888,2022-03-12 19:40:56.935435
38857,23,102,6,74,177,382,2022-03-12 19:40:58.359432
38864,100,1766,71,142,1361,3440,2022-03-12 19:40:59.164432
38874,5,23,5,40,35,108,2022-03-12 19:41:00.408147
38882,43,126,27,52,3664,3912,2022-03-12 19:41:01.608173
38895,279,3644,143,102,2032,6200,2022-03-12 19:41:02.984332
38903,0,0,0,0,1841,1841,2022-03-12 19:41:04.141332
38913,3,200,2,7,39,251,2022-03-12 19:41:05.201888
38921,287,13741,152,95,6251,20526,2022-03-12 19:41:06.517281
38928,21,0,15,32,48,116,2022-03-12 19:41:07.646282
43845,0,0,0,0,0,0,2022-03-12 19:49:35.45542
43853,0,0,0,0,0,0,2022-03-12 19:49:36.836648
43860,0,0,0,0,0,0,2022-03-12 19:49:38.073623
43868,0,0,0,0,0,0,2022-03-12 19:49:39.139143
38938,4571,31569,1482,1514,30132,69268,2022-03-12 19:41:08.902901
38959,12068,61444,5035,6746,46129,131422,2022-03-12 19:41:10.016928
38971,284,5965,173,178,3362,9962,2022-03-12 19:41:11.233113
38985,465,5941,224,228,10003,16861,2022-03-12 19:41:12.458707
38999,369,19546,191,99,5937,26142,2022-03-12 19:41:13.750707
39007,35,37,8,91,671,842,2022-03-12 19:41:14.869797
39022,301,854,142,319,1974,3590,2022-03-12 19:41:16.245426
39029,19,57,9,87,130,302,2022-03-12 19:41:17.199959
39037,12,75,9,27,130,253,2022-03-12 19:41:18.413074
39056,15,304,6,19,99,443,2022-03-12 19:41:19.658077
39077,8,102,0,19,46,175,2022-03-12 19:41:20.872145
39088,5,139,3,15,41,203,2022-03-12 19:41:22.008146
39097,3,150,2,9,29,193,2022-03-12 19:41:23.254333
39106,13,138,10,32,178,371,2022-03-12 19:41:24.634448
39114,32,3575,12,28,302,3949,2022-03-12 19:41:26.201123
39119,7,33,6,43,76,165,2022-03-12 19:41:26.858749
39128,2,20,1,29,31,83,2022-03-12 19:41:28.087749
39137,2,21,1,26,30,80,2022-03-12 19:41:29.321938
39146,2,23,1,37,28,91,2022-03-12 19:41:30.459158
39152,2,11,2,33,28,76,2022-03-12 19:41:31.727638
39160,3,25,5,28,35,96,2022-03-12 19:41:32.914819
39168,0,0,0,0,6135,6135,2022-03-12 19:41:34.217812
39174,10,395,3,11,49,468,2022-03-12 19:41:35.365561
39183,229,414,136,307,902,1988,2022-03-12 19:41:36.455711
44114,0,0,0,0,0,0,2022-03-12 19:52:50.753824
44116,0,0,0,0,0,0,2022-03-12 19:52:52.158943
44117,0,0,0,0,0,0,2022-03-12 19:52:52.99269
44122,0,0,0,0,0,0,2022-03-12 19:53:01.870273
39192,7,40,3,28,61,139,2022-03-12 19:41:37.693733
39200,3,124,1,10,26,164,2022-03-12 19:41:38.918807
39215,4,125,1,9,28,167,2022-03-12 19:41:41.281049
39224,6,187,4,19,83,299,2022-03-12 19:41:43.079156
39228,3,44,3,36,39,125,2022-03-12 19:41:43.808157
39243,8,329,4,16,50,407,2022-03-12 19:41:44.932156
39252,9,268,6,17,79,379,2022-03-12 19:41:46.043788
39260,1,13,2,25,39,80,2022-03-12 19:41:47.308415
39271,7,110,6,28,81,232,2022-03-12 19:41:48.646488
39281,11,391,2,13,45,462,2022-03-12 19:41:49.741492
39292,27234,105631,9058,14978,64795,221696,2022-03-12 19:41:50.821004
39306,6,130,1,13,53,203,2022-03-12 19:41:52.20811
39315,34,291,16,39,262,642,2022-03-12 19:41:53.379857
39325,399,4543,121,146,2368,7577,2022-03-12 19:41:54.45194
39331,3,193,1,15,32,244,2022-03-12 19:41:55.644076
39343,3,43,4,22,43,115,2022-03-12 19:41:56.90213
39354,2,44,8,34,62,150,2022-03-12 19:41:58.195133
39362,30,523,24,48,302,927,2022-03-12 19:41:59.279221
39372,6,51,7,32,58,154,2022-03-12 19:42:00.507912
39380,428,5817,142,131,1916,8434,2022-03-12 19:42:01.724947
39388,7370,28828,3622,8290,26353,74463,2022-03-12 19:42:02.914028
39404,1,10,4,33,25,73,2022-03-12 19:42:04.300028
39410,39,50,18,47,130,284,2022-03-12 19:42:05.261419
39417,4201,17198,2091,6962,17149,47601,2022-03-12 19:42:06.570055
39430,7,71,5,52,90,225,2022-03-12 19:42:07.775031
39451,2,10,3,36,28,79,2022-03-12 19:42:08.933139
39463,39598,207176,11788,26463,106485,391510,2022-03-12 19:42:10.148146
39475,7,157,2,12,31,209,2022-03-12 19:42:12.938542
39476,7,290,0,9,36,342,2022-03-12 19:42:13.154534
39490,55,1098,9,27,330,1519,2022-03-12 19:42:15.063136
39502,2,15,3,25,29,74,2022-03-12 19:42:17.278373
39503,2,9,3,32,25,71,2022-03-12 19:42:17.478373
39514,31,256,28,30,456,801,2022-03-12 19:42:18.687454
39529,22,290,13,54,470,849,2022-03-12 19:42:19.932495
39538,450,1025,192,71,2889,4627,2022-03-12 19:42:20.890734
39549,4,231,1,14,39,289,2022-03-12 19:42:22.131734
39566,9,139,0,25,48,221,2022-03-12 19:42:23.361877
39575,27356,111681,12157,13355,80611,245160,2022-03-12 19:42:24.47885
39585,150,1771,89,93,6519,8622,2022-03-12 19:42:25.742876
39592,887,9141,362,292,5325,16007,2022-03-12 19:42:26.868011
39616,3,126,1,12,23,165,2022-03-12 19:42:28.136013
39624,3,7,1,31,24,66,2022-03-12 19:42:29.533093
39634,8,27,2,16,50,103,2022-03-12 19:42:30.501723
39653,402,1,177,130,909,1619,2022-03-12 19:42:31.747828
39675,534,924,111,215,1942,3726,2022-03-12 19:42:32.976964
39684,11,509,6,14,127,667,2022-03-12 19:42:34.057958
39697,9,183,6,34,103,335,2022-03-12 19:42:35.350683
39707,12,196,5,25,113,351,2022-03-12 19:42:36.592784
39718,5,125,2,13,35,180,2022-03-12 19:42:37.686788
39731,118,299,51,82,767,1317,2022-03-12 19:42:39.097926
39738,70,1268,34,96,922,2390,2022-03-12 19:42:40.241106
39761,820,15123,232,198,13404,29777,2022-03-12 19:42:41.323257
39769,12,1411,4,24,117,1568,2022-03-12 19:42:42.583244
39790,15477,62122,6027,8055,60763,152444,2022-03-12 19:42:43.867364
39808,9079,39116,2130,954,45864,97143,2022-03-12 19:42:44.952381
39823,169,178,26,76,540,989,2022-03-12 19:42:46.210586
39840,45,396,12,37,322,812,2022-03-12 19:42:47.425227
39857,5,78,0,9,16,108,2022-03-12 19:42:48.523231
39885,21,270,11,34,221,557,2022-03-12 19:42:50.95467
39894,0,0,0,1,17592,17593,2022-03-12 19:42:52.222672
39910,2,119,0,14,19,154,2022-03-12 19:42:53.279804
39920,4,140,0,13,23,180,2022-03-12 19:42:54.506313
39936,11,172,11,44,128,366,2022-03-12 19:42:55.754959
39957,8,215,4,15,91,333,2022-03-12 19:42:57.140086
44124,0,0,0,0,0,0,2022-03-12 19:53:04.936271
44125,0,0,0,0,0,0,2022-03-12 19:53:05.802842
47459,0,0,0,0,0,0,2022-03-12 20:24:16.415436
39967,23,271,15,42,626,977,2022-03-12 19:42:58.090086
39988,12930,145814,4349,3473,32914,199480,2022-03-12 19:42:59.382438
39997,4,206,3,18,42,273,2022-03-12 19:43:00.633438
40005,1648,17200,338,334,5862,25382,2022-03-12 19:43:01.738438
40015,10,160,2,34,58,264,2022-03-12 19:43:03.038594
40031,874,7115,353,484,5082,13908,2022-03-12 19:43:04.102619
40044,52,1528,31,65,1173,2849,2022-03-12 19:43:05.507355
40057,12,328,6,39,197,582,2022-03-12 19:43:15.254702
40058,3,130,1,17,20,171,2022-03-12 19:43:15.502678
40059,9098,67113,2248,911,40406,119776,2022-03-12 19:43:15.667675
40060,22067,190293,8820,10502,68309,299991,2022-03-12 19:43:15.839675
40074,5455,14069,1626,17138,22976,61264,2022-03-12 19:43:16.855515
40085,854,2810,389,1775,4385,10213,2022-03-12 19:43:17.916515
40100,882,3860,282,304,3994,9322,2022-03-12 19:43:19.13462
40112,15,262,3,20,97,397,2022-03-12 19:43:20.416246
40136,1895,6521,853,3012,5853,18134,2022-03-12 19:43:21.532564
40147,22,739,11,32,242,1046,2022-03-12 19:43:25.133942
40148,3032,15307,1390,3442,16058,39229,2022-03-12 19:43:25.328982
40151,677,1908,214,254,2357,5410,2022-03-12 19:43:25.486981
40156,198,2511,71,104,2494,5378,2022-03-12 19:43:26.612979
40165,5708,15480,2330,13944,20022,57484,2022-03-12 19:43:27.565006
40179,48,731,32,65,417,1293,2022-03-12 19:43:29.006625
40194,85,770,18,17,463,1353,2022-03-12 19:43:29.95376
40208,271,705,86,147,1581,2790,2022-03-12 19:43:31.163444
40228,654,7880,291,435,3111,12371,2022-03-12 19:43:32.523474
40239,741,22077,205,420,4639,28082,2022-03-12 19:43:33.561548
40254,1929,14032,568,1386,11871,29786,2022-03-12 19:43:36.377833
40267,1404,1582,431,1010,13877,18304,2022-03-12 19:43:37.174566
40291,21,772,10,33,139,975,2022-03-12 19:43:40.474947
40293,16,766,8,33,128,951,2022-03-12 19:43:40.84504
40304,2,112,2,9,17,142,2022-03-12 19:43:42.069054
40323,637,5398,218,164,6225,12642,2022-03-12 19:43:46.289751
40327,1038,822,433,564,3274,6131,2022-03-12 19:43:46.478748
40334,174,2818,173,151,2582,5898,2022-03-12 19:43:48.030824
40346,3,118,3,11,29,164,2022-03-12 19:43:49.332347
40350,5,148,3,14,66,236,2022-03-12 19:43:51.696072
40351,32779,1,8337,6258,13049,60424,2022-03-12 19:43:51.904072
40359,9939,32342,3479,9472,42739,97971,2022-03-12 19:43:55.384267
40360,5,469,6,16,66,562,2022-03-12 19:43:55.667266
40361,6,152,3,26,34,221,2022-03-12 19:43:55.838293
40365,5,25,3,18,38,89,2022-03-12 19:43:56.385267
40376,32,75,4,47,136,294,2022-03-12 19:43:57.583536
40392,8309,52546,3330,4271,38621,107077,2022-03-12 19:43:58.809536
40407,2,31,4,21,44,102,2022-03-12 19:44:00.031679
40421,2828,120362,839,461,50533,175023,2022-03-12 19:44:01.270435
40434,6158,13914,747,435,30228,51482,2022-03-12 19:44:02.357413
40442,12,391,3,14,64,484,2022-03-12 19:44:03.582554
40462,63,770,32,80,731,1676,2022-03-12 19:44:04.875558
40474,4,172,2,13,38,229,2022-03-12 19:44:06.094052
40482,11,57,4,32,79,183,2022-03-12 19:44:07.182054
40491,605,12528,146,125,5668,19072,2022-03-12 19:44:08.401087
40507,84890,8,1990,3044,131153,221085,2022-03-12 19:44:09.671752
40517,61,920,23,45,662,1711,2022-03-12 19:44:14.978616
40523,4,161,0,9,24,198,2022-03-12 19:44:15.172613
40526,6244,15428,1599,7910,14369,45550,2022-03-12 19:44:18.143255
40527,4,106,3,9,26,148,2022-03-12 19:44:18.316255
40529,5429,31498,1980,2373,27495,68775,2022-03-12 19:44:18.493258
40530,29758,151607,6367,11904,71578,271214,2022-03-12 19:44:18.756255
40543,30,101,18,36,356,541,2022-03-12 19:44:23.11619
40550,7634,25824,2699,7765,28112,72034,2022-03-12 19:44:23.322192
40552,2,47,3,19,26,97,2022-03-12 19:44:23.50619
40558,11,329,5,10,54,409,2022-03-12 19:44:24.468701
40568,57,232,18,43,398,748,2022-03-12 19:44:25.566824
40583,0,0,0,0,0,0,2022-03-12 19:44:26.788826
44309,0,0,0,0,0,0,2022-03-12 19:54:54.452551
44310,0,0,0,0,0,0,2022-03-12 19:54:55.281133
44312,0,0,0,0,0,0,2022-03-12 19:54:57.328277
40595,24823,115221,6407,14310,57417,218178,2022-03-12 19:44:28.102384
40606,9,232,1,25,90,357,2022-03-12 19:44:29.173634
40620,29263,55188,5844,8040,54149,152484,2022-03-12 19:44:30.390191
40633,1,59,0,8,30,98,2022-03-12 19:44:31.605721
40651,114,1666,42,109,893,2824,2022-03-12 19:44:32.858723
40661,239,6133,77,69,2196,8714,2022-03-12 19:44:33.933205
40674,4,13,3,30,42,92,2022-03-12 19:44:37.745621
40677,894,3356,443,716,4582,9991,2022-03-12 19:44:37.964647
40682,15822,15324,2203,1178,28985,63512,2022-03-12 19:44:40.978293
40683,8,419,3,8,61,499,2022-03-12 19:44:41.45729
40684,12,335,3,9,43,402,2022-03-12 19:44:41.637292
40690,10,326,2,22,58,418,2022-03-12 19:44:42.717307
40699,3,144,2,15,28,192,2022-03-12 19:44:43.540733
40711,249,1684,77,129,2390,4529,2022-03-12 19:44:44.740272
40721,6,339,2,11,47,405,2022-03-12 19:44:45.979154
40734,776,2582,92,169,1240,4859,2022-03-12 19:44:47.225244
40747,502,6078,187,227,9795,16789,2022-03-12 19:44:48.474249
40756,16,132,16,36,153,353,2022-03-12 19:44:49.71779
40768,50,0,30,39,76,195,2022-03-12 19:44:50.807369
40783,3329,14237,1030,5332,9631,33559,2022-03-12 19:44:52.043558
40794,5,98,3,5,20,131,2022-03-12 19:44:53.24676
40811,5,151,2,7,39,204,2022-03-12 19:44:54.473122
40820,0,0,0,0,0,0,2022-03-12 19:44:55.581459
40833,1790,6427,419,790,2990,12416,2022-03-12 19:44:57.620636
44318,0,0,0,0,0,0,2022-03-12 19:54:59.657133
44321,0,0,0,0,0,0,2022-03-12 19:55:00.842736
44329,0,0,0,0,0,0,2022-03-12 19:55:03.305779
40835,247,1546,96,104,1555,3548,2022-03-12 19:44:58.209663
40842,5027,14422,1771,2124,27067,50411,2022-03-12 19:44:59.277202
40850,1014,2885,466,1602,3575,9542,2022-03-12 19:45:00.460762
40863,2,17,2,26,73,120,2022-03-12 19:45:01.678984
40877,4,117,3,9,22,155,2022-03-12 19:45:02.858985
40893,282,1998,68,274,1319,3941,2022-03-12 19:45:04.077398
40905,3,94,2,8,19,126,2022-03-12 19:45:05.303271
40914,17,677,2,15,60,771,2022-03-12 19:45:06.397278
40934,5637,9980,2457,6283,19183,43540,2022-03-12 19:45:07.832781
40948,112,710,42,69,942,1875,2022-03-12 19:45:08.897804
40962,0,0,0,0,0,0,2022-03-12 19:45:09.991862
40974,10041,66968,2648,5857,26384,111898,2022-03-12 19:45:11.224549
40995,465,1694,159,677,1995,4990,2022-03-12 19:45:12.43355
41023,8,276,4,10,31,329,2022-03-12 19:45:13.826524
41030,61,1104,35,43,724,1967,2022-03-12 19:45:14.964094
41043,0,0,0,0,0,0,2022-03-12 19:45:16.431759
41053,994,29223,444,246,10608,41515,2022-03-12 19:45:17.392195
44332,0,0,0,0,0,0,2022-03-12 19:55:04.473949
44335,0,0,0,0,0,0,2022-03-12 19:55:05.69763
41062,139,140,49,241,620,1189,2022-03-12 19:45:18.469197
41075,39,622,64,67,432,1224,2022-03-12 19:45:19.689831
41084,3,0,6,0,129995,130004,2022-03-12 19:45:20.823012
41096,7,124,5,45,112,293,2022-03-12 19:45:22.181158
41105,224,4026,105,138,3172,7665,2022-03-12 19:45:23.341826
41116,3,22,4,25,31,85,2022-03-12 19:45:24.426827
41126,0,0,0,0,0,0,2022-03-12 19:45:25.800181
41135,13,322,4,29,134,502,2022-03-12 19:45:27.259809
41141,0,0,0,0,3496,3496,2022-03-12 19:45:28.074817
41158,7,29,5,16,41,98,2022-03-12 19:45:29.29492
44338,0,0,0,0,0,0,2022-03-12 19:55:06.818683
44342,0,0,0,0,0,0,2022-03-12 19:55:12.493801
41168,5851,241447,1716,1324,65126,315464,2022-03-12 19:45:30.396489
41179,4,407,5,7,42,465,2022-03-12 19:45:31.635026
41189,66,1088,55,73,970,2252,2022-03-12 19:45:32.855026
41195,113,3532,23,33,493,4194,2022-03-12 19:45:34.216688
41206,627,1667,310,181,1965,4750,2022-03-12 19:45:36.429876
41220,0,0,0,0,473,473,2022-03-12 19:45:37.672562
41232,0,0,0,0,0,0,2022-03-12 19:45:38.888566
41242,0,0,0,0,0,0,2022-03-12 19:45:40.133633
41250,27,61,10,30,176,304,2022-03-12 19:45:41.332864
41265,13778,28817,4500,10736,50715,108546,2022-03-12 19:45:42.41886
44343,0,0,0,0,0,0,2022-03-12 19:55:16.243942
41283,297,1023,109,263,1256,2948,2022-03-12 19:45:43.837013
41295,0,0,0,0,0,0,2022-03-12 19:45:44.913045
41308,3,100,1,4,11,119,2022-03-12 19:45:46.132483
41319,31,1270,17,33,224,1575,2022-03-12 19:45:47.206482
41349,14,60,14,86,171,345,2022-03-12 19:45:48.485693
41379,2150,8268,677,536,33200,44831,2022-03-12 19:45:49.732458
41389,56075,353197,14256,15408,114969,553905,2022-03-12 19:45:50.857068
41405,441,817,88,373,1110,2829,2022-03-12 19:45:52.851762
41410,0,0,0,0,0,0,2022-03-12 19:45:53.379894
44344,0,0,0,0,0,0,2022-03-12 19:55:19.722869
44345,0,0,0,0,0,0,2022-03-12 19:55:21.068866
41431,3,154,2,9,34,202,2022-03-12 19:45:54.706999
41444,4,159,1,6,25,195,2022-03-12 19:45:55.677252
41451,3,96,2,5,19,125,2022-03-12 19:45:56.955231
41458,21,0,8,57,71,157,2022-03-12 19:45:58.055795
41466,2548,14146,499,1900,7711,26804,2022-03-12 19:45:59.252795
41480,68,624,6,31,346,1075,2022-03-12 19:46:00.481916
41494,1,24,2,18,35,80,2022-03-12 19:46:01.679118
41504,7,77,3,32,58,177,2022-03-12 19:46:02.936123
41520,799,2788,243,341,5137,9308,2022-03-12 19:46:04.04527
41534,6,101,3,5,15,130,2022-03-12 19:46:05.387083
41546,17,0,6,37,44,104,2022-03-12 19:46:06.58876
41564,13,456,9,39,152,669,2022-03-12 19:46:07.651293
41570,25,353,5,11,106,500,2022-03-12 19:46:08.874293
41590,926,16163,357,279,10417,28142,2022-03-12 19:46:10.090057
41619,25165,143112,6867,12744,68746,256634,2022-03-12 19:46:11.298144
41629,0,0,0,0,0,0,2022-03-12 19:46:12.527703
44347,0,0,0,0,0,0,2022-03-12 19:55:21.876457
44348,0,0,0,0,0,0,2022-03-12 19:55:22.644453
44352,0,0,0,0,0,0,2022-03-12 19:55:26.236493
41637,13,178,13,28,97,329,2022-03-12 19:46:13.631802
41659,193,1954,125,79,3523,5874,2022-03-12 19:46:14.873802
41674,219,2445,129,56,5972,8821,2022-03-12 19:46:16.103581
41697,0,0,0,0,0,0,2022-03-12 19:46:17.404581
41722,2,72,3,7,15,99,2022-03-12 19:46:20.064194
41725,4,181,0,4,42,231,2022-03-12 19:46:20.360961
41734,16,31,11,39,315,412,2022-03-12 19:46:20.850965
41760,0,0,0,0,0,0,2022-03-12 19:46:22.24816
41776,3,38,5,38,82,166,2022-03-12 19:46:23.316162
44354,0,0,0,0,0,0,2022-03-12 19:55:27.973099
44357,0,0,0,0,0,0,2022-03-12 19:55:29.083076
44361,0,0,0,0,0,0,2022-03-12 19:55:30.966881
41786,3,68,1,8,18,98,2022-03-12 19:46:24.537874
41808,6,51,8,34,103,202,2022-03-12 19:46:25.662233
41833,10058,19662,1732,5265,22491,59208,2022-03-12 19:46:26.949207
41855,0,0,0,0,0,0,2022-03-12 19:46:28.282717
41884,1020,0,76,111,556,1763,2022-03-12 19:46:29.378715
41915,0,0,0,0,4879,4879,2022-03-12 19:46:30.577727
41926,5,97,3,6,20,131,2022-03-12 19:46:31.749929
41957,0,0,0,0,0,0,2022-03-12 19:46:35.957432
41962,0,0,0,0,0,0,2022-03-12 19:46:36.310432
41963,0,0,0,0,0,0,2022-03-12 19:46:36.477429
41971,0,0,0,0,0,0,2022-03-12 19:46:37.757607
41977,0,0,0,0,0,0,2022-03-12 19:46:38.962611
41985,0,0,0,0,0,0,2022-03-12 19:46:40.273788
41993,0,0,0,0,0,0,2022-03-12 19:46:41.543001
41999,0,0,0,0,0,0,2022-03-12 19:46:42.50128
44362,0,0,0,0,0,0,2022-03-12 19:55:31.876487
44370,0,0,0,0,0,0,2022-03-12 19:55:36.232035
47462,0,0,0,0,0,0,2022-03-12 20:24:17.635586
47468,0,0,0,0,0,0,2022-03-12 20:24:19.936517
42055,31,133,16,31,286,497,2022-03-12 19:46:46.156605
42076,69,2950,11,36,175,3241,2022-03-12 19:46:50.593396
42078,5,1073,3,7,65,1153,2022-03-12 19:46:50.799399
42082,112,241,25,83,163,624,2022-03-12 19:46:51.125399
42083,4,4,1,4,12,25,2022-03-12 19:46:51.288396
42104,5,332,3,7,46,393,2022-03-12 19:46:52.07353
42128,54,1304,44,58,456,1916,2022-03-12 19:46:53.388526
42138,0,0,0,0,0,0,2022-03-12 19:46:54.555404
44668,0,0,0,0,0,0,2022-03-12 19:59:06.060924
44669,0,0,0,0,0,0,2022-03-12 19:59:07.486603
44670,0,0,0,0,0,0,2022-03-12 19:59:08.234832
44671,0,0,0,0,0,0,2022-03-12 19:59:09.034775
42148,125,178,30,99,455,887,2022-03-12 19:46:55.882714
42163,425,0,109,59,1358,1951,2022-03-12 19:46:56.939719
42178,254,274,72,177,1767,2544,2022-03-12 19:46:58.137185
42194,339,1412,137,148,3369,5405,2022-03-12 19:46:59.530193
42208,2,94,1,19,26,142,2022-03-12 19:47:00.699173
42229,0,0,0,0,0,0,2022-03-12 19:47:01.783373
42246,3,182,2,19,64,270,2022-03-12 19:47:03.017376
42258,5,70,1,9,56,141,2022-03-12 19:47:04.128068
44675,0,0,0,0,0,0,2022-03-12 19:59:12.486686
44676,0,0,0,0,0,0,2022-03-12 19:59:13.365772
44678,0,0,0,0,0,0,2022-03-12 19:59:14.322579
42271,2,73,2,10,36,123,2022-03-12 19:47:05.530171
42276,2,77,2,8,34,123,2022-03-12 19:47:06.520311
42285,240,224,49,116,1047,1676,2022-03-12 19:47:07.762845
42297,15,13,8,10,132,178,2022-03-12 19:47:09.02485
42319,71,109,22,61,528,791,2022-03-12 19:47:10.30386
42331,13,17,9,45,229,313,2022-03-12 19:47:11.38786
42345,15,100,10,44,156,325,2022-03-12 19:47:12.631965
42359,178,481,49,48,2173,2929,2022-03-12 19:47:13.726968
42378,7,214,4,8,29,262,2022-03-12 19:47:14.969001
42393,0,0,0,0,0,0,2022-03-12 19:47:16.189584
42415,0,0,0,0,0,0,2022-03-12 19:47:17.306692
42436,7,195,5,5,21,233,2022-03-12 19:47:18.520962
42446,5,27,4,29,46,111,2022-03-12 19:47:21.183095
42447,2,27,4,33,40,106,2022-03-12 19:47:21.377105
42453,0,0,0,0,0,0,2022-03-12 19:47:22.132245
42463,41,0,8,43,80,172,2022-03-12 19:47:23.70632
42476,41,346,38,56,608,1089,2022-03-12 19:47:24.647345
42486,43,369,17,55,212,696,2022-03-12 19:47:25.714155
44691,0,0,0,0,0,0,2022-03-12 19:59:19.340836
44693,0,0,0,0,0,0,2022-03-12 19:59:20.305022
42500,12,145,5,44,79,285,2022-03-12 19:47:26.90913
42516,1837,2943,467,1678,4295,11220,2022-03-12 19:47:28.128225
42533,0,0,0,0,0,0,2022-03-12 19:47:29.350225
42550,18,10,4,39,142,213,2022-03-12 19:47:30.612332
42576,1,115,2,5,26,149,2022-03-12 19:47:31.842695
42601,4,81,1,11,21,118,2022-03-12 19:47:32.94472
42625,16512,62606,3034,4365,57990,144507,2022-03-12 19:47:34.17782
42639,2,65,3,5,14,89,2022-03-12 19:47:35.414451
44697,0,0,0,0,0,0,2022-03-12 19:59:21.517859
44701,0,0,0,0,0,0,2022-03-12 19:59:23.696766
47472,0,0,0,0,0,0,2022-03-12 20:24:21.285538
42653,476,674,159,261,1001,2571,2022-03-12 19:47:36.61307
42666,2,72,2,8,16,100,2022-03-12 19:47:37.828166
42685,337,2612,134,193,2449,5725,2022-03-12 19:47:39.053168
42699,14,61,5,27,104,211,2022-03-12 19:47:40.192824
42725,2,103,3,6,21,135,2022-03-12 19:47:41.452337
42740,17,61,9,33,61,181,2022-03-12 19:47:42.541422
42760,4,27,5,36,43,115,2022-03-12 19:47:43.745421
42776,0,0,0,0,0,0,2022-03-12 19:47:44.955964
44820,0,0,0,0,0,0,2022-03-12 20:00:49.148398
44821,0,0,0,0,0,0,2022-03-12 20:00:49.997531
44828,0,0,0,0,0,0,2022-03-12 20:00:53.727452
42792,3,66,4,5,17,95,2022-03-12 19:47:46.146154
42802,4,86,0,6,21,117,2022-03-12 19:47:47.413155
42812,0,0,0,0,0,0,2022-03-12 19:47:48.648769
42831,222,894,128,142,1564,2950,2022-03-12 19:47:49.731794
42842,3,84,4,9,21,121,2022-03-12 19:47:50.948293
42854,7,116,6,7,20,156,2022-03-12 19:47:52.163383
42872,4,61,2,6,14,87,2022-03-12 19:47:53.514384
42883,474,2969,135,674,1542,5794,2022-03-12 19:47:54.580211
44829,0,0,0,0,0,0,2022-03-12 20:00:54.57454
44831,0,0,0,0,0,0,2022-03-12 20:00:57.582271
44832,0,0,0,0,0,0,2022-03-12 20:00:58.423435
44833,0,0,0,0,0,0,2022-03-12 20:01:01.040523
42889,92,1673,45,36,826,2672,2022-03-12 19:47:55.739184
42898,238,896,32,77,236,1479,2022-03-12 19:47:56.965482
42913,76,847,39,49,874,1885,2022-03-12 19:47:58.176121
42928,0,0,0,0,0,0,2022-03-12 19:47:59.386121
42940,3341,50610,526,315,13415,68207,2022-03-12 19:48:00.628963
42950,186,333,44,64,698,1325,2022-03-12 19:48:02.014923
42959,887,5582,243,316,4623,11651,2022-03-12 19:48:05.199552
42962,1,0,1,1,80837,80840,2022-03-12 19:48:05.394157
44834,0,0,0,0,0,0,2022-03-12 20:01:02.782736
44835,0,0,0,0,0,0,2022-03-12 20:01:03.713661
44836,0,0,0,0,0,0,2022-03-12 20:01:04.580777
44841,0,0,0,0,0,0,2022-03-12 20:01:09.225591
42976,361,7828,105,180,3140,11614,2022-03-12 19:48:06.679267
42990,383,7836,147,129,5076,13571,2022-03-12 19:48:07.878479
43005,3,59,3,7,13,85,2022-03-12 19:48:09.1165
43196,2,6,4,16,19,47,2022-03-12 19:48:10.178744
43212,1,33,2,9,13,58,2022-03-12 19:48:11.418858
43219,1,41,2,8,19,71,2022-03-12 19:48:12.663454
43227,0,23,2,6,7,38,2022-03-12 19:48:14.352017
43232,0,8,2,6,9,25,2022-03-12 19:48:15.015059
43283,0,7,1,6,11,25,2022-03-12 19:48:22.281929
43293,5,113,2,6,21,147,2022-03-12 19:48:23.497929
43307,0,0,0,0,0,0,2022-03-12 19:48:24.706962
43314,1,15,0,4,12,32,2022-03-12 19:48:25.770578
43323,6,85,3,7,18,119,2022-03-12 19:48:26.985332
43341,0,18,1,7,8,34,2022-03-12 19:48:28.386472
43348,0,2,0,7,13,22,2022-03-12 19:48:29.462469
43353,484,3838,148,213,1749,6432,2022-03-12 19:48:30.629267
43362,0,11,0,9,10,30,2022-03-12 19:48:31.837304
44843,0,0,0,0,0,0,2022-03-12 20:01:13.201918
44845,0,0,0,0,0,0,2022-03-12 20:01:15.0529
47475,0,0,0,0,0,0,2022-03-12 20:24:22.475921
43370,0,5,1,9,10,25,2022-03-12 19:48:33.0188
43378,0,6,1,6,11,24,2022-03-12 19:48:34.272902
43386,0,13,2,7,12,34,2022-03-12 19:48:35.482559
43394,0,8,2,5,10,25,2022-03-12 19:48:36.594195
43402,0,8,2,6,10,26,2022-03-12 19:48:37.913219
43406,0,9,2,4,9,24,2022-03-12 19:48:39.453336
43412,0,8,1,5,11,25,2022-03-12 19:48:40.251056
43429,5,34,6,9,52,106,2022-03-12 19:48:41.855058
44918,0,0,0,0,0,0,2022-03-12 20:01:59.733801
43431,4,8,6,14,24,56,2022-03-12 19:48:42.775486
43444,9,250,3,10,84,356,2022-03-12 19:48:43.832486
43456,0,10,3,9,11,33,2022-03-12 19:48:45.036534
43464,1,4,2,6,11,24,2022-03-12 19:48:46.333825
43479,0,0,0,0,0,0,2022-03-12 19:48:47.417346
43485,2,56,2,6,14,80,2022-03-12 19:48:48.821337
43494,0,7,2,5,10,24,2022-03-12 19:48:50.010691
43502,0,9,1,7,10,27,2022-03-12 19:48:51.071795
43511,0,8,1,6,9,24,2022-03-12 19:48:53.766983
43512,0,9,1,7,10,27,2022-03-12 19:48:53.972983
43516,0,7,1,7,10,25,2022-03-12 19:48:54.607176
43525,0,9,0,5,10,24,2022-03-12 19:48:55.856798
43537,1,13,0,5,13,32,2022-03-12 19:48:57.169086
43544,1,10,0,5,10,26,2022-03-12 19:48:58.327717
43555,1475,27774,393,375,12551,42568,2022-03-12 19:48:59.40972
43569,0,6,1,6,10,23,2022-03-12 19:49:00.809773
43579,1,11,0,8,9,29,2022-03-12 19:49:01.935769
44925,0,0,0,0,0,0,2022-03-12 20:02:02.159948
43587,0,12,1,5,7,25,2022-03-12 19:49:03.061507
43597,0,23,0,6,10,39,2022-03-12 19:49:04.304205
43607,0,13,1,7,10,31,2022-03-12 19:49:05.70748
43610,0,7,1,8,10,26,2022-03-12 19:49:06.63067
43619,0,10,1,7,8,26,2022-03-12 19:49:07.915669
43627,2,80,1,7,18,108,2022-03-12 19:49:09.107233
43638,0,25,0,5,7,37,2022-03-12 19:49:11.405877
43639,0,25,1,4,7,37,2022-03-12 19:49:11.604877
43648,1,11,1,7,8,28,2022-03-12 19:49:12.699997
43656,0,13,3,12,10,38,2022-03-12 19:49:13.937998
43663,0,11,1,7,6,25,2022-03-12 19:49:15.111996
43671,0,11,2,4,12,29,2022-03-12 19:49:16.339204
43678,0,5,0,7,11,23,2022-03-12 19:49:17.463204
43689,1,72,1,9,15,98,2022-03-12 19:49:18.721496
43702,4,18,3,18,34,77,2022-03-12 19:49:20.121106
43727,58,209,14,34,374,689,2022-03-12 19:49:21.056681
43751,37,2174,20,60,522,2813,2022-03-12 19:49:24.740941
43755,193,103,135,29,8560,9020,2022-03-12 19:49:24.950915
43756,12436,32644,3029,3744,31736,83589,2022-03-12 19:49:25.121916
43767,4315,7719,1037,3255,22315,38641,2022-03-12 19:49:26.054941
43772,37,52,12,36,159,296,2022-03-12 19:49:27.057571
43795,0,11,1,7,10,29,2022-03-12 19:49:28.374294
43802,0,10,1,8,10,29,2022-03-12 19:49:29.438294
43810,0,6,1,7,13,27,2022-03-12 19:49:30.703903
43879,8,396,0,5,46,455,2022-03-12 19:49:40.366199
43887,0,0,0,0,0,0,2022-03-12 19:49:41.475201
43893,0,0,0,0,0,0,2022-03-12 19:49:44.403172
43894,0,0,0,0,0,0,2022-03-12 19:49:45.266788
43895,0,0,0,0,0,0,2022-03-12 19:49:46.017784
43897,0,0,0,0,0,0,2022-03-12 19:49:46.923909
43901,0,0,0,0,0,0,2022-03-12 19:49:48.139936
43906,0,0,0,0,0,0,2022-03-12 19:49:50.256319
43907,0,0,0,0,0,0,2022-03-12 19:49:51.203319
43908,0,0,0,0,0,0,2022-03-12 19:49:52.523485
43909,0,0,0,0,0,0,2022-03-12 19:49:53.301447
43910,0,0,0,0,0,0,2022-03-12 19:49:54.350546
43912,0,0,0,0,0,0,2022-03-12 19:49:55.301555
43916,0,0,0,0,0,0,2022-03-12 19:49:56.747322
43918,0,0,0,0,0,0,2022-03-12 19:49:58.493392
43919,8,289,1,5,21,324,2022-03-12 19:49:59.905392
43933,0,0,0,0,0,0,2022-03-12 19:50:03.80903
43935,0,0,0,0,0,0,2022-03-12 19:50:04.996714
43938,0,0,0,0,0,0,2022-03-12 19:50:06.204379
43942,0,0,0,0,0,0,2022-03-12 19:50:07.413018
43945,0,0,0,0,0,0,2022-03-12 19:50:08.921018
43949,0,0,0,0,0,0,2022-03-12 19:50:11.018852
43958,0,0,0,0,0,0,2022-03-12 19:50:14.68412
43961,0,0,0,0,0,0,2022-03-12 19:50:15.82724
43964,0,0,0,0,0,0,2022-03-12 19:50:16.956598
43974,0,0,0,0,0,0,2022-03-12 19:50:19.344217
44928,0,0,0,0,0,0,2022-03-12 20:02:03.370619
47481,0,0,0,0,0,0,2022-03-12 20:24:24.71745
47485,0,0,0,0,0,0,2022-03-12 20:24:26.552648
43982,1,47,0,20,34,102,2022-03-12 19:50:22.476366
43983,2,39,1,19,22,83,2022-03-12 19:50:23.728369
43987,1,30,0,19,22,72,2022-03-12 19:50:28.189178
43994,1,24,0,20,21,66,2022-03-12 19:50:31.793532
43996,1,26,0,19,22,68,2022-03-12 19:50:44.244272
43997,1,22,0,20,21,64,2022-03-12 19:50:50.026144
43998,1,24,1,20,20,66,2022-03-12 19:50:50.956427
43999,1,23,1,19,22,66,2022-03-12 19:50:52.083404
44000,1,27,0,19,23,70,2022-03-12 19:50:54.907603
44001,2,26,0,19,22,69,2022-03-12 19:50:56.07829
44003,2,26,0,21,29,78,2022-03-12 19:50:58.314011
44004,1,19,0,18,29,67,2022-03-12 19:50:59.702408
44010,1,22,2,21,22,68,2022-03-12 19:51:07.027489
44011,1,17,1,20,24,63,2022-03-12 19:51:07.958552
44012,1,20,1,21,24,67,2022-03-12 19:51:09.188458
44013,1,17,1,24,25,68,2022-03-12 19:51:10.569871
44014,3,9,0,12,19,43,2022-03-12 19:51:11.583875
44015,0,0,0,0,0,0,2022-03-12 19:51:12.395872
44017,0,0,0,0,0,0,2022-03-12 19:51:14.104079
44018,0,0,0,0,0,0,2022-03-12 19:51:14.919314
44019,0,0,0,0,0,0,2022-03-12 19:51:15.767061
44021,0,0,0,0,0,0,2022-03-12 19:51:18.587315
44024,0,0,0,0,0,0,2022-03-12 19:51:19.423312
44025,12,36,5,8,1440,1501,2022-03-12 19:51:19.591316
44034,0,0,0,0,0,0,2022-03-12 19:51:22.356403
44040,186,1232,69,453,456,2396,2022-03-12 19:51:25.098142
44041,161,304,50,154,498,1167,2022-03-12 19:51:27.362761
44042,19674,1,2065,1822,19559,43121,2022-03-12 19:51:27.558787
44046,2,51,0,3,9,65,2022-03-12 19:51:31.627712
45004,0,0,0,0,0,0,2022-03-12 20:02:44.910524
45006,0,0,0,0,0,0,2022-03-12 20:02:45.922482
44047,261,393,36,93,250,1033,2022-03-12 19:51:33.163783
44048,17,31,6,34,122,210,2022-03-12 19:51:34.587795
44050,67,1242,35,50,578,1972,2022-03-12 19:51:36.849154
44053,55,0,13,30,100,198,2022-03-12 19:51:37.039158
44055,47201,13,1104,1781,41997,92096,2022-03-12 19:51:37.207154
44056,1,0,0,0,3453,3454,2022-03-12 19:51:39.961807
44059,529,21887,113,53,7680,30262,2022-03-12 19:51:43.048212
44060,0,0,0,0,296,296,2022-03-12 19:51:44.314222
44061,71,2139,30,46,525,2811,2022-03-12 19:51:47.122929
45009,0,0,0,0,0,0,2022-03-12 20:02:47.10773
45018,0,0,0,0,0,0,2022-03-12 20:02:49.726038
45019,0,0,0,0,0,0,2022-03-12 20:02:50.52284
44067,163,432,45,55,1302,1997,2022-03-12 19:51:57.186602
44068,390,1024,70,77,1038,2599,2022-03-12 19:51:59.529244
44069,10456,19519,1135,663,27336,59109,2022-03-12 19:52:05.065031
44071,264,588,28,64,490,1434,2022-03-12 19:52:10.72039
44072,134,111,37,51,805,1138,2022-03-12 19:52:12.914021
44074,22660,61328,4504,2204,95526,186222,2022-03-12 19:52:15.390335
44076,0,0,0,0,306,306,2022-03-12 19:52:18.250437
44078,85,79,22,35,239,460,2022-03-12 19:52:21.289895
45023,0,0,0,0,0,0,2022-03-12 20:02:51.818506
47486,0,0,0,0,0,0,2022-03-12 20:24:27.428903
47488,0,0,0,0,0,0,2022-03-12 20:24:28.428826
44084,7,197,2,4,34,244,2022-03-12 19:52:26.331474
44086,25,1232,11,23,176,1467,2022-03-12 19:52:28.845539
44087,1675,29359,536,219,19500,51289,2022-03-12 19:52:29.769549
44089,2,45,0,2,4,53,2022-03-12 19:52:30.823657
44096,35,29,11,29,219,323,2022-03-12 19:52:35.661711
44097,150,406,50,65,868,1539,2022-03-12 19:52:37.535878
44099,3,67,1,5,18,94,2022-03-12 19:52:38.621878
44101,0,0,0,0,0,0,2022-03-12 19:52:39.911004
44105,0,0,0,0,0,0,2022-03-12 19:52:42.659817
44109,0,0,0,0,0,0,2022-03-12 19:52:44.759157
44110,0,0,0,0,0,0,2022-03-12 19:52:45.667188
44113,0,0,0,0,0,0,2022-03-12 19:52:49.217252
44126,2,16,1,1,26,46,2022-03-12 19:53:07.1332
44127,0,0,0,0,0,0,2022-03-12 19:53:08.543199
44128,0,0,0,0,0,0,2022-03-12 19:53:09.381596
44129,95,1297,33,74,731,2230,2022-03-12 19:53:12.21986
44131,0,0,0,0,0,0,2022-03-12 19:53:13.597979
44133,0,6,0,3,7,16,2022-03-12 19:53:15.09367
44135,0,0,0,0,0,0,2022-03-12 19:53:15.957785
44136,0,0,0,0,0,0,2022-03-12 19:53:16.750786
44139,0,0,0,0,0,0,2022-03-12 19:53:17.837784
44145,0,11,0,11,12,34,2022-03-12 19:53:19.201935
44148,0,12,1,15,14,42,2022-03-12 19:53:20.416114
44152,0,11,1,14,11,37,2022-03-12 19:53:21.627172
45101,0,0,0,0,0,0,2022-03-12 20:03:26.686972
45107,0,0,0,0,0,0,2022-03-12 20:03:29.136098
45115,0,0,0,0,0,0,2022-03-12 20:03:31.552215
44156,0,11,0,16,10,37,2022-03-12 19:53:23.953732
44161,0,7,0,11,10,28,2022-03-12 19:53:26.31904
44164,0,8,0,9,11,28,2022-03-12 19:53:27.53619
44167,3,7,0,10,58,78,2022-03-12 19:53:29.096817
44168,0,0,0,0,0,0,2022-03-12 19:53:29.894814
44173,0,0,0,0,0,0,2022-03-12 19:53:31.771588
44174,0,0,0,0,0,0,2022-03-12 19:53:32.637585
44175,0,0,0,0,0,0,2022-03-12 19:53:34.634184
44176,0,0,0,0,0,0,2022-03-12 19:53:37.15617
44177,0,0,0,0,0,0,2022-03-12 19:53:38.791167
44179,0,0,0,0,0,0,2022-03-12 19:53:41.437905
44180,0,0,0,0,0,0,2022-03-12 19:53:42.276908
44181,0,0,0,0,0,0,2022-03-12 19:53:43.044905
44183,0,0,0,0,0,0,2022-03-12 19:53:44.630435
44185,0,0,0,0,0,0,2022-03-12 19:53:46.433332
44186,0,0,0,0,0,0,2022-03-12 19:53:47.170331
44189,182,3705,59,87,534,4567,2022-03-12 19:53:50.271579
45255,0,0,0,0,0,0,2022-03-12 20:04:24.574128
45257,0,0,0,0,0,0,2022-03-12 20:04:25.603819
44191,2495,1510,525,548,3405,8483,2022-03-12 19:53:53.372816
44196,1005,2455,185,189,1876,5710,2022-03-12 19:53:56.064983
44200,3326,46664,1473,268,94954,146685,2022-03-12 19:53:58.929365
44204,0,0,0,0,51473,51473,2022-03-12 19:54:00.601217
44209,19,40,6,31,151,247,2022-03-12 19:54:04.767769
44212,0,0,0,0,1281,1281,2022-03-12 19:54:06.711627
44218,429,1232,57,124,655,2497,2022-03-12 19:54:07.865743
44221,634,2461,143,135,2297,5670,2022-03-12 19:54:11.265612
44223,5,257,2,5,19,288,2022-03-12 19:54:12.650611
45403,0,0,0,0,0,0,2022-03-12 20:05:44.20248
45407,0,0,0,0,0,0,2022-03-12 20:05:46.896403
44225,3,54,4,13,37,111,2022-03-12 19:54:14.486787
44228,32,63,15,43,256,409,2022-03-12 19:54:15.844099
44232,0,0,0,0,0,0,2022-03-12 19:54:16.680141
44233,0,0,0,0,305,305,2022-03-12 19:54:17.898986
44235,1261,6960,248,386,2018,10873,2022-03-12 19:54:20.193075
44236,124,1144,31,68,855,2222,2022-03-12 19:54:21.757926
44245,1,46,2,15,18,82,2022-03-12 19:54:23.773957
44250,0,0,0,0,0,0,2022-03-12 19:54:30.318946
44251,0,0,0,0,0,0,2022-03-12 19:54:31.153974
44252,0,0,0,0,0,0,2022-03-12 19:54:31.995288
44253,0,0,0,0,0,0,2022-03-12 19:54:32.804289
44257,0,0,0,0,0,0,2022-03-12 19:54:37.207239
44265,0,0,0,0,0,0,2022-03-12 19:54:40.439766
44268,0,0,0,0,0,0,2022-03-12 19:54:41.636275
44271,0,0,0,0,0,0,2022-03-12 19:54:42.737272
44283,0,0,0,0,0,0,2022-03-12 19:54:45.356324
44291,0,0,0,0,0,0,2022-03-12 19:54:47.696817
44300,0,0,0,0,0,0,2022-03-12 19:54:49.984813
44308,0,0,0,0,0,0,2022-03-12 19:54:53.559537
44376,296,0,64,37,586,983,2022-03-12 19:55:38.11955
44385,0,0,0,0,0,0,2022-03-12 19:55:40.002548
44389,241,0,15,34,371,661,2022-03-12 19:55:41.288179
44399,3,12,2,11,22,50,2022-03-12 19:55:50.137571
44402,0,0,0,0,0,0,2022-03-12 19:55:51.832797
44406,3332,3047,363,279,11536,18557,2022-03-12 19:55:53.188794
44407,14,1344,2,11,94,1465,2022-03-12 19:55:56.380748
44408,0,0,0,0,365,365,2022-03-12 19:55:57.802761
44409,0,0,0,0,0,0,2022-03-12 19:55:58.582762
44410,171,242,19,71,318,821,2022-03-12 19:56:00.30861
44411,72,97,24,34,555,782,2022-03-12 19:56:01.821747
45416,0,0,0,0,0,0,2022-03-12 20:05:49.82535
44412,513,2037,47,82,903,3582,2022-03-12 19:56:03.281751
44413,0,0,0,0,0,0,2022-03-12 19:56:04.055382
44415,0,0,0,0,0,0,2022-03-12 19:56:05.289991
44416,0,0,0,0,0,0,2022-03-12 19:56:06.164646
44419,0,0,0,0,0,0,2022-03-12 19:56:09.517643
44420,0,0,0,0,0,0,2022-03-12 19:56:10.339422
44426,0,0,0,0,0,0,2022-03-12 19:56:12.636424
44432,0,0,0,0,0,0,2022-03-12 19:56:13.752643
44435,0,0,0,0,0,0,2022-03-12 19:56:14.960643
44441,0,0,0,0,0,0,2022-03-12 19:56:17.391383
44446,0,0,0,0,0,0,2022-03-12 19:56:18.495086
44450,0,0,0,0,0,0,2022-03-12 19:56:20.467853
44451,0,0,0,0,0,0,2022-03-12 19:56:21.30383
44452,0,0,0,0,0,0,2022-03-12 19:56:22.163867
44456,0,0,0,0,0,0,2022-03-12 19:56:23.355863
44460,0,0,0,0,0,0,2022-03-12 19:56:24.611055
44463,0,0,0,0,0,0,2022-03-12 19:56:30.039507
44464,0,0,0,0,0,0,2022-03-12 19:56:31.125064
44465,0,0,0,0,0,0,2022-03-12 19:56:32.028188
44466,0,0,0,0,0,0,2022-03-12 19:56:32.827192
44467,0,0,0,0,0,0,2022-03-12 19:56:33.636186
44469,0,0,0,0,0,0,2022-03-12 19:56:35.154322
44470,0,0,0,0,0,0,2022-03-12 19:56:35.947593
44476,0,0,0,0,0,0,2022-03-12 19:56:38.161159
44479,0,0,0,0,0,0,2022-03-12 19:56:39.360162
44483,0,0,0,0,0,0,2022-03-12 19:56:41.850639
44495,0,0,0,0,0,0,2022-03-12 19:56:45.423702
44499,0,0,0,0,0,0,2022-03-12 19:56:46.515827
44503,0,0,0,0,0,0,2022-03-12 19:56:47.834255
44506,0,0,0,0,0,0,2022-03-12 19:56:49.017256
45437,0,0,0,0,0,0,2022-03-12 20:05:56.022429
47491,0,0,0,0,0,0,2022-03-12 20:24:29.542511
47495,0,0,0,0,0,0,2022-03-12 20:24:30.816051
44513,124,510,24,72,267,997,2022-03-12 19:56:52.087048
44515,0,0,0,0,0,0,2022-03-12 19:56:52.934048
44516,43027,10,1511,4512,45575,94635,2022-03-12 19:56:53.101045
44525,0,0,0,0,0,0,2022-03-12 19:56:55.152301
44527,0,0,0,0,0,0,2022-03-12 19:56:57.233358
44528,0,0,0,0,0,0,2022-03-12 19:57:01.991893
44529,0,0,0,0,0,0,2022-03-12 19:57:06.396387
44532,0,0,0,0,0,0,2022-03-12 19:57:08.698747
44533,0,0,0,0,0,0,2022-03-12 19:57:10.471521
44535,0,0,0,0,0,0,2022-03-12 19:57:11.768526
44536,0,0,0,0,0,0,2022-03-12 19:57:12.581823
44539,0,0,0,0,0,0,2022-03-12 19:57:14.408958
44543,15,49,6,26,49,145,2022-03-12 19:57:16.264731
44545,7,39,4,24,33,107,2022-03-12 19:57:19.53158
44546,0,0,0,0,0,0,2022-03-12 19:57:20.364998
44547,0,0,0,0,0,0,2022-03-12 19:57:21.178979
44548,0,0,0,0,0,0,2022-03-12 19:57:21.986983
44559,0,0,0,0,0,0,2022-03-12 19:57:25.2718
44562,0,0,0,0,0,0,2022-03-12 19:57:26.388819
45514,0,0,0,0,0,0,2022-03-12 20:06:48.288912
45515,0,0,0,0,0,0,2022-03-12 20:06:49.569832
47498,0,0,0,0,0,0,2022-03-12 20:24:31.946597
44571,16,48,11,22,121,218,2022-03-12 19:57:27.991772
44579,0,0,0,0,0,0,2022-03-12 19:57:30.154144
44582,0,0,0,0,0,0,2022-03-12 19:57:31.434428
44585,0,0,0,0,0,0,2022-03-12 19:57:32.455534
44590,34,490,40,48,515,1127,2022-03-12 19:57:34.819416
44591,37,222,28,43,215,545,2022-03-12 19:57:36.488584
44596,0,0,0,0,0,0,2022-03-12 19:57:38.295748
44597,0,0,0,0,0,0,2022-03-12 19:57:39.120595
44598,0,0,0,0,0,0,2022-03-12 19:57:40.289014
44599,0,0,0,0,0,0,2022-03-12 19:57:41.076317
44604,0,0,0,0,0,0,2022-03-12 19:57:43.402788
44610,0,0,0,0,0,0,2022-03-12 19:57:45.7701
44617,0,0,0,0,0,0,2022-03-12 19:57:51.843533
44618,0,0,0,0,0,0,2022-03-12 19:57:52.6649
44620,0,0,0,0,0,0,2022-03-12 19:57:54.422271
44621,0,0,0,0,0,0,2022-03-12 19:57:55.259115
44622,0,0,0,0,0,0,2022-03-12 19:57:56.057666
44627,0,0,0,0,0,0,2022-03-12 19:57:57.963438
44630,0,0,0,0,0,0,2022-03-12 19:57:59.167672
44633,0,0,0,0,0,0,2022-03-12 19:58:00.320271
44637,0,0,0,0,0,0,2022-03-12 19:58:01.623405
44640,0,0,0,0,0,0,2022-03-12 19:58:02.74181
44642,0,0,0,0,0,0,2022-03-12 19:58:04.028539
44646,0,0,0,0,0,0,2022-03-12 19:58:05.180509
44665,0,0,0,0,0,0,2022-03-12 19:58:15.70243
44667,0,0,0,0,0,0,2022-03-12 19:58:59.421588
44702,5,5,4,18,17,49,2022-03-12 19:59:24.790952
44707,0,0,0,0,0,0,2022-03-12 19:59:27.659873
44713,0,0,0,0,0,0,2022-03-12 19:59:30.562908
44715,0,0,0,0,0,0,2022-03-12 19:59:32.362374
44719,0,0,0,0,0,0,2022-03-12 19:59:33.624591
44722,0,0,0,0,0,0,2022-03-12 19:59:34.745939
44729,0,0,0,0,0,0,2022-03-12 19:59:37.812304
44730,0,0,0,0,0,0,2022-03-12 19:59:38.795861
44731,0,0,0,0,0,0,2022-03-12 19:59:39.612791
44735,0,0,0,0,0,0,2022-03-12 19:59:40.919159
44749,0,0,0,0,0,0,2022-03-12 19:59:45.569445
44754,0,0,0,0,0,0,2022-03-12 19:59:46.826755
44757,0,0,0,0,0,0,2022-03-12 19:59:48.016415
44764,0,0,0,0,0,0,2022-03-12 19:59:51.646499
44772,0,0,0,0,0,0,2022-03-12 19:59:53.920665
44776,2,107,2,11,37,159,2022-03-12 19:59:55.592585
44777,0,0,0,0,0,0,2022-03-12 19:59:56.494264
44780,0,0,0,0,0,0,2022-03-12 19:59:57.619465
44783,0,0,0,0,0,0,2022-03-12 19:59:58.822605
44787,0,0,0,0,0,0,2022-03-12 19:59:59.931112
44794,0,0,0,0,0,0,2022-03-12 20:00:01.237698
44797,0,0,0,0,0,0,2022-03-12 20:00:02.406521
44800,0,0,0,0,0,0,2022-03-12 20:00:03.610323
44804,0,0,0,0,0,0,2022-03-12 20:00:04.925944
44809,0,0,0,0,0,0,2022-03-12 20:00:16.423979
44812,0,0,0,0,0,0,2022-03-12 20:00:41.865437
44813,0,0,0,0,0,0,2022-03-12 20:00:43.720599
44814,0,0,0,0,0,0,2022-03-12 20:00:44.567774
44815,0,0,0,0,0,0,2022-03-12 20:00:45.381709
44816,0,0,0,0,0,0,2022-03-12 20:00:46.252432
44846,8,17,1,14,42,82,2022-03-12 20:01:16.199428
44849,0,0,0,0,0,0,2022-03-12 20:01:18.418131
44850,0,0,0,0,0,0,2022-03-12 20:01:19.205495
44852,0,0,0,0,0,0,2022-03-12 20:01:20.161505
44855,0,0,0,0,0,0,2022-03-12 20:01:21.375151
44863,0,0,0,0,0,0,2022-03-12 20:01:25.471804
44866,0,0,0,0,0,0,2022-03-12 20:01:28.784468
44867,0,0,0,0,0,0,2022-03-12 20:01:29.654424
44869,0,0,0,0,0,0,2022-03-12 20:01:31.350139
44870,0,0,0,0,0,0,2022-03-12 20:01:32.150766
44876,0,0,0,0,0,0,2022-03-12 20:01:34.497445
44880,0,0,0,0,0,0,2022-03-12 20:01:35.730484
44887,0,0,0,0,0,0,2022-03-12 20:01:40.749871
44888,0,0,0,0,0,0,2022-03-12 20:01:41.672837
44889,0,0,0,0,0,0,2022-03-12 20:01:43.207463
44890,0,0,0,0,0,0,2022-03-12 20:01:44.258436
44891,0,0,0,0,0,0,2022-03-12 20:01:45.068425
44893,0,0,0,0,0,0,2022-03-12 20:01:46.866489
44896,0,0,0,0,0,0,2022-03-12 20:01:49.065267
44897,0,0,0,0,0,0,2022-03-12 20:01:50.147272
44903,0,0,0,0,0,0,2022-03-12 20:01:52.526056
44906,0,0,0,0,0,0,2022-03-12 20:01:53.624527
44910,0,2,0,5,5,12,2022-03-12 20:01:54.923449
44911,0,2,0,5,6,13,2022-03-12 20:01:56.625396
44912,0,0,0,0,0,0,2022-03-12 20:01:57.46286
44915,0,0,0,0,0,0,2022-03-12 20:01:58.595036
44931,1428,61986,374,126,34067,97981,2022-03-12 20:02:06.658282
44933,0,0,0,0,0,0,2022-03-12 20:02:07.483453
44934,0,0,0,0,0,0,2022-03-12 20:02:08.422969
44935,0,0,0,0,0,0,2022-03-12 20:02:09.323828
44936,0,0,0,0,0,0,2022-03-12 20:02:10.127764
44938,0,0,0,0,0,0,2022-03-12 20:02:11.614995
44939,0,0,0,0,0,0,2022-03-12 20:02:12.951601
44940,12352,23680,857,488,35254,72631,2022-03-12 20:02:15.855353
44942,9990,116558,2566,9726,38248,177088,2022-03-12 20:02:18.501758
44944,0,0,0,0,0,0,2022-03-12 20:02:20.885281
44945,0,0,0,0,0,0,2022-03-12 20:02:21.835888
44946,0,0,0,0,0,0,2022-03-12 20:02:22.609439
44947,0,0,0,0,0,0,2022-03-12 20:02:23.394012
44948,0,0,0,0,0,0,2022-03-12 20:02:24.239387
44949,0,0,0,0,0,0,2022-03-12 20:02:25.003826
44951,0,0,0,0,0,0,2022-03-12 20:02:26.830767
44953,0,0,0,0,0,0,2022-03-12 20:02:27.852647
44962,0,0,0,0,0,0,2022-03-12 20:02:30.174371
44966,0,0,0,0,0,0,2022-03-12 20:02:31.435017
44969,0,0,0,0,0,0,2022-03-12 20:02:32.613453
44976,0,0,0,0,0,0,2022-03-12 20:02:35.082449
44985,0,0,0,0,0,0,2022-03-12 20:02:38.545516
44990,0,0,0,0,0,0,2022-03-12 20:02:39.787543
44994,0,0,0,0,0,0,2022-03-12 20:02:41.119435
44997,0,0,0,0,0,0,2022-03-12 20:02:42.272521
45000,0,0,0,0,0,0,2022-03-12 20:02:43.410508
45031,2,42,3,10,19,76,2022-03-12 20:02:54.409547
45033,0,1,0,5,6,12,2022-03-12 20:02:55.439646
45036,0,0,0,0,0,0,2022-03-12 20:02:56.532824
45040,22,35,8,30,99,194,2022-03-12 20:02:58.134496
45041,0,0,0,0,0,0,2022-03-12 20:02:58.990464
45045,0,0,0,0,0,0,2022-03-12 20:03:01.423519
45046,0,0,0,0,0,0,2022-03-12 20:03:02.229032
45047,0,0,0,0,0,0,2022-03-12 20:03:02.999478
45049,0,0,0,0,0,0,2022-03-12 20:03:03.831706
45053,7,227,2,10,38,284,2022-03-12 20:03:05.699403
45056,0,0,0,0,0,0,2022-03-12 20:03:07.528175
45059,0,0,0,0,0,0,2022-03-12 20:03:08.803736
45061,0,0,0,0,0,0,2022-03-12 20:03:10.151967
45063,0,0,0,0,0,0,2022-03-12 20:03:11.095608
45067,0,0,0,0,0,0,2022-03-12 20:03:13.529214
45080,0,6,0,9,8,23,2022-03-12 20:03:18.305166
45083,0,0,0,0,0,0,2022-03-12 20:03:19.442279
45086,0,0,0,0,0,0,2022-03-12 20:03:20.617842
45090,0,0,0,0,0,0,2022-03-12 20:03:22.059437
45092,0,0,0,0,0,0,2022-03-12 20:03:23.034439
45096,0,0,0,0,0,0,2022-03-12 20:03:24.500013
45098,0,0,0,0,0,0,2022-03-12 20:03:25.516284
45118,1,2,0,4,5,12,2022-03-12 20:03:32.719217
45122,0,0,0,0,0,0,2022-03-12 20:03:35.126229
45125,0,0,0,0,0,0,2022-03-12 20:03:36.275864
45128,0,0,0,0,0,0,2022-03-12 20:03:37.398466
45135,0,0,0,0,0,0,2022-03-12 20:03:38.691444
45138,0,0,0,0,0,0,2022-03-12 20:03:39.840817
45142,0,0,0,0,0,0,2022-03-12 20:03:41.12393
45152,0,0,0,0,0,0,2022-03-12 20:03:43.560201
45155,0,0,0,0,0,0,2022-03-12 20:03:44.955742
45157,0,0,0,0,0,0,2022-03-12 20:03:45.986641
45160,0,0,0,0,0,0,2022-03-12 20:03:47.075645
45167,0,0,0,0,0,0,2022-03-12 20:03:49.538191
45180,0,0,0,0,0,0,2022-03-12 20:03:53.105036
45186,0,0,0,0,0,0,2022-03-12 20:03:56.140132
45187,0,0,0,0,0,0,2022-03-12 20:03:57.985698
45188,0,0,0,0,0,0,2022-03-12 20:04:00.069384
45190,0,2,0,5,5,12,2022-03-12 20:04:01.847165
45191,0,0,0,0,0,0,2022-03-12 20:04:02.63821
45193,0,0,0,0,0,0,2022-03-12 20:04:04.359682
45197,0,0,0,0,0,0,2022-03-12 20:04:06.355796
45224,0,0,0,0,0,0,2022-03-12 20:04:14.693387
45225,0,0,0,0,0,0,2022-03-12 20:04:15.835142
45229,0,0,0,0,0,0,2022-03-12 20:04:17.159146
45234,0,0,0,0,0,0,2022-03-12 20:04:19.512304
45237,0,0,0,0,0,0,2022-03-12 20:04:20.623445
45246,1,14,2,13,17,47,2022-03-12 20:04:23.322035
45262,1,7,1,13,16,38,2022-03-12 20:04:27.945923
45268,0,0,0,0,0,0,2022-03-12 20:04:30.280054
45275,0,0,0,0,1,1,2022-03-12 20:04:32.950284
45280,0,0,0,0,0,0,2022-03-12 20:04:35.116956
45283,0,0,0,0,0,0,2022-03-12 20:04:36.389374
45286,0,0,0,0,0,0,2022-03-12 20:04:37.534587
45300,0,0,0,0,0,0,2022-03-12 20:04:41.107272
45311,0,0,0,0,0,0,2022-03-12 20:04:44.71983
45325,0,0,0,0,0,0,2022-03-12 20:04:48.274163
45329,0,0,0,0,0,0,2022-03-12 20:04:49.60316
45332,0,0,0,0,0,0,2022-03-12 20:04:50.696936
45337,0,0,0,0,0,0,2022-03-12 20:04:52.47242
45339,0,0,0,0,0,0,2022-03-12 20:04:53.322424
45344,0,0,0,0,0,0,2022-03-12 20:04:54.331556
45348,0,0,0,0,0,0,2022-03-12 20:04:57.094452
45353,0,0,0,0,0,0,2022-03-12 20:05:07.098298
45354,0,0,0,0,0,0,2022-03-12 20:05:07.891433
45355,0,0,0,0,0,0,2022-03-12 20:05:08.754458
45356,0,0,0,0,0,0,2022-03-12 20:05:09.509451
45358,0,0,0,0,0,0,2022-03-12 20:05:11.296755
45360,0,0,0,0,0,0,2022-03-12 20:05:12.280893
45368,0,0,0,0,0,0,2022-03-12 20:05:14.598033
45372,0,0,0,0,0,0,2022-03-12 20:05:15.865823
45390,0,0,0,0,0,0,2022-03-12 20:05:29.347596
45391,0,0,0,0,0,0,2022-03-12 20:05:30.420083
45392,0,0,0,0,0,0,2022-03-12 20:05:31.270059
45393,0,0,0,0,0,0,2022-03-12 20:05:32.103266
45395,0,0,0,0,0,0,2022-03-12 20:05:33.89077
45397,0,0,0,0,0,0,2022-03-12 20:05:39.301589
45399,0,0,0,0,0,0,2022-03-12 20:05:40.739396
45400,0,0,0,0,0,0,2022-03-12 20:05:41.628441
45401,0,0,0,0,0,0,2022-03-12 20:05:42.413445
45402,0,0,0,0,0,0,2022-03-12 20:05:43.432444
45444,20,44,8,19,80,171,2022-03-12 20:05:58.715009
45445,13,33,8,22,57,133,2022-03-12 20:05:59.864384
45447,34,26,11,40,112,223,2022-03-12 20:06:01.233579
45448,21,35,4,34,80,174,2022-03-12 20:06:02.280792
45452,0,0,0,0,0,0,2022-03-12 20:06:04.323772
45455,0,0,0,0,0,0,2022-03-12 20:06:05.516239
45458,0,0,0,0,0,0,2022-03-12 20:06:06.709552
45461,0,0,0,0,0,0,2022-03-12 20:06:07.868531
45464,0,0,0,0,0,0,2022-03-12 20:06:09.008215
45467,0,0,0,0,0,0,2022-03-12 20:06:10.184368
45471,0,0,0,0,0,0,2022-03-12 20:06:11.457899
45474,0,0,0,0,0,0,2022-03-12 20:06:12.614339
45478,0,0,0,0,0,0,2022-03-12 20:06:13.893579
45481,0,0,0,0,0,0,2022-03-12 20:06:15.012275
45484,0,0,0,0,0,0,2022-03-12 20:06:16.123029
45488,0,0,0,0,0,0,2022-03-12 20:06:17.341464
45507,0,0,0,0,0,0,2022-03-12 20:06:28.772526
45508,0,0,0,0,0,0,2022-03-12 20:06:31.990538
45510,0,0,0,0,0,0,2022-03-12 20:06:44.966344
45511,0,0,0,0,0,0,2022-03-12 20:06:45.763611
45512,0,0,0,0,0,0,2022-03-12 20:06:46.662942
45513,0,0,0,0,0,0,2022-03-12 20:06:47.471842
45517,1,12,1,15,20,49,2022-03-12 20:06:51.637758
45518,27,503,6,20,187,743,2022-03-12 20:06:53.301383
45520,1,8,0,10,19,38,2022-03-12 20:06:55.40683
45521,1,9,0,11,19,40,2022-03-12 20:06:56.339878
45526,2,11,1,15,16,45,2022-03-12 20:06:59.21064
45530,1,10,1,14,16,42,2022-03-12 20:07:01.65234
45532,2,18,0,9,16,45,2022-03-12 20:07:02.76101
45535,1,13,0,9,18,41,2022-03-12 20:07:03.983789
45541,0,0,0,0,0,0,2022-03-12 20:07:06.386798
45556,1789,19036,363,213,8535,29936,2022-03-12 20:07:10.784653
45572,13216,32649,2649,6094,51622,106230,2022-03-12 20:07:16.096638
45574,65,1895,17,42,370,2389,2022-03-12 20:07:18.500772
45576,83424,323217,4287,2586,110129,523643,2022-03-12 20:07:19.490099
45577,1587,4435,289,356,7688,14355,2022-03-12 20:07:22.521518
45585,67,439,43,90,813,1452,2022-03-12 20:07:27.832463
45587,811,2992,166,672,1609,6250,2022-03-12 20:07:28.87023
45596,46,135,19,93,298,591,2022-03-12 20:07:31.170655
45600,113,176,25,80,223,617,2022-03-12 20:07:35.895745
45604,996,20740,312,120,9095,31263,2022-03-12 20:07:38.685517
45605,0,0,0,0,0,0,2022-03-12 20:07:39.592604
45611,6,102,2,27,52,189,2022-03-12 20:07:42.22563
45612,36,59,9,41,111,256,2022-03-12 20:07:44.162454
45613,3,0,0,0,85558,85561,2022-03-12 20:07:44.403603
45614,4,129,1,9,34,177,2022-03-12 20:07:45.840789
45618,120,132,44,134,1390,1820,2022-03-12 20:07:50.55648
45622,0,0,0,0,0,0,2022-03-12 20:07:59.766642
45627,3,67,0,5,16,91,2022-03-12 20:08:03.032781
47502,0,0,0,0,0,0,2022-03-12 20:24:33.272227
47504,0,0,0,0,0,0,2022-03-12 20:24:34.653133
45645,2,42,5,25,56,130,2022-03-12 20:08:05.955796
45654,15,78,8,27,148,276,2022-03-12 20:08:11.876339
45660,1,6,0,10,20,37,2022-03-12 20:08:15.555956
45661,1,6,0,10,20,37,2022-03-12 20:08:16.455967
45662,1,8,0,10,19,38,2022-03-12 20:08:17.350875
45667,0,0,0,0,0,0,2022-03-12 20:08:22.925291
45668,0,0,0,0,0,0,2022-03-12 20:08:23.789428
45669,0,0,0,0,0,0,2022-03-12 20:08:24.652264
45670,0,0,0,0,0,0,2022-03-12 20:08:25.406753
45672,0,0,0,0,0,0,2022-03-12 20:08:26.775682
45674,0,0,0,0,0,0,2022-03-12 20:08:27.763028
45683,1,5,0,8,19,33,2022-03-12 20:08:30.359626
47509,0,0,0,0,0,0,2022-03-12 20:24:36.903271
47512,0,0,0,0,0,0,2022-03-12 20:24:38.115662
47515,0,0,0,0,0,0,2022-03-12 20:24:39.235435
47519,0,0,0,0,0,0,2022-03-12 20:24:40.522279
45698,2,11,0,14,21,48,2022-03-12 20:08:35.764843
45702,1,4,0,10,21,36,2022-03-12 20:08:37.467753
45705,1,8,0,12,19,40,2022-03-12 20:08:38.876989
45707,1,5,0,13,15,34,2022-03-12 20:08:40.191425
45714,0,0,0,0,0,0,2022-03-12 20:08:42.158748
45719,0,0,0,0,0,0,2022-03-12 20:08:44.656584
45722,0,0,0,0,0,0,2022-03-12 20:08:45.791677
45726,0,0,0,0,0,0,2022-03-12 20:08:47.10555
45730,0,0,0,0,0,0,2022-03-12 20:08:49.369646
45738,0,0,0,0,0,0,2022-03-12 20:08:51.910824
45741,0,0,0,0,0,0,2022-03-12 20:08:53.06897
45744,0,0,0,0,0,0,2022-03-12 20:08:54.239499
45747,0,0,0,0,0,0,2022-03-12 20:08:55.335451
45771,0,0,0,0,0,0,2022-03-12 20:09:00.207499
45774,0,0,0,0,0,0,2022-03-12 20:09:02.275492
45776,0,0,0,0,0,0,2022-03-12 20:09:07.712816
45777,0,0,0,0,0,0,2022-03-12 20:09:12.324758
45780,2,7,1,8,19,37,2022-03-12 20:09:15.990064
47522,0,0,0,0,0,0,2022-03-12 20:24:41.688396
45781,1,27,1,10,18,57,2022-03-12 20:09:18.039526
45783,2679,3,196,682,5560,9120,2022-03-12 20:09:21.021691
45784,0,0,0,0,0,0,2022-03-12 20:09:21.89458
45787,0,0,0,0,0,0,2022-03-12 20:09:24.700583
45788,0,0,0,0,0,0,2022-03-12 20:09:25.557559
45790,1,6,0,9,16,32,2022-03-12 20:09:26.591059
45799,0,0,0,0,0,0,2022-03-12 20:09:29.008695
45808,0,0,0,0,0,0,2022-03-12 20:09:31.269735
45812,2,5,0,11,20,38,2022-03-12 20:09:32.697657
45814,0,0,0,0,0,0,2022-03-12 20:09:33.73749
45821,0,0,0,0,0,0,2022-03-12 20:09:36.443292
45822,0,0,0,0,0,0,2022-03-12 20:09:37.299769
45826,0,0,0,0,0,0,2022-03-12 20:09:38.562334
45829,0,0,0,0,0,0,2022-03-12 20:09:39.685627
45836,0,0,0,0,0,0,2022-03-12 20:09:42.239114
45839,0,0,0,0,0,0,2022-03-12 20:09:43.435518
45848,0,0,0,0,0,0,2022-03-12 20:09:47.596906
45851,0,0,0,0,0,0,2022-03-12 20:09:49.390011
45854,0,0,0,0,0,0,2022-03-12 20:09:50.659562
45855,0,0,0,0,0,0,2022-03-12 20:09:51.75357
45859,0,0,0,0,0,0,2022-03-12 20:09:52.988405
47525,0,0,0,0,0,0,2022-03-12 20:24:42.817983
47528,0,0,0,0,0,0,2022-03-12 20:24:43.937694
45862,1,5,0,13,18,37,2022-03-12 20:09:54.215548
45868,2,11,1,24,23,61,2022-03-12 20:09:56.756236
45870,0,0,0,0,0,0,2022-03-12 20:09:57.898492
45873,0,0,0,0,0,0,2022-03-12 20:09:59.051484
45877,0,0,0,0,0,0,2022-03-12 20:10:03.394941
45878,0,0,0,0,0,0,2022-03-12 20:10:04.672687
45879,0,0,0,0,0,0,2022-03-12 20:10:05.469032
45880,0,0,0,0,0,0,2022-03-12 20:10:06.295413
45881,0,0,0,0,0,0,2022-03-12 20:10:07.082583
45882,0,0,0,0,0,0,2022-03-12 20:10:07.835118
45883,0,0,0,0,0,0,2022-03-12 20:10:08.609778
45886,0,0,0,0,0,0,2022-03-12 20:10:09.711541
45895,0,0,0,0,0,0,2022-03-12 20:10:13.346866
45899,0,0,0,0,0,0,2022-03-12 20:10:14.63902
45905,0,0,0,0,0,0,2022-03-12 20:10:16.987101
45913,0,0,0,0,0,0,2022-03-12 20:10:20.600351
45916,2,3,0,11,20,36,2022-03-12 20:10:21.83857
45921,1,3,0,11,22,37,2022-03-12 20:10:23.013493
45924,0,0,0,0,0,0,2022-03-12 20:10:24.192514
45927,0,0,0,0,0,0,2022-03-12 20:10:25.738544
45928,0,0,0,0,0,0,2022-03-12 20:10:26.570323
47535,0,0,0,0,0,0,2022-03-12 20:24:46.49665
47541,0,0,0,0,0,0,2022-03-12 20:24:47.715105
45935,8,12,0,17,100,137,2022-03-12 20:10:29.611422
45940,0,0,0,0,0,0,2022-03-12 20:10:31.964424
45941,0,0,0,0,0,0,2022-03-12 20:10:32.927702
45942,0,0,0,0,0,0,2022-03-12 20:10:33.740864
45946,0,0,0,0,0,0,2022-03-12 20:10:35.518712
45947,0,0,0,0,0,0,2022-03-12 20:10:36.350511
45954,0,0,0,0,0,0,2022-03-12 20:10:38.62864
45960,0,0,0,0,0,0,2022-03-12 20:10:41.025678
45963,0,0,0,0,0,0,2022-03-12 20:10:42.204664
45966,0,0,0,0,0,0,2022-03-12 20:10:43.319423
45970,0,0,0,0,0,0,2022-03-12 20:10:44.959821
45971,0,0,0,0,0,0,2022-03-12 20:10:45.804746
45974,0,0,0,0,0,0,2022-03-12 20:10:46.878681
45983,0,0,0,0,0,0,2022-03-12 20:10:49.405468
45986,0,0,0,0,0,0,2022-03-12 20:10:50.540863
46003,48,333,34,76,640,1131,2022-03-12 20:10:56.851695
46004,56,356,40,76,730,1258,2022-03-12 20:10:58.949828
46010,0,0,0,0,0,0,2022-03-12 20:11:06.030495
46011,0,0,0,0,0,0,2022-03-12 20:11:06.857947
46012,0,0,0,0,0,0,2022-03-12 20:11:07.715599
46013,0,0,0,0,0,0,2022-03-12 20:11:08.700886
46016,0,0,0,0,0,0,2022-03-12 20:11:11.355637
46017,0,0,0,0,0,0,2022-03-12 20:11:12.305718
46018,0,0,0,0,0,0,2022-03-12 20:11:13.12512
46021,0,0,0,0,0,0,2022-03-12 20:11:14.28057
46029,0,0,0,0,0,0,2022-03-12 20:11:16.772707
46084,24,138,28,27,302,519,2022-03-12 20:11:37.706402
46089,37,200,14,30,253,534,2022-03-12 20:11:39.34397
46093,28418,29687,6917,9343,63822,138187,2022-03-12 20:11:42.022833
46096,0,0,0,0,0,0,2022-03-12 20:11:46.199661
46098,0,0,0,0,0,0,2022-03-12 20:11:48.049825
46100,0,0,0,0,0,0,2022-03-12 20:11:48.828014
46102,30106,139080,6205,3769,95048,274208,2022-03-12 20:11:50.911721
46103,0,0,0,0,0,0,2022-03-12 20:11:51.709882
46104,0,0,0,0,0,0,2022-03-12 20:11:52.630718
46105,0,0,0,0,0,0,2022-03-12 20:11:53.39572
46109,0,0,0,0,0,0,2022-03-12 20:11:54.795364
46116,0,0,0,0,0,0,2022-03-12 20:11:57.146508
46119,74,225,48,53,578,978,2022-03-12 20:11:59.277485
46120,0,0,0,0,0,0,2022-03-12 20:12:00.152445
46121,0,0,0,0,0,0,2022-03-12 20:12:00.951824
46123,0,0,0,0,0,0,2022-03-12 20:12:01.895386
48565,0,0,0,0,0,0,2022-03-12 20:33:34.950637
46150,1,7,0,12,18,38,2022-03-12 20:12:11.943781
46151,0,0,0,0,0,0,2022-03-12 20:12:12.801731
46152,0,0,0,0,0,0,2022-03-12 20:12:13.950484
46154,2,7,0,10,19,38,2022-03-12 20:12:15.370313
46156,0,0,0,0,0,0,2022-03-12 20:12:16.406066
46159,0,0,0,0,0,0,2022-03-12 20:12:17.605918
46162,0,0,0,0,0,0,2022-03-12 20:12:18.79361
46165,0,0,0,0,0,0,2022-03-12 20:12:19.939112
46168,0,0,0,0,0,0,2022-03-12 20:12:21.082302
46173,0,0,0,0,0,0,2022-03-12 20:12:22.367068
46177,0,0,0,0,0,0,2022-03-12 20:12:23.529435
46180,0,0,0,0,0,0,2022-03-12 20:12:24.707428
46184,0,0,0,0,0,0,2022-03-12 20:12:26.004897
46189,0,0,0,0,0,0,2022-03-12 20:12:30.157982
46190,0,0,0,0,0,0,2022-03-12 20:12:30.968664
46201,0,0,0,0,0,0,2022-03-12 20:12:34.355686
46205,0,0,0,0,0,0,2022-03-12 20:12:35.45887
46209,0,0,0,0,0,0,2022-03-12 20:12:37.760619
46211,0,0,0,0,0,0,2022-03-12 20:13:06.186034
46212,0,0,0,0,0,0,2022-03-12 20:13:09.605736
46213,1,4,0,12,17,34,2022-03-12 20:13:11.155528
46214,0,0,0,0,0,0,2022-03-12 20:13:12.041651
46216,0,0,0,0,0,0,2022-03-12 20:13:12.894156
46217,0,0,0,0,0,0,2022-03-12 20:13:13.74353
46219,0,0,0,0,0,0,2022-03-12 20:13:15.491649
46221,0,0,0,0,0,0,2022-03-12 20:13:24.001983
46277,1,5,0,11,19,36,2022-03-12 20:13:50.7625
46281,0,0,0,0,0,0,2022-03-12 20:13:52.879598
46285,0,0,0,0,0,0,2022-03-12 20:13:55.209359
46286,0,0,0,0,0,0,2022-03-12 20:13:56.149471
46288,0,0,0,0,0,0,2022-03-12 20:13:57.891778
46290,0,0,0,0,0,0,2022-03-12 20:13:58.933758
46294,0,0,0,0,0,0,2022-03-12 20:14:00.219513
46297,0,0,0,0,0,0,2022-03-12 20:14:01.354564
46300,0,0,0,0,0,0,2022-03-12 20:14:02.50849
46307,1,5,0,9,18,33,2022-03-12 20:14:04.958529
46310,1,4,0,11,19,35,2022-03-12 20:14:06.217777
46313,0,0,0,0,0,0,2022-03-12 20:14:07.380093
46316,1,9,0,10,20,40,2022-03-12 20:14:08.612601
46321,0,0,0,0,0,0,2022-03-12 20:14:11.149538
46331,0,0,0,0,0,0,2022-03-12 20:14:14.71076
46341,0,0,0,0,0,0,2022-03-12 20:14:19.086152
46343,0,0,0,0,0,0,2022-03-12 20:14:20.853527
46345,0,0,0,0,0,0,2022-03-12 20:14:21.828557
46348,0,0,0,0,0,0,2022-03-12 20:14:22.9575
46351,0,0,0,0,0,0,2022-03-12 20:14:24.075652
46358,0,0,0,0,0,0,2022-03-12 20:14:27.150514
46361,0,0,0,0,0,0,2022-03-12 20:14:28.949611
46363,0,0,0,0,0,0,2022-03-12 20:14:30.548744
46431,1,5,1,1,60603,60611,2022-03-12 20:15:21.246582
46433,0,0,0,0,0,0,2022-03-12 20:15:23.017438
46434,0,0,0,0,0,0,2022-03-12 20:15:23.854514
46436,0,0,0,0,0,0,2022-03-12 20:15:25.566614
46445,0,0,0,0,0,0,2022-03-12 20:15:27.780579
46453,0,0,0,0,0,0,2022-03-12 20:15:30.312171
46463,0,0,0,0,0,0,2022-03-12 20:15:32.755792
46469,0,0,0,0,0,0,2022-03-12 20:15:36.26986
46473,0,0,0,0,0,0,2022-03-12 20:15:37.438213
46477,0,0,0,0,0,0,2022-03-12 20:15:38.8265
46479,0,0,0,0,0,0,2022-03-12 20:15:39.806571
46483,0,0,0,0,0,0,2022-03-12 20:15:41.149554
46487,0,0,0,0,0,0,2022-03-12 20:15:42.239521
46502,0,0,0,0,0,0,2022-03-12 20:15:44.746774
46503,0,0,0,0,0,0,2022-03-12 20:15:46.003741
46506,0,0,0,0,0,0,2022-03-12 20:15:47.132433
46509,0,0,0,0,0,0,2022-03-12 20:15:48.216621
46513,0,0,0,0,0,0,2022-03-12 20:15:50.146787
46514,0,0,0,0,0,0,2022-03-12 20:15:50.942567
46522,0,0,0,0,0,0,2022-03-12 20:15:52.980123
46530,0,0,0,0,0,0,2022-03-12 20:15:55.629829
46532,0,0,0,0,0,0,2022-03-12 20:15:56.618782
46537,0,0,0,0,0,0,2022-03-12 20:15:57.910958
46540,0,0,0,0,0,0,2022-03-12 20:15:59.082712
46544,0,0,0,0,0,0,2022-03-12 20:16:00.573935
46546,0,0,0,0,0,0,2022-03-12 20:16:01.558069
46549,0,0,0,0,0,0,2022-03-12 20:16:02.663706
46554,0,0,0,0,0,0,2022-03-12 20:16:04.000829
46557,0,0,0,0,0,0,2022-03-12 20:16:05.156932
46560,0,0,0,0,0,0,2022-03-12 20:16:06.880462
46561,0,0,0,0,0,0,2022-03-12 20:16:07.681617
46563,0,0,0,0,0,0,2022-03-12 20:16:09.436916
46564,0,0,0,0,0,0,2022-03-12 20:16:10.264979
46650,31,372,22,30,455,910,2022-03-12 20:16:37.299355
46652,90,0,20,104,384,598,2022-03-12 20:16:37.546703
46662,0,0,0,0,0,0,2022-03-12 20:16:39.99249
46673,0,0,0,0,0,0,2022-03-12 20:16:42.350675
46680,0,0,0,0,0,0,2022-03-12 20:16:44.7626
46695,1,8,0,10,17,36,2022-03-12 20:16:48.369598
46698,1,5,0,9,18,33,2022-03-12 20:16:49.586537
46705,1,3,0,11,18,33,2022-03-12 20:16:51.955386
46718,0,0,0,0,0,0,2022-03-12 20:16:56.720584
46728,1,6,1,16,16,40,2022-03-12 20:16:59.542827
46729,0,0,0,0,0,0,2022-03-12 20:17:00.430426
46732,0,0,0,0,0,0,2022-03-12 20:17:01.621574
46737,0,0,0,0,0,0,2022-03-12 20:17:02.812561
46740,0,0,0,0,0,0,2022-03-12 20:17:03.939819
46743,0,0,0,0,0,0,2022-03-12 20:17:05.075774
46747,0,0,0,0,0,0,2022-03-12 20:17:06.419859
46750,0,0,0,0,0,0,2022-03-12 20:17:07.517024
46760,0,0,0,0,0,0,2022-03-12 20:17:09.929044
46767,0,0,0,0,0,0,2022-03-12 20:17:12.854396
46821,207,201,38,89,306,841,2022-03-12 20:17:49.510183
46822,0,0,0,0,0,0,2022-03-12 20:17:50.591611
46823,0,0,0,0,0,0,2022-03-12 20:17:51.383865
46824,0,0,0,0,0,0,2022-03-12 20:17:52.574959
46825,0,0,0,0,0,0,2022-03-12 20:17:53.459605
46827,1,6,0,11,17,35,2022-03-12 20:17:54.82992
46830,0,0,0,0,0,0,2022-03-12 20:17:55.776584
46834,0,0,0,0,0,0,2022-03-12 20:17:57.064074
46837,0,0,0,0,0,0,2022-03-12 20:17:58.851064
46841,0,0,0,0,0,0,2022-03-12 20:18:00.673903
46844,0,0,0,0,0,0,2022-03-12 20:18:01.8403
46847,0,0,0,0,0,0,2022-03-12 20:18:02.935504
46852,0,0,0,0,0,0,2022-03-12 20:18:04.152883
46859,0,0,0,0,0,0,2022-03-12 20:18:06.961486
46860,0,0,0,0,0,0,2022-03-12 20:18:08.397664
46861,0,0,0,0,0,0,2022-03-12 20:18:09.190554
46862,0,0,0,0,0,0,2022-03-12 20:18:10.323969
46866,0,0,0,0,0,0,2022-03-12 20:18:11.394586
46870,0,0,0,0,0,0,2022-03-12 20:18:12.845133
46872,0,0,0,0,0,0,2022-03-12 20:18:13.835709
46876,0,0,0,0,0,0,2022-03-12 20:18:15.182081
46879,0,0,0,0,0,0,2022-03-12 20:18:16.153614
46887,0,0,0,0,0,0,2022-03-12 20:18:18.920372
46888,0,0,0,0,0,0,2022-03-12 20:18:19.894741
46891,0,0,0,0,0,0,2022-03-12 20:18:21.052098
46894,0,0,0,0,0,0,2022-03-12 20:18:22.163617
46916,0,0,0,0,0,0,2022-03-12 20:18:28.160732
46919,0,0,0,0,0,0,2022-03-12 20:18:33.637791
46921,0,0,0,0,0,0,2022-03-12 20:18:35.470177
46922,0,0,0,0,0,0,2022-03-12 20:18:36.474647
46924,120,0,20,33,215,388,2022-03-12 20:18:37.684131
46925,0,0,0,0,162,162,2022-03-12 20:18:38.997464
46926,0,0,0,0,0,0,2022-03-12 20:18:39.808395
46927,0,0,0,0,0,0,2022-03-12 20:18:40.661231
46928,0,0,0,0,0,0,2022-03-12 20:18:41.434239
46929,0,0,0,0,0,0,2022-03-12 20:18:42.206737
46932,0,0,0,0,0,0,2022-03-12 20:18:43.353632
46935,0,0,0,0,0,0,2022-03-12 20:18:44.486714
46946,0,0,0,0,0,0,2022-03-12 20:18:48.097522
46959,0,0,0,0,0,0,2022-03-12 20:18:51.734601
46965,0,0,0,0,0,0,2022-03-12 20:18:57.324012
46966,0,0,0,0,0,0,2022-03-12 20:18:58.258423
46967,0,0,0,0,0,0,2022-03-12 20:18:59.061801
46971,277,6013,88,60,1732,8170,2022-03-12 20:19:01.991294
46973,1,30,2,7,17,57,2022-03-12 20:19:03.100638
46978,0,0,0,0,0,0,2022-03-12 20:19:03.836841
46982,0,0,0,0,0,0,2022-03-12 20:19:04.760399
46985,19236,59103,1782,8962,24738,113821,2022-03-12 20:19:05.87449
46990,0,0,0,0,0,0,2022-03-12 20:19:06.65972
46991,0,0,0,0,0,0,2022-03-12 20:19:07.445441
46994,0,0,0,0,0,0,2022-03-12 20:19:08.589693
47002,0,0,0,0,0,0,2022-03-12 20:19:11.012714
47022,1,6,1,12,19,39,2022-03-12 20:19:18.390517
47024,0,0,0,0,0,0,2022-03-12 20:19:19.450755
47031,0,0,0,0,0,0,2022-03-12 20:19:21.74335
47036,0,0,0,0,0,0,2022-03-12 20:19:23.036501
47038,0,0,0,0,0,0,2022-03-12 20:19:24.266653
47046,0,0,0,0,0,0,2022-03-12 20:19:27.843223
47049,0,0,0,0,0,0,2022-03-12 20:19:29.04745
47052,0,0,0,0,0,0,2022-03-12 20:19:30.134731
47057,0,0,0,0,0,0,2022-03-12 20:19:32.912696
47058,1,7,0,11,17,36,2022-03-12 20:19:33.816427
47063,0,0,0,0,0,0,2022-03-12 20:19:35.601777
47064,0,0,0,0,0,0,2022-03-12 20:19:36.45589
47072,0,0,0,0,0,0,2022-03-12 20:19:38.608524
47075,0,0,0,0,0,0,2022-03-12 20:19:39.678534
47079,0,0,0,0,0,0,2022-03-12 20:19:40.918907
47083,0,0,0,0,0,0,2022-03-12 20:19:42.181498
47086,0,0,0,0,0,0,2022-03-12 20:19:43.370772
47094,0,0,0,0,0,0,2022-03-12 20:19:45.794574
47097,0,0,0,0,0,0,2022-03-12 20:19:47.004726
47102,0,0,0,0,0,0,2022-03-12 20:19:48.106497
47109,0,0,0,0,0,0,2022-03-12 20:19:50.518691
47113,0,0,0,0,0,0,2022-03-12 20:19:51.828569
47119,0,0,0,0,0,0,2022-03-12 20:19:54.472677
47121,0,0,0,0,0,0,2022-03-12 20:19:55.728732
47122,1,6,0,11,16,34,2022-03-12 20:19:56.699728
47125,0,0,0,0,0,0,2022-03-12 20:19:57.800778
47159,78469,24,1736,3050,52602,135881,2022-03-12 20:20:10.580541
47167,0,0,0,0,0,0,2022-03-12 20:20:12.395659
47176,0,0,0,0,0,0,2022-03-12 20:20:14.698646
47188,0,0,0,0,0,0,2022-03-12 20:21:38.571867
47189,0,0,0,0,0,0,2022-03-12 20:21:47.752719
47190,0,0,0,0,0,0,2022-03-12 20:21:50.711666
47191,0,0,0,0,0,0,2022-03-12 20:21:51.93365
47192,0,0,0,0,0,0,2022-03-12 20:21:52.762497
47193,0,0,0,0,0,0,2022-03-12 20:21:53.628285
47199,0,0,0,0,0,0,2022-03-12 20:21:57.188547
47201,0,0,0,0,0,0,2022-03-12 20:21:58.90794
47202,0,0,0,0,0,0,2022-03-12 20:21:59.775591
47206,0,0,0,0,0,0,2022-03-12 20:22:03.236916
47211,0,0,0,0,0,0,2022-03-12 20:22:04.747778
47213,0,0,0,0,0,0,2022-03-12 20:22:06.168801
47218,0,0,0,0,0,0,2022-03-12 20:22:09.248611
47221,0,0,0,0,0,0,2022-03-12 20:22:10.47821
47225,0,0,0,0,0,0,2022-03-12 20:22:16.214288
47227,0,0,0,0,0,0,2022-03-12 20:22:19.835364
47228,0,0,0,0,0,0,2022-03-12 20:22:20.739277
47229,0,0,0,0,0,0,2022-03-12 20:22:21.587943
47232,0,0,0,0,0,0,2022-03-12 20:22:24.75509
47234,0,0,0,0,0,0,2022-03-12 20:22:25.544755
47236,0,0,0,0,0,0,2022-03-12 20:22:26.296739
47237,0,0,0,0,0,0,2022-03-12 20:22:27.160073
47238,0,0,0,0,0,0,2022-03-12 20:22:27.990253
47243,0,0,0,0,0,0,2022-03-12 20:22:30.538965
47258,0,0,0,0,0,0,2022-03-12 20:22:33.98081
47264,0,0,0,0,0,0,2022-03-12 20:22:37.368239
47265,0,0,0,0,0,0,2022-03-12 20:22:38.370523
47266,0,0,0,0,0,0,2022-03-12 20:22:39.240583
47544,0,0,0,0,0,0,2022-03-12 20:24:48.797889
47557,0,0,0,0,0,0,2022-03-12 20:24:52.488295
47267,1,4,0,12,16,33,2022-03-12 20:22:40.119847
47284,0,0,0,0,0,0,2022-03-12 20:22:44.792934
47287,0,0,0,0,0,0,2022-03-12 20:22:46.163684
47291,0,0,0,0,0,0,2022-03-12 20:22:48.414635
47294,0,0,0,0,0,0,2022-03-12 20:22:49.593645
47301,0,0,0,0,0,0,2022-03-12 20:22:52.061657
47303,0,0,0,0,0,0,2022-03-12 20:22:53.106592
47314,0,0,0,0,0,0,2022-03-12 20:22:54.347935
47318,0,0,0,0,0,0,2022-03-12 20:22:55.717339
47320,0,0,0,0,0,0,2022-03-12 20:22:56.788429
47323,0,0,0,0,0,0,2022-03-12 20:22:59.193788
47324,0,0,0,0,0,0,2022-03-12 20:23:00.590785
47326,0,0,0,0,0,0,2022-03-12 20:23:02.978945
47328,0,0,0,0,0,0,2022-03-12 20:23:04.743932
47329,0,0,0,0,0,0,2022-03-12 20:23:05.57463
47330,0,0,0,0,0,0,2022-03-12 20:23:06.457133
47341,0,0,0,0,0,0,2022-03-12 20:23:09.898005
47345,0,0,0,0,0,0,2022-03-12 20:23:11.493076
47347,0,0,0,0,0,0,2022-03-12 20:23:13.993341
47352,0,0,0,0,0,0,2022-03-12 20:23:16.042577
47355,0,0,0,0,0,0,2022-03-12 20:23:17.244985
47362,0,0,0,0,0,0,2022-03-12 20:23:19.714466
47367,0,0,0,0,0,0,2022-03-12 20:23:22.0209
47374,0,0,0,0,0,0,2022-03-12 20:23:24.458901
47376,0,0,0,0,0,0,2022-03-12 20:23:25.85266
47382,0,0,0,0,0,0,2022-03-12 20:23:28.772255
47384,0,0,0,0,0,0,2022-03-12 20:23:30.480688
47390,0,0,0,0,0,0,2022-03-12 20:23:31.95326
47391,7047,19317,1489,5557,11778,45188,2022-03-12 20:23:35.597727
47393,0,0,0,0,0,0,2022-03-12 20:23:37.382619
47402,77,2753,21,27,779,3657,2022-03-12 20:23:44.302003
47405,1411,3,121,174,2401,4110,2022-03-12 20:23:47.144536
47409,53,73,24,26,1313,1489,2022-03-12 20:23:49.131749
47410,104,1677,50,63,1262,3156,2022-03-12 20:23:52.121862
47413,270,1453,81,67,3217,5088,2022-03-12 20:23:55.098467
47418,0,0,0,0,0,0,2022-03-12 20:23:56.047312
47425,10,43,3,25,58,139,2022-03-12 20:23:57.293755
47426,4,84,5,24,51,168,2022-03-12 20:23:58.486958
47428,0,0,0,0,0,0,2022-03-12 20:23:59.258347
47430,0,0,0,0,0,0,2022-03-12 20:24:01.005866
47431,0,0,0,0,0,0,2022-03-12 20:24:01.859638
47618,24,164,9,32,145,374,2022-03-12 20:25:14.294134
47620,1,5,1,3,9,19,2022-03-12 20:25:16.442073
47621,0,5,0,4,6,15,2022-03-12 20:25:17.340933
47623,58,1,19,94,566,738,2022-03-12 20:25:19.33375
47624,0,4,1,3,6,14,2022-03-12 20:25:20.727011
47626,0,5,0,4,6,15,2022-03-12 20:25:21.578245
47629,0,0,0,0,0,0,2022-03-12 20:25:30.059219
47634,7,26,5,25,49,112,2022-03-12 20:26:03.117255
47777,0,0,0,0,2072,2072,2022-03-12 20:27:13.423336
47910,0,0,0,0,0,0,2022-03-12 20:28:00.894207
47993,0,0,0,0,0,0,2022-03-12 20:28:37.222879
48150,0,0,0,0,0,0,2022-03-12 20:30:01.451449
47635,14,410,12,13,92,541,2022-03-12 20:26:11.391287
47638,1,102,1,11,19,134,2022-03-12 20:26:15.107543
47641,0,0,0,0,0,0,2022-03-12 20:26:20.370613
47643,0,0,0,0,0,0,2022-03-12 20:26:22.125331
47644,0,0,0,0,0,0,2022-03-12 20:26:23.01548
47645,0,0,0,0,0,0,2022-03-12 20:26:24.096382
47646,0,0,0,0,0,0,2022-03-12 20:26:24.928677
47648,0,0,0,0,0,0,2022-03-12 20:26:25.949421
47652,0,0,0,0,0,0,2022-03-12 20:26:27.206055
47661,0,0,0,0,0,0,2022-03-12 20:26:30.749026
47665,0,0,0,0,0,0,2022-03-12 20:26:32.008916
47669,0,0,0,0,0,0,2022-03-12 20:26:34.874781
47670,0,0,0,0,0,0,2022-03-12 20:26:35.744188
47672,0,0,0,0,0,0,2022-03-12 20:26:36.758481
47684,0,0,0,0,0,0,2022-03-12 20:26:40.417209
47700,0,0,0,0,0,0,2022-03-12 20:26:45.211028
47708,0,0,0,0,0,0,2022-03-12 20:26:47.57449
47712,0,0,0,0,0,0,2022-03-12 20:26:48.943459
47717,0,0,0,0,0,0,2022-03-12 20:26:51.090202
47721,0,0,0,0,0,0,2022-03-12 20:26:52.344544
47728,2,18,2,18,30,70,2022-03-12 20:26:54.180203
47729,0,0,0,0,0,0,2022-03-12 20:26:55.07319
47735,0,0,0,0,0,0,2022-03-12 20:26:58.420388
47738,0,0,0,0,0,0,2022-03-12 20:26:59.544623
47742,0,0,0,0,0,0,2022-03-12 20:27:00.770929
47746,0,0,0,0,0,0,2022-03-12 20:27:02.013426
47795,94,104,38,45,934,1215,2022-03-12 20:27:14.762238
47803,0,0,0,0,0,0,2022-03-12 20:27:17.751931
47805,0,0,0,0,0,0,2022-03-12 20:27:18.787044
47809,0,0,0,0,0,0,2022-03-12 20:27:20.142101
47810,0,0,0,0,0,0,2022-03-12 20:27:21.255369
47813,0,0,0,0,0,0,2022-03-12 20:27:22.365865
47819,0,2,0,7,4,13,2022-03-12 20:27:23.756311
47821,0,0,0,0,0,0,2022-03-12 20:27:24.804323
47824,0,0,0,0,0,0,2022-03-12 20:27:25.962867
47831,0,0,0,0,0,0,2022-03-12 20:27:28.389881
47838,0,0,0,0,0,0,2022-03-12 20:27:30.816818
47842,0,0,0,0,0,0,2022-03-12 20:27:32.127189
47843,0,0,0,0,0,0,2022-03-12 20:27:33.247145
47850,0,0,0,0,0,0,2022-03-12 20:27:35.693828
47853,0,0,0,0,0,0,2022-03-12 20:27:36.873578
47859,0,0,0,0,0,0,2022-03-12 20:27:39.187211
47865,0,0,0,0,0,0,2022-03-12 20:27:41.57316
47876,0,0,0,0,0,0,2022-03-12 20:27:44.039192
47881,0,0,0,0,0,0,2022-03-12 20:27:45.25046
47884,0,0,0,0,0,0,2022-03-12 20:27:46.417132
47890,0,0,0,0,0,0,2022-03-12 20:27:48.730454
47894,0,0,0,0,0,0,2022-03-12 20:27:50.013574
47901,0,0,0,0,0,0,2022-03-12 20:27:52.431173
47904,256,5083,46,54,1005,6444,2022-03-12 20:27:55.492189
47906,0,0,0,0,0,0,2022-03-12 20:27:57.60712
47908,0,0,0,0,0,0,2022-03-12 20:27:59.316488
47913,2,49,2,5,11,69,2022-03-12 20:28:02.249306
47922,0,0,0,0,0,0,2022-03-12 20:28:03.261402
47931,0,0,0,0,0,0,2022-03-12 20:28:05.666315
47934,0,0,0,0,0,0,2022-03-12 20:28:06.814214
47940,0,0,0,0,0,0,2022-03-12 20:28:09.234828
47944,0,4,0,8,12,24,2022-03-12 20:28:10.637187
47954,1,5,0,9,15,30,2022-03-12 20:28:14.231486
47956,0,3,0,9,13,25,2022-03-12 20:28:15.327796
47959,0,4,0,8,14,26,2022-03-12 20:28:16.834126
47960,0,6,0,11,11,28,2022-03-12 20:28:17.966406
47962,0,0,0,0,0,0,2022-03-12 20:28:18.95484
47965,0,0,0,0,0,0,2022-03-12 20:28:20.099828
47968,0,0,0,0,0,0,2022-03-12 20:28:21.270179
47979,0,0,0,0,0,0,2022-03-12 20:28:26.425506
47980,0,0,0,0,0,0,2022-03-12 20:28:27.648092
47981,0,0,0,0,0,0,2022-03-12 20:28:28.394111
47994,0,20,1,10,10,41,2022-03-12 20:28:38.248628
47996,1,8,3,15,19,46,2022-03-12 20:28:39.180047
47997,0,5,2,7,17,31,2022-03-12 20:28:40.022075
47998,0,6,0,15,15,36,2022-03-12 20:28:40.949994
48000,47,43,18,32,206,346,2022-03-12 20:28:41.939237
48004,0,7,1,11,16,35,2022-03-12 20:28:44.805083
48006,1,8,2,18,27,56,2022-03-12 20:28:46.178453
48007,0,7,2,16,13,38,2022-03-12 20:28:47.090753
48066,0,0,0,0,0,0,2022-03-12 20:29:18.63753
48008,0,6,1,17,12,36,2022-03-12 20:28:48.206601
48014,0,0,0,0,0,0,2022-03-12 20:28:50.454138
48021,0,4,0,9,15,28,2022-03-12 20:28:53.072509
48023,1,14,3,7,17,42,2022-03-12 20:28:54.180191
48026,1,20,0,5,8,34,2022-03-12 20:28:55.457179
48028,0,5,0,11,14,30,2022-03-12 20:28:56.567885
48031,0,5,1,12,12,30,2022-03-12 20:28:57.935729
48033,0,3,0,8,17,28,2022-03-12 20:28:59.601066
48040,0,6,0,10,12,28,2022-03-12 20:29:02.629601
48041,0,4,0,9,15,28,2022-03-12 20:29:03.910235
48043,1,5,0,12,17,35,2022-03-12 20:29:04.90118
48047,0,6,0,9,11,26,2022-03-12 20:29:07.341111
48048,0,4,0,13,14,31,2022-03-12 20:29:08.252713
48049,0,4,0,10,14,28,2022-03-12 20:29:09.120282
48051,0,4,0,11,13,28,2022-03-12 20:29:11.020849
48055,3,0,1,9,16,29,2022-03-12 20:29:12.202211
48058,1,5,0,11,16,33,2022-03-12 20:29:13.516272
48061,0,5,0,10,13,28,2022-03-12 20:29:14.566869
48068,1,5,0,11,15,32,2022-03-12 20:29:21.190257
48070,0,4,0,8,14,26,2022-03-12 20:29:23.050468
48076,0,7,0,12,15,34,2022-03-12 20:29:25.428589
48079,0,5,1,12,13,31,2022-03-12 20:29:26.685291
48088,0,4,0,9,13,26,2022-03-12 20:29:31.455155
48096,0,5,0,9,14,28,2022-03-12 20:29:34.863982
48100,0,4,0,10,15,29,2022-03-12 20:29:36.27609
48103,0,0,0,0,0,0,2022-03-12 20:29:37.4993
48105,0,0,0,0,0,0,2022-03-12 20:29:38.550846
48134,0,0,0,0,0,0,2022-03-12 20:29:55.912445
48137,0,0,0,0,0,0,2022-03-12 20:29:57.762855
48147,0,0,0,0,0,0,2022-03-12 20:30:00.163695
48111,2,3,0,8,15,28,2022-03-12 20:29:39.851026
48114,2,7,2,14,18,43,2022-03-12 20:29:41.180578
48116,21,0,3,10,60,94,2022-03-12 20:29:42.551518
48117,1,13,0,8,14,36,2022-03-12 20:29:43.906099
48118,1,4,0,12,20,37,2022-03-12 20:29:44.778751
48121,2,8,2,19,31,62,2022-03-12 20:29:46.357077
48126,3,19,2,22,32,78,2022-03-12 20:29:50.45435
48129,2,10,1,19,29,61,2022-03-12 20:29:53.166539
48133,0,0,0,0,0,0,2022-03-12 20:29:55.044863
48153,0,0,0,0,0,0,2022-03-12 20:30:02.626236
48163,0,0,0,0,0,0,2022-03-12 20:30:06.193485
48166,0,0,0,0,0,0,2022-03-12 20:30:07.754936
48169,0,0,0,0,0,0,2022-03-12 20:30:08.576006
48175,0,0,0,0,0,0,2022-03-12 20:30:10.919126
48186,0,0,0,0,0,0,2022-03-12 20:30:13.430211
48195,0,0,0,0,0,0,2022-03-12 20:30:16.906395
48204,0,0,0,0,0,0,2022-03-12 20:30:19.408237
48212,0,0,0,0,0,0,2022-03-12 20:30:23.018576
48215,0,0,0,0,0,0,2022-03-12 20:30:24.144074
48219,0,0,0,0,0,0,2022-03-12 20:30:25.378149
48224,1,5,1,12,17,36,2022-03-12 20:30:26.744125
48233,0,0,0,0,0,0,2022-03-12 20:30:29.035519
48241,0,0,0,0,0,0,2022-03-12 20:30:32.539063
48254,1,7,0,13,22,43,2022-03-12 20:30:36.328017
48266,0,0,0,0,0,0,2022-03-12 20:30:39.71118
48274,0,0,0,0,0,0,2022-03-12 20:30:42.167328
48281,0,0,0,0,0,0,2022-03-12 20:30:44.649788
48283,0,0,0,0,0,0,2022-03-12 20:30:45.966137
48285,0,0,0,0,0,0,2022-03-12 20:30:48.928123
48287,1,8,1,23,24,57,2022-03-12 20:30:53.591461
48288,1,8,2,19,22,52,2022-03-12 20:30:55.624194
48290,5,17,4,26,50,102,2022-03-12 20:30:58.777549
48292,1,15,1,12,22,51,2022-03-12 20:31:00.002271
48293,0,0,0,0,0,0,2022-03-12 20:31:00.816263
48295,1,6,0,9,17,33,2022-03-12 20:31:03.681469
48297,0,0,0,0,0,0,2022-03-12 20:31:06.100603
48298,0,0,0,0,0,0,2022-03-12 20:31:06.953602
48300,0,0,0,0,0,0,2022-03-12 20:31:08.721795
48301,1,11,0,15,21,48,2022-03-12 20:31:09.710694
48305,12,351,5,23,126,517,2022-03-12 20:31:13.045902
48307,1,13,1,19,19,53,2022-03-12 20:31:13.939558
48308,0,0,0,0,0,0,2022-03-12 20:31:14.821534
48312,3,85,3,7,20,118,2022-03-12 20:31:18.642573
48313,2,109,2,10,28,151,2022-03-12 20:31:19.898756
48317,1,10,1,12,19,43,2022-03-12 20:31:23.81558
48320,2,11,4,11,27,55,2022-03-12 20:31:26.096951
48322,1,4,0,9,27,41,2022-03-12 20:31:27.515139
48323,1,16,3,19,24,63,2022-03-12 20:31:28.532665
48324,1,9,1,12,18,41,2022-03-12 20:31:29.446373
48325,1,9,1,11,21,43,2022-03-12 20:31:30.409785
48327,1,11,1,17,19,49,2022-03-12 20:31:31.516252
48335,3,47,1,20,28,99,2022-03-12 20:31:35.474601
48343,13,32,5,33,57,140,2022-03-12 20:31:37.928395
48345,1,9,3,22,19,54,2022-03-12 20:31:40.076817
48349,3,14,2,21,24,64,2022-03-12 20:31:42.576144
48350,4,17,4,24,30,79,2022-03-12 20:31:43.741429
48352,21,48,13,29,692,803,2022-03-12 20:31:46.073527
48365,324,0,120,239,778,1461,2022-03-12 20:31:49.095109
48367,0,0,0,0,0,0,2022-03-12 20:31:49.922275
48368,0,0,0,0,0,0,2022-03-12 20:31:50.716078
48374,49,107,43,39,232,470,2022-03-12 20:31:55.403492
48375,1481,20656,322,145,36389,58993,2022-03-12 20:31:56.506081
48377,7,460,8,12,56,543,2022-03-12 20:31:58.166151
48378,8,422,8,10,60,508,2022-03-12 20:31:59.282164
48386,3,7,8,18,94,130,2022-03-12 20:32:01.656743
48391,288,0,82,280,650,1300,2022-03-12 20:32:03.667803
48397,0,0,0,0,0,0,2022-03-12 20:32:06.197159
48405,214,40,81,5,15182,15522,2022-03-12 20:32:06.38264
48406,15530,36256,3244,5124,35622,95776,2022-03-12 20:32:08.606118
48410,0,0,0,0,0,0,2022-03-12 20:32:20.426139
48411,75,115,75,23,2973,3261,2022-03-12 20:32:23.586275
48413,3,0,2,0,191045,191050,2022-03-12 20:32:23.761311
48414,78990,18,2063,3391,58366,142828,2022-03-12 20:32:23.930141
48415,7,0,3,0,25794,25804,2022-03-12 20:32:24.245094
48425,0,0,0,0,903,903,2022-03-12 20:32:29.543319
48427,0,0,0,0,1,1,2022-03-12 20:32:33.085581
48432,9,225,2,21,64,321,2022-03-12 20:32:35.378023
48438,7764,5,1739,152,34674,44334,2022-03-12 20:32:36.531154
48441,0,0,1,0,1449,1450,2022-03-12 20:32:40.364412
48442,0,0,0,0,1366,1366,2022-03-12 20:32:43.921792
48452,16,61,10,37,80,204,2022-03-12 20:32:46.003725
48453,3710,19174,659,1001,12548,37092,2022-03-12 20:32:46.422381
48455,715,0,100,132,852,1799,2022-03-12 20:32:46.594788
48456,686,21174,186,199,6933,29178,2022-03-12 20:32:50.158962
48459,0,0,0,0,0,0,2022-03-12 20:32:52.657625
48470,2837,4524,701,3435,9548,21045,2022-03-12 20:32:54.858264
48480,301,0,34,45,251,631,2022-03-12 20:32:57.669251
48481,309,381,98,119,3176,4083,2022-03-12 20:33:00.017027
48483,68691,141841,8485,13621,105635,338273,2022-03-12 20:33:00.199167
48486,8,22,6,55,133,224,2022-03-12 20:33:01.438462
48491,0,0,0,0,4761,4761,2022-03-12 20:33:07.516824
48494,0,0,0,0,0,0,2022-03-12 20:33:08.86259
48499,0,0,0,0,0,0,2022-03-12 20:33:11.099583
48502,0,0,0,0,1551,1551,2022-03-12 20:33:14.405872
48504,0,0,0,0,0,0,2022-03-12 20:33:15.181164
48505,12007,6,657,650,16767,30087,2022-03-12 20:33:15.339672
48507,0,3,0,0,0,3,2022-03-12 20:33:16.095125
48512,31,122,10,22,226,411,2022-03-12 20:33:19.832056
48517,98,0,20,72,133,323,2022-03-12 20:33:20.822153
48519,0,0,0,0,0,0,2022-03-12 20:33:21.637234
48530,0,0,0,0,0,0,2022-03-12 20:33:22.89916
48540,0,0,0,0,0,0,2022-03-12 20:33:26.523303
48544,24,0,9,31,53,117,2022-03-12 20:33:29.708646
48548,6,2,3,0,90857,90868,2022-03-12 20:33:29.912593
48555,197,264,48,140,606,1255,2022-03-12 20:33:31.450202
48557,0,0,0,0,0,0,2022-03-12 20:33:32.562036
48561,3918,4209,1752,120,288650,298649,2022-03-12 20:33:33.93505
48569,141984,254,13618,3204,88312,247372,2022-03-12 20:33:35.444346
48583,454077,2,4556,2052,255677,716364,2022-03-12 20:33:36.664315
48605,14,467,9,19,100,609,2022-03-12 20:33:39.418739
48606,14,403,7,16,101,541,2022-03-12 20:33:41.14354
48610,98,190,40,64,622,1014,2022-03-12 20:33:42.880126
48612,451,2957,121,94,5304,8927,2022-03-12 20:33:45.599335
48615,288,1246,166,147,1707,3554,2022-03-12 20:33:48.79908
48616,40,154,22,38,322,576,2022-03-12 20:33:50.579199
48624,1,0,0,0,7814,7815,2022-03-12 20:33:52.333159
48627,55,1175,38,36,2022,3326,2022-03-12 20:33:54.772689
48628,11,28,3,30,65,137,2022-03-12 20:33:55.951608
48638,0,0,0,0,0,0,2022-03-12 20:34:00.35389
48640,0,0,0,0,0,0,2022-03-12 20:34:01.744181
48641,8999,7071,1354,1441,12339,31204,2022-03-12 20:34:04.492053
48643,4,0,2,1,19070,19077,2022-03-12 20:34:07.235888
48743,0,0,0,0,0,0,2022-03-12 20:34:50.62264
48644,2228,4595,464,1848,7342,16477,2022-03-12 20:34:08.755829
48646,3,27,4,17,38,89,2022-03-12 20:34:11.585229
48649,0,0,0,0,3396,3396,2022-03-12 20:34:14.720221
48653,314,8939,42,57,902,10254,2022-03-12 20:34:15.233009
48661,163760,101,21145,957,114759,300722,2022-03-12 20:34:15.431005
48672,36,237,40,46,309,668,2022-03-12 20:34:16.873309
48678,90,214,92,44,2916,3356,2022-03-12 20:34:22.852852
48680,2383,2669,476,4542,9766,19836,2022-03-12 20:34:23.883233
48874,0,0,0,0,131,131,2022-03-12 20:36:33.779758
48694,165,217,54,39,748,1223,2022-03-12 20:34:27.949612
48695,0,0,0,0,0,0,2022-03-12 20:34:28.786697
48699,0,0,0,0,0,0,2022-03-12 20:34:29.594179
48703,4,18,1,20,97,140,2022-03-12 20:34:36.97633
48707,5526,52584,831,449,30083,89473,2022-03-12 20:34:40.076916
48708,0,0,0,0,497,497,2022-03-12 20:34:41.351904
48709,3,60,3,5,19,90,2022-03-12 20:34:42.513874
48711,7,268,2,5,24,306,2022-03-12 20:34:43.906398
48727,1320,3711,373,180,3958,9542,2022-03-12 20:34:47.084207
48730,0,0,0,0,0,0,2022-03-12 20:34:47.922214
48736,323488,80,4364,4531,131037,463500,2022-03-12 20:34:48.565193
48738,0,0,0,0,0,0,2022-03-12 20:34:49.452361
48750,10,35,7,20,48,120,2022-03-12 20:34:51.937269
48753,46617,44246,9512,15598,74267,190240,2022-03-12 20:34:57.923061
48754,16,43,9,34,120,222,2022-03-12 20:35:00.675635
48759,106,187,21,47,407,768,2022-03-12 20:35:02.355575
48760,8,0,1,0,37115,37124,2022-03-12 20:35:02.62832
48761,45439,82658,4393,11402,57681,201573,2022-03-12 20:35:03.542471
48764,8,212,2,7,30,259,2022-03-12 20:35:06.456132
48766,0,0,0,0,0,0,2022-03-12 20:35:09.634403
49576,0,0,0,0,0,0,2022-03-12 20:44:41.64537
49584,0,0,0,0,0,0,2022-03-12 20:44:49.767204
49586,0,0,0,0,0,0,2022-03-12 20:44:53.835412
48770,56,61,13,89,117,336,2022-03-12 20:35:11.429481
48772,7,193,4,8,37,249,2022-03-12 20:35:12.831641
48775,2308,6121,501,674,12611,22215,2022-03-12 20:35:17.185398
48776,6295,8087,1110,4191,18024,37707,2022-03-12 20:35:20.312033
48777,1,0,1,0,6813,6815,2022-03-12 20:35:20.47622
48779,2,0,1,0,6769,6772,2022-03-12 20:35:23.15919
48780,523,427,257,68,21715,22990,2022-03-12 20:35:26.240284
48783,0,0,0,0,0,0,2022-03-12 20:35:27.092518
48784,0,11,2,18,32,63,2022-03-12 20:35:28.126226
48789,5,22,1,43,40,111,2022-03-12 20:35:30.303342
49827,0,0,0,0,2732,2732,2022-03-12 20:47:58.695553
49828,0,0,0,0,1198,1198,2022-03-12 20:47:58.988361
48790,6,66,2,37,66,177,2022-03-12 20:35:31.516037
48803,0,0,0,0,0,0,2022-03-12 20:35:34.705451
48804,9685,25544,1076,1005,24461,61771,2022-03-12 20:35:37.686462
48810,98,0,24,33,440,595,2022-03-12 20:35:37.869461
48820,0,0,0,0,41951,41951,2022-03-12 20:35:42.786364
48825,9,292,4,6,52,363,2022-03-12 20:35:46.927174
48827,0,0,0,0,0,0,2022-03-12 20:35:47.86115
48828,0,0,0,0,0,0,2022-03-12 20:35:48.646233
48830,0,1,0,0,18128,18129,2022-03-12 20:35:51.609317
48834,0,0,0,0,0,0,2022-03-12 20:35:57.659174
48847,2,54,0,2,14,72,2022-03-12 20:36:05.391261
48850,0,0,0,0,0,0,2022-03-12 20:36:09.196401
48851,2,22,4,16,36,80,2022-03-12 20:36:10.312234
49833,0,0,0,0,0,0,2022-03-12 20:48:00.260866
48852,4,26,1,16,36,83,2022-03-12 20:36:11.39748
48854,0,0,0,0,0,0,2022-03-12 20:36:12.595755
48858,4090,6781,765,2220,15145,29001,2022-03-12 20:36:17.697472
48859,119,100,30,122,1259,1630,2022-03-12 20:36:20.150106
48861,0,0,0,0,0,0,2022-03-12 20:36:20.491729
48862,647,1158,107,283,2323,4518,2022-03-12 20:36:22.984505
48866,37,49,7,34,157,284,2022-03-12 20:36:25.540486
48868,0,0,0,0,254,254,2022-03-12 20:36:27.245699
48869,14,434,5,7,188,648,2022-03-12 20:36:29.157841
48870,0,0,0,0,0,0,2022-03-12 20:36:29.988901
48873,25,21,9,38,105,198,2022-03-12 20:36:32.556202
48875,64,42,27,28,1204,1365,2022-03-12 20:36:35.416844
48876,12,1244,6,11,127,1400,2022-03-12 20:36:36.930701
48877,20,231,12,37,153,453,2022-03-12 20:36:37.183252
48878,0,0,0,0,0,0,2022-03-12 20:36:38.328187
48882,2,52,1,2,11,68,2022-03-12 20:36:39.783168
48884,1,7,1,14,30,53,2022-03-12 20:36:40.719027
48890,22,363,16,30,232,663,2022-03-12 20:36:42.306152
48894,3,57,1,2,12,75,2022-03-12 20:36:46.492237
49980,0,0,0,0,643,643,2022-03-12 20:49:19.329356
49981,0,0,0,0,22651,22651,2022-03-12 20:49:21.724184
48895,1,0,0,0,158219,158220,2022-03-12 20:36:46.942077
48896,1,0,0,0,13321,13322,2022-03-12 20:36:49.877789
48903,0,1,0,0,34839,34840,2022-03-12 20:36:53.1581
48907,0,0,0,0,0,0,2022-03-12 20:36:56.156982
48908,2,41,1,8,18,70,2022-03-12 20:36:57.15564
48909,2,16,4,23,29,74,2022-03-12 20:36:58.725467
48914,12,31,4,10,216,273,2022-03-12 20:37:01.07591
48915,0,0,0,0,0,0,2022-03-12 20:37:01.93001
48918,4,79,1,11,68,163,2022-03-12 20:37:03.271363
48920,3,70,2,3,38,116,2022-03-12 20:37:05.524932
50598,0,0,0,0,0,0,2022-03-12 20:58:10.163632
48926,128665,256283,13268,12964,149507,560687,2022-03-12 20:37:06.807183
48931,0,0,0,0,0,0,2022-03-12 20:37:07.809016
48953,81,983,32,41,974,2111,2022-03-12 20:37:12.130628
48954,25,60,11,12,957,1065,2022-03-12 20:37:12.604074
48955,0,0,0,0,0,0,2022-03-12 20:37:13.502668
48956,754,2,46,58,284,1144,2022-03-12 20:37:14.401226
48960,7,105,2,10,45,169,2022-03-12 20:37:15.869143
48962,399,321,59,55,1924,2758,2022-03-12 20:37:19.636121
48963,2,72,1,3,14,92,2022-03-12 20:37:20.742162
48964,0,0,0,0,410,410,2022-03-12 20:37:26.670422
48965,0,0,0,0,158,158,2022-03-12 20:37:28.023432
48966,4,109,3,4,22,142,2022-03-12 20:37:29.16527
48967,4,70,2,3,18,97,2022-03-12 20:37:30.21773
48968,3,79,4,8,20,114,2022-03-12 20:37:31.391147
48969,7,110,3,10,27,157,2022-03-12 20:37:32.537402
48970,4,81,2,8,29,124,2022-03-12 20:37:33.712435
48971,3,146,3,10,35,197,2022-03-12 20:37:35.086887
48973,0,0,0,0,0,0,2022-03-12 20:37:37.727423
48979,0,31,2,12,12,57,2022-03-12 20:37:41.469524
48981,0,0,0,0,2098,2098,2022-03-12 20:37:43.745248
50749,0,0,0,0,0,0,2022-03-12 20:59:58.959953
50751,0,0,0,0,0,0,2022-03-12 20:59:59.796662
50753,0,0,0,0,0,0,2022-03-12 21:00:00.656638
48988,3,49,1,22,36,111,2022-03-12 20:37:45.473513
48992,5,184,8,18,111,326,2022-03-12 20:37:47.009421
48994,0,0,0,0,0,0,2022-03-12 20:37:47.789153
48997,50019,14,1229,2472,28283,82017,2022-03-12 20:37:47.963729
49001,0,0,0,0,0,0,2022-03-12 20:37:48.789592
49017,0,0,0,0,0,0,2022-03-12 20:37:50.773105
49040,5076,0,412,359,10332,16179,2022-03-12 20:37:52.583059
49065,1,17,0,12,19,49,2022-03-12 20:37:58.900731
49066,873,4000,178,304,3303,8658,2022-03-12 20:38:01.760445
49069,1,9,0,12,19,41,2022-03-12 20:38:02.701449
50754,0,0,0,0,0,0,2022-03-12 21:00:01.582282
49070,2,11,3,20,26,62,2022-03-12 20:38:03.744542
49078,3,30,2,32,39,106,2022-03-12 20:38:06.354278
49079,38,0,6,58,160,262,2022-03-12 20:38:09.949499
49091,3,59,1,4,16,83,2022-03-12 20:38:13.80522
49094,4,129,3,10,18,164,2022-03-12 20:38:14.942979
49098,51,127,21,40,247,486,2022-03-12 20:38:16.36056
49099,1,36,1,7,12,57,2022-03-12 20:38:17.370147
49101,0,0,0,0,0,0,2022-03-12 20:38:18.190733
49104,9,440,2,4,22,477,2022-03-12 20:38:20.352505
49109,1,0,2,0,28277,28280,2022-03-12 20:38:22.563138
49112,110,0,72,33,217,432,2022-03-12 20:38:23.381154
49114,64626,36,1632,816,67408,134518,2022-03-12 20:38:23.564897
49119,0,0,0,0,613,613,2022-03-12 20:38:27.027624
49120,0,0,0,0,514,514,2022-03-12 20:38:28.152315
49122,0,0,0,0,0,0,2022-03-12 20:38:30.805198
49123,1883,1,68,63,1290,3305,2022-03-12 20:38:31.386233
49124,0,62,0,7,15,84,2022-03-12 20:38:32.897315
49125,0,0,0,0,542,542,2022-03-12 20:38:34.639745
49126,0,0,0,0,0,0,2022-03-12 20:38:35.473931
49133,1,15,2,21,22,61,2022-03-12 20:38:37.736419
49134,221,172,53,34,440,920,2022-03-12 20:38:39.644315
49139,1,20,1,6,17,45,2022-03-12 20:38:43.139256
49143,1,12,0,17,27,57,2022-03-12 20:38:44.178069
49145,154,2594,136,96,1746,4726,2022-03-12 20:38:47.298047
49146,11,113,12,25,575,736,2022-03-12 20:38:48.767259
49147,0,0,0,0,0,0,2022-03-12 20:38:49.578121
49148,0,0,0,0,0,0,2022-03-12 20:38:50.355462
49154,0,0,0,0,1319,1319,2022-03-12 20:38:56.868167
49160,0,0,1,0,4796,4797,2022-03-12 20:38:59.342132
49162,0,0,0,0,0,0,2022-03-12 20:39:00.290053
49163,0,0,0,0,2194,2194,2022-03-12 20:39:03.521157
49168,0,0,0,0,0,0,2022-03-12 20:39:08.843294
49170,173,145,39,59,228,644,2022-03-12 20:39:10.367005
49179,0,0,0,0,854,854,2022-03-12 20:39:12.108187
49182,2,101,2,8,24,137,2022-03-12 20:39:13.852205
49184,65,28,14,101,264,472,2022-03-12 20:39:14.039133
49189,0,0,0,0,0,0,2022-03-12 20:39:15.159322
49195,1,9,4,10,15,39,2022-03-12 20:39:17.297212
49197,8,108,7,9,164,296,2022-03-12 20:39:20.086643
49198,2,21,6,8,35,72,2022-03-12 20:39:21.115055
49202,0,0,0,0,0,0,2022-03-12 20:39:24.45015
49204,328,0,74,171,2005,2578,2022-03-12 20:39:24.885325
49205,16,28,11,22,59,136,2022-03-12 20:39:25.939198
49210,0,0,0,0,1238,1238,2022-03-12 20:39:29.631437
49214,193,570,78,99,1357,2297,2022-03-12 20:39:32.646488
49215,568,892,169,154,1809,3592,2022-03-12 20:39:35.005965
49220,0,0,1,0,6043,6044,2022-03-12 20:39:37.728732
49221,17,63,5,53,113,251,2022-03-12 20:39:38.880108
49223,1128,1,110,127,2764,4130,2022-03-12 20:39:39.314118
49227,0,0,0,0,0,0,2022-03-12 20:39:40.45546
49233,0,1,1,0,77838,77840,2022-03-12 20:39:51.885972
49235,654,26741,229,370,10386,38380,2022-03-12 20:39:52.361443
49236,1751,26289,345,116,12797,41298,2022-03-12 20:39:57.721152
49241,653,8795,190,189,5522,15349,2022-03-12 20:40:03.468083
49243,0,0,0,0,1,1,2022-03-12 20:40:06.683725
49244,0,0,0,0,0,0,2022-03-12 20:40:08.760175
49245,0,0,0,0,0,0,2022-03-12 20:40:10.471076
49246,0,0,0,0,0,0,2022-03-12 20:40:11.296161
49247,0,0,0,0,0,0,2022-03-12 20:40:12.146944
49248,0,0,0,0,0,0,2022-03-12 20:40:13.036968
49249,0,0,0,0,0,0,2022-03-12 20:40:13.88732
49250,0,0,0,0,0,0,2022-03-12 20:40:15.206193
49252,0,0,0,0,0,0,2022-03-12 20:40:17.000395
49263,1539,5896,309,420,5908,14072,2022-03-12 20:40:32.482272
49270,0,0,0,0,0,0,2022-03-12 20:40:34.647532
49275,65,259,4,22,135,485,2022-03-12 20:40:38.935051
49277,13,0,8,18,81,120,2022-03-12 20:40:41.237015
49283,0,1,0,0,11411,11412,2022-03-12 20:40:41.433237
49284,15,131,3,22,168,339,2022-03-12 20:40:43.025496
49285,1124,0,131,370,1698,3323,2022-03-12 20:40:43.207352
49289,0,0,0,0,0,0,2022-03-12 20:40:48.870422
49290,286,739,126,118,2104,3373,2022-03-12 20:40:51.070377
49291,2,0,1,0,11510,11513,2022-03-12 20:40:51.234619
49292,4561,6660,863,6254,16845,35183,2022-03-12 20:40:53.79032
49297,674,13684,156,168,6007,20689,2022-03-12 20:40:54.137562
49302,0,0,0,0,0,0,2022-03-12 20:40:54.962339
49303,0,0,0,0,33125,33125,2022-03-12 20:40:57.260204
49305,493,0,31,41,159,724,2022-03-12 20:41:00.777086
49310,553,162,300,26,41780,42821,2022-03-12 20:41:00.981086
49311,0,0,0,0,0,0,2022-03-12 20:41:01.76257
49314,6,103,2,3,38,152,2022-03-12 20:41:03.163844
49316,0,0,1,0,18521,18522,2022-03-12 20:41:03.971249
49322,0,0,0,0,0,0,2022-03-12 20:41:05.250857
49332,1,22,0,0,2,25,2022-03-12 20:41:08.038583
49338,335,662,82,39,3182,4300,2022-03-12 20:41:10.640015
49342,3,1,0,0,3856,3860,2022-03-12 20:41:13.920468
49345,105,48,76,6,7658,7893,2022-03-12 20:41:16.903716
49348,81,347,29,52,736,1245,2022-03-12 20:41:18.534107
49354,3,7,7,23,42,82,2022-03-12 20:41:21.19443
49355,12,11,8,16,114,161,2022-03-12 20:41:22.40846
49363,0,0,0,0,24558,24558,2022-03-12 20:41:30.870929
49366,1,24,0,4,19,48,2022-03-12 20:41:31.916226
49367,0,0,0,0,0,0,2022-03-12 20:41:32.72156
49368,37,192,20,10,305,564,2022-03-12 20:41:34.079454
49369,14,26,7,20,155,222,2022-03-12 20:41:35.251029
49376,0,0,0,0,623,623,2022-03-12 20:41:38.803468
49379,3,14,3,20,21,61,2022-03-12 20:41:42.205914
49383,0,0,0,0,0,0,2022-03-12 20:41:44.749215
49385,14974,1,664,2717,13628,31984,2022-03-12 20:41:44.944217
49387,6,1,5,0,85513,85525,2022-03-12 20:41:48.946513
49391,3,22,2,15,23,65,2022-03-12 20:41:50.071519
49392,1125,375,256,306,440,2502,2022-03-12 20:41:50.498586
49395,51,1183,21,22,397,1674,2022-03-12 20:41:52.982941
49396,61,1775,36,24,671,2567,2022-03-12 20:41:55.117855
49398,333,0,24,49,374,780,2022-03-12 20:41:56.672335
49403,0,0,0,0,0,0,2022-03-12 20:42:01.687223
49409,73,1181,22,32,604,1912,2022-03-12 20:42:03.98448
49410,341,316,132,86,2125,3000,2022-03-12 20:42:08.524064
49413,2,0,1,0,21993,21996,2022-03-12 20:42:11.331024
49418,7,279,1,4,33,324,2022-03-12 20:42:13.724754
49420,5,327,2,6,24,364,2022-03-12 20:42:15.651148
49422,1,6,3,7,15,32,2022-03-12 20:42:16.744364
49429,1,60,0,5,14,80,2022-03-12 20:42:24.02524
49431,99,50,26,44,2686,2905,2022-03-12 20:42:28.726389
49432,0,0,0,0,298,298,2022-03-12 20:42:29.958716
49433,64,68,17,33,133,315,2022-03-12 20:42:31.221163
49437,2,96,1,4,17,120,2022-03-12 20:42:33.539435
49438,3,0,2,0,7246,7251,2022-03-12 20:42:36.104264
49439,0,54,1,3,18,76,2022-03-12 20:42:37.282324
49440,0,0,0,0,0,0,2022-03-12 20:42:38.085177
49441,0,0,0,0,0,0,2022-03-12 20:42:39.163357
49442,6,128,4,17,53,208,2022-03-12 20:42:40.336718
49445,9,23,7,22,56,117,2022-03-12 20:42:41.458437
49450,3,30,2,14,24,73,2022-03-12 20:42:44.214939
49454,33,0,13,27,90,163,2022-03-12 20:42:45.522777
49457,407,6703,168,73,9356,16707,2022-03-12 20:42:49.270409
49458,0,0,0,1,84113,84114,2022-03-12 20:42:49.738994
49460,0,0,0,0,741,741,2022-03-12 20:42:51.473388
49464,0,0,0,0,0,0,2022-03-12 20:42:52.28917
49467,55,956,22,24,828,1885,2022-03-12 20:42:54.19722
49469,0,0,0,0,27399,27399,2022-03-12 20:42:56.730561
49470,1,0,0,0,17703,17704,2022-03-12 20:42:59.213543
49471,20,54,21,24,1104,1223,2022-03-12 20:43:00.84784
49474,1,35,0,5,12,53,2022-03-12 20:43:01.844868
49475,0,53,0,2,7,62,2022-03-12 20:43:02.832117
49478,4,80,2,9,62,157,2022-03-12 20:43:05.260336
49479,0,0,0,0,0,0,2022-03-12 20:43:06.139446
49483,10901,4155,3348,362,10306,29072,2022-03-12 20:43:07.928425
49486,0,0,0,0,0,0,2022-03-12 20:43:09.701555
49487,335,2131,76,37,2175,4754,2022-03-12 20:43:12.309302
49491,1,39,0,6,17,63,2022-03-12 20:43:14.606553
49496,0,0,0,0,0,0,2022-03-12 20:43:16.498252
49498,1,46,0,3,15,65,2022-03-12 20:43:16.946289
49501,463,579,150,116,2783,4091,2022-03-12 20:43:19.219559
49505,2739,8198,517,1004,13969,26427,2022-03-12 20:43:21.665478
49507,437,286,93,92,2484,3392,2022-03-12 20:43:23.93446
49508,0,0,0,0,0,0,2022-03-12 20:43:24.727196
49509,0,0,0,0,0,0,2022-03-12 20:43:25.888254
49510,25,156,12,22,173,388,2022-03-12 20:43:27.240328
49513,0,0,0,0,0,0,2022-03-12 20:43:28.088204
49514,4186,1,317,2333,7414,14251,2022-03-12 20:43:28.255177
49515,7661,0,556,981,5521,14719,2022-03-12 20:43:28.42778
49520,11,0,4,0,51875,51890,2022-03-12 20:43:29.713964
49523,0,0,0,0,1317,1317,2022-03-12 20:43:32.849847
49526,0,0,0,0,0,0,2022-03-12 20:43:34.72863
49528,4,74,1,2,13,94,2022-03-12 20:43:40.652323
49530,0,0,0,0,0,0,2022-03-12 20:43:48.309077
49531,0,0,0,0,0,0,2022-03-12 20:43:49.192299
49532,101,74,41,15,2400,2631,2022-03-12 20:43:49.657047
49535,0,0,0,0,0,0,2022-03-12 20:43:53.229912
49544,0,0,0,0,0,0,2022-03-12 20:43:54.066091
49545,0,0,0,0,0,0,2022-03-12 20:43:54.937427
49549,0,0,0,0,0,0,2022-03-12 20:43:55.796072
49550,309,7331,80,140,1887,9747,2022-03-12 20:43:58.520088
49551,0,0,0,0,165,165,2022-03-12 20:43:59.790029
49552,0,0,0,0,0,0,2022-03-12 20:44:00.73458
49555,5,34,5,10,64,118,2022-03-12 20:44:02.000162
49556,2,0,0,0,10706,10708,2022-03-12 20:44:04.424165
49558,0,0,0,0,1731,1731,2022-03-12 20:44:06.421386
49560,0,0,0,0,0,0,2022-03-12 20:44:09.008185
49565,0,0,0,0,466,466,2022-03-12 20:44:10.581361
49569,333,0,22,23,383,761,2022-03-12 20:44:14.650174
49570,0,0,0,0,884,884,2022-03-12 20:44:16.354955
49571,555,1,19,26,418,1019,2022-03-12 20:44:16.610388
49572,0,0,0,0,6232,6232,2022-03-12 20:44:18.918526
49573,0,0,0,0,459,459,2022-03-12 20:44:20.189252
49574,0,0,0,0,1377,1377,2022-03-12 20:44:33.188301
49587,721,1,28,22,1414,2186,2022-03-12 20:44:57.160085
49590,0,0,0,0,13586,13586,2022-03-12 20:45:02.508111
49595,0,0,0,0,0,0,2022-03-12 20:45:05.311387
49596,0,1,1,0,49441,49443,2022-03-12 20:45:07.95793
49598,15,0,5,19,78,117,2022-03-12 20:45:09.208598
49600,3,157,2,6,18,186,2022-03-12 20:45:13.045404
49603,1,5,0,2,4,12,2022-03-12 20:45:14.902353
49608,0,0,0,0,0,0,2022-03-12 20:45:21.646438
49609,0,0,0,0,0,0,2022-03-12 20:45:22.516165
49611,0,0,0,0,0,0,2022-03-12 20:45:23.330205
49612,0,0,0,0,3108,3108,2022-03-12 20:45:24.826213
49613,0,0,0,0,2620,2620,2022-03-12 20:45:27.061301
49615,1,24,2,15,32,74,2022-03-12 20:45:29.412834
49616,0,0,0,0,0,0,2022-03-12 20:45:30.24235
49618,0,0,0,1,6443,6444,2022-03-12 20:45:32.221137
49620,17,48,9,20,120,214,2022-03-12 20:45:33.631426
49622,0,0,0,0,0,0,2022-03-12 20:45:34.411881
49627,484,364,93,22,2278,3241,2022-03-12 20:45:35.643469
49628,0,0,0,0,0,0,2022-03-12 20:45:36.904311
49635,0,0,0,0,0,0,2022-03-12 20:45:39.40669
49636,0,0,0,0,0,0,2022-03-12 20:45:40.175218
49638,605,1912,40,54,510,3121,2022-03-12 20:45:44.262362
49643,0,0,0,0,0,0,2022-03-12 20:45:45.221416
49652,322,1678,112,89,973,3174,2022-03-12 20:45:51.924763
49654,7,138,5,13,49,212,2022-03-12 20:45:53.484443
49657,0,0,0,0,0,0,2022-03-12 20:45:54.281642
49661,162,1049,36,31,1316,2594,2022-03-12 20:45:56.983268
49665,82,20,53,7,6114,6276,2022-03-12 20:46:00.917212
49669,0,0,0,0,0,0,2022-03-12 20:46:03.275635
49670,0,0,0,0,0,0,2022-03-12 20:46:04.088446
49671,0,0,0,0,0,0,2022-03-12 20:46:04.947529
49678,0,40,0,3,9,52,2022-03-12 20:46:05.928123
49689,0,0,0,0,0,0,2022-03-12 20:46:10.867356
49690,347,1016,166,28,2037,3594,2022-03-12 20:46:13.502176
49691,0,0,1,0,7474,7475,2022-03-12 20:46:15.02719
49692,1,0,1,0,12375,12377,2022-03-12 20:46:17.491406
49697,2,38,0,4,12,56,2022-03-12 20:46:18.542409
49700,5,38,3,5,27,78,2022-03-12 20:46:19.738104
49703,0,0,0,0,6240,6240,2022-03-12 20:46:23.009809
49704,0,0,0,0,0,0,2022-03-12 20:46:23.830171
49709,0,0,3,1,84596,84600,2022-03-12 20:46:25.530349
49716,0,0,0,0,671,671,2022-03-12 20:46:27.70769
49717,0,0,0,0,207,207,2022-03-12 20:46:28.880114
49718,101,105,33,20,566,825,2022-03-12 20:46:30.871176
49721,51974,23,1376,623,51932,105928,2022-03-12 20:46:31.061172
49722,1,1,1,0,12859,12862,2022-03-12 20:46:32.97746
49730,1876,6063,278,189,1862,10268,2022-03-12 20:46:36.158282
49733,1,0,0,0,16888,16889,2022-03-12 20:46:36.511269
49736,0,0,0,0,0,0,2022-03-12 20:46:39.516647
49738,10239,16519,2149,2752,25515,57174,2022-03-12 20:46:43.256862
49739,39,925,28,36,300,1328,2022-03-12 20:46:45.500173
49741,0,0,0,0,0,0,2022-03-12 20:46:46.314487
49742,0,0,0,0,144,144,2022-03-12 20:46:47.731352
49743,0,0,0,0,1069,1069,2022-03-12 20:46:49.348497
49744,0,0,0,0,0,0,2022-03-12 20:46:50.318066
49751,7,264,2,3,20,296,2022-03-12 20:46:54.370859
49753,0,0,0,0,0,0,2022-03-12 20:46:55.631069
49755,41,1968,12,26,440,2487,2022-03-12 20:46:57.520304
49756,0,0,0,0,0,0,2022-03-12 20:46:58.349152
49759,0,0,0,0,138,138,2022-03-12 20:47:01.314555
49768,0,0,0,0,0,0,2022-03-12 20:47:02.957452
49769,3,41,2,3,8,57,2022-03-12 20:47:10.290408
49774,0,0,0,0,334,334,2022-03-12 20:47:20.20853
49776,1,0,0,0,9592,9593,2022-03-12 20:47:26.131315
49780,2853,1,92,437,1513,4896,2022-03-12 20:47:28.429629
49782,0,0,0,0,26060,26060,2022-03-12 20:47:28.634367
49784,1,1,2,0,27210,27214,2022-03-12 20:47:31.084362
49785,1,0,3,0,45985,45989,2022-03-12 20:47:33.500035
49794,22,17,11,17,141,208,2022-03-12 20:47:35.823517
49801,0,0,0,0,0,0,2022-03-12 20:47:42.92777
49802,0,0,0,0,0,0,2022-03-12 20:47:44.788724
49804,0,0,0,0,0,0,2022-03-12 20:47:46.968513
49805,0,0,0,0,0,0,2022-03-12 20:47:47.811125
49806,34,23,8,14,267,346,2022-03-12 20:47:49.029199
49811,0,0,0,0,0,0,2022-03-12 20:47:50.331161
49814,12,31,5,15,42,105,2022-03-12 20:47:51.766527
49815,0,0,0,0,0,0,2022-03-12 20:47:53.270135
49818,0,0,0,0,0,0,2022-03-12 20:47:55.232484
49819,0,0,0,0,965,965,2022-03-12 20:47:55.437308
49820,0,0,0,0,550,550,2022-03-12 20:47:57.124353
49838,15,994,5,11,121,1146,2022-03-12 20:48:02.443487
49839,0,0,0,0,0,0,2022-03-12 20:48:03.255988
49841,54,81,5,36,103,279,2022-03-12 20:48:04.374573
49843,0,0,0,0,56,56,2022-03-12 20:48:08.550517
49844,0,0,0,0,0,0,2022-03-12 20:48:09.639576
49847,432,850,68,55,1932,3337,2022-03-12 20:48:11.055146
49848,224,1084,86,85,1708,3187,2022-03-12 20:48:13.383659
49849,0,0,0,0,997,997,2022-03-12 20:48:15.0516
49851,0,0,0,0,501,501,2022-03-12 20:48:16.736229
49854,6401,22475,865,908,13427,44076,2022-03-12 20:48:18.570733
49855,0,0,0,0,0,0,2022-03-12 20:48:19.34114
49860,132,1623,24,38,510,2327,2022-03-12 20:48:25.323201
49866,285,1591,146,44,4924,6990,2022-03-12 20:48:29.141611
49867,25,0,7,24,49,105,2022-03-12 20:48:30.454019
49869,272,1036,156,51,7530,9045,2022-03-12 20:48:32.787168
49871,0,0,0,0,0,0,2022-03-12 20:48:33.609956
49873,159,157,22,25,133,496,2022-03-12 20:48:34.684503
49875,0,0,0,0,0,0,2022-03-12 20:48:36.128427
49877,1,0,4,0,71328,71333,2022-03-12 20:48:38.512319
49878,6,269,0,4,22,301,2022-03-12 20:48:39.842018
49880,10,555,11,15,136,727,2022-03-12 20:48:41.316157
49881,0,0,0,0,0,0,2022-03-12 20:48:42.140117
49882,0,0,0,0,0,0,2022-03-12 20:48:43.057425
49889,2,0,3,0,52279,52284,2022-03-12 20:48:47.429137
49891,0,0,0,0,5307,5307,2022-03-12 20:48:49.824984
49894,2,0,0,0,3099,3101,2022-03-12 20:48:52.662854
49898,2,64,0,2,11,79,2022-03-12 20:48:55.910472
49899,0,45,0,3,11,59,2022-03-12 20:48:56.898992
49903,1,61,0,4,16,82,2022-03-12 20:49:01.417615
49909,1454,1282,47,19,2024,4826,2022-03-12 20:49:03.763346
49913,30,847,13,21,208,1119,2022-03-12 20:49:06.059472
49915,1128,537,257,93,5026,7041,2022-03-12 20:49:06.51064
49918,3,2,2,0,137653,137660,2022-03-12 20:49:06.675191
49930,72342,30,1367,1408,47487,122634,2022-03-12 20:49:07.149295
49956,6,17,3,20,51,97,2022-03-12 20:49:09.465558
49960,0,5,0,9,16,30,2022-03-12 20:49:10.666632
49961,0,5,0,8,14,27,2022-03-12 20:49:11.541191
49976,6,180,1,7,40,234,2022-03-12 20:49:15.680037
49977,8,198,1,6,37,250,2022-03-12 20:49:16.91541
49982,99,20,43,18,1453,1633,2022-03-12 20:49:24.034519
49983,0,0,0,0,92,92,2022-03-12 20:49:25.147
49984,0,0,0,0,91,91,2022-03-12 20:49:26.267157
49990,0,0,0,0,0,0,2022-03-12 20:49:31.807516
49992,4,12,0,11,19,46,2022-03-12 20:49:39.393276
49995,1,50,0,3,9,63,2022-03-12 20:49:41.648346
49996,3,51,0,2,9,65,2022-03-12 20:49:42.890259
50001,0,0,0,0,0,0,2022-03-12 20:49:46.316265
50002,0,0,4,0,5064,5068,2022-03-12 20:49:48.556597
50005,0,54,0,2,7,63,2022-03-12 20:49:49.490003
50006,3,99,0,2,13,117,2022-03-12 20:49:50.714476
50008,2,137,1,7,15,162,2022-03-12 20:49:57.996423
50009,0,40,3,5,10,58,2022-03-12 20:50:00.262713
50010,0,0,1,0,772,773,2022-03-12 20:50:01.920822
50012,0,0,0,0,1087,1087,2022-03-12 20:50:02.11471
50019,2,54,1,4,8,69,2022-03-12 20:50:03.21332
50022,2,100,1,2,16,121,2022-03-12 20:50:06.386536
50028,0,67,1,9,7,84,2022-03-12 20:50:09.534525
50030,8,612,1,7,56,684,2022-03-12 20:50:13.006342
50033,2,99,2,4,18,125,2022-03-12 20:50:15.45448
50036,2,178,2,4,68,254,2022-03-12 20:50:16.979536
50037,6,273,0,3,31,313,2022-03-12 20:50:18.258148
50038,4,102,0,2,21,129,2022-03-12 20:50:19.379284
50040,2,64,1,3,13,83,2022-03-12 20:50:21.981279
50041,3,268,1,4,51,327,2022-03-12 20:50:23.162502
50043,0,45,1,3,7,56,2022-03-12 20:50:25.30843
50045,0,0,0,0,0,0,2022-03-12 20:50:26.164149
50049,2,14,2,13,18,49,2022-03-12 20:50:30.475435
50050,1,10,1,15,17,44,2022-03-12 20:50:31.409601
50053,3,111,1,2,19,136,2022-03-12 20:50:33.084436
50054,3,117,0,3,20,143,2022-03-12 20:50:34.480717
50055,11,382,1,7,45,446,2022-03-12 20:50:35.843389
50056,3,96,2,3,13,117,2022-03-12 20:50:37.923333
50060,0,0,0,0,653,653,2022-03-12 20:50:41.241332
50062,4,101,0,3,23,131,2022-03-12 20:50:42.317683
50063,5,151,1,3,28,188,2022-03-12 20:50:43.426209
50065,0,0,0,0,0,0,2022-03-12 20:50:45.467216
50066,7,256,9,11,100,383,2022-03-12 20:50:46.601639
50073,2,60,0,3,18,83,2022-03-12 20:50:49.490433
50076,2,82,0,3,15,102,2022-03-12 20:50:53.354161
50077,2,79,0,2,18,101,2022-03-12 20:50:54.968448
50079,1,68,0,3,12,84,2022-03-12 20:50:56.370551
50082,0,49,1,4,11,65,2022-03-12 20:50:58.504037
50086,2,47,1,1,8,59,2022-03-12 20:50:59.615677
50089,0,0,0,0,0,0,2022-03-12 20:51:00.753589
50094,150,2590,44,37,1232,4053,2022-03-12 20:51:03.510964
50099,0,0,0,0,2649,2649,2022-03-12 20:51:16.94935
50101,2,17,2,5,4,30,2022-03-12 20:51:19.157551
50109,0,0,0,0,0,0,2022-03-12 20:51:24.33113
50110,4,131,4,8,60,207,2022-03-12 20:51:25.586096
50111,6,72,11,6,48,143,2022-03-12 20:51:26.935814
50112,0,0,0,0,0,0,2022-03-12 20:51:27.755078
50113,1,53,0,1,5,60,2022-03-12 20:51:28.766177
50114,0,0,0,0,0,0,2022-03-12 20:51:29.535275
50115,2,83,0,4,13,102,2022-03-12 20:51:31.354244
50119,1,25,0,2,4,32,2022-03-12 20:51:34.16451
50122,0,0,0,0,0,0,2022-03-12 20:51:36.75628
50123,2,35,2,1,7,47,2022-03-12 20:51:37.705202
50124,2,33,0,2,7,44,2022-03-12 20:51:38.648437
50125,2,32,0,1,6,41,2022-03-12 20:51:39.573492
50137,0,0,0,0,0,0,2022-03-12 20:51:42.649739
50139,0,0,0,0,3338,3338,2022-03-12 20:51:44.698234
50142,12,0,3,30,31,76,2022-03-12 20:51:47.420839
50143,0,0,0,0,0,0,2022-03-12 20:51:48.2102
50145,0,40,1,1,5,47,2022-03-12 20:51:49.062396
50146,1,37,0,1,4,43,2022-03-12 20:51:50.670458
50147,1,37,0,2,6,46,2022-03-12 20:51:51.597313
50150,5,62,0,1,15,83,2022-03-12 20:51:52.723592
50169,0,0,0,0,1,1,2022-03-12 20:51:56.869713
50179,0,0,0,0,0,0,2022-03-12 20:51:59.071127
50191,6,36,5,12,125,184,2022-03-12 20:52:00.878634
50193,0,0,0,0,151,151,2022-03-12 20:52:02.101591
50194,0,0,0,0,0,0,2022-03-12 20:52:02.858548
50203,0,0,0,0,8468,8468,2022-03-12 20:52:05.882553
50204,21254,3,867,2900,17725,42749,2022-03-12 20:52:06.085554
50205,0,0,0,0,4600,4600,2022-03-12 20:52:08.734481
50206,30,484,2,9,153,678,2022-03-12 20:52:10.300281
50207,443,0,30,34,358,865,2022-03-12 20:52:11.222236
50215,0,0,0,0,0,0,2022-03-12 20:52:15.274568
50217,0,0,0,0,0,0,2022-03-12 20:52:18.635574
50218,9,233,3,6,39,290,2022-03-12 20:52:20.002453
50220,1,0,0,0,4102,4103,2022-03-12 20:52:22.540498
50221,0,0,0,0,797,797,2022-03-12 20:52:24.132036
50225,1,35,0,3,14,53,2022-03-12 20:52:25.991465
50226,0,0,0,0,0,0,2022-03-12 20:52:26.838095
50227,2,24,0,0,1,27,2022-03-12 20:52:27.709087
50230,8,12,0,9,22,51,2022-03-12 20:52:30.569707
50238,1,30,0,2,2,35,2022-03-12 20:52:34.791872
50241,1,23,0,2,2,28,2022-03-12 20:52:37.265317
50245,0,0,0,0,0,0,2022-03-12 20:52:39.967294
50249,0,0,0,0,0,0,2022-03-12 20:52:41.74019
50272,0,0,0,0,0,0,2022-03-12 20:52:45.010404
50280,52,31,9,26,203,321,2022-03-12 20:52:47.154753
50281,2104,1,77,108,2063,4353,2022-03-12 20:52:47.378612
50290,12,137,8,9,143,309,2022-03-12 20:52:48.710586
50296,0,2,0,7,6,15,2022-03-12 20:52:50.944302
50297,1,0,0,7,7,15,2022-03-12 20:52:51.804882
50299,1,2,0,2,14,19,2022-03-12 20:52:52.790038
50302,1,56,1,2,18,78,2022-03-12 20:52:54.184376
50304,0,0,0,0,0,0,2022-03-12 20:52:55.346582
50317,0,0,0,0,0,0,2022-03-12 20:52:58.69036
50320,0,0,0,0,0,0,2022-03-12 20:52:59.877536
50325,1550,18632,243,75,10304,30804,2022-03-12 20:53:03.03369
50326,6,6,3,8,62,85,2022-03-12 20:53:04.559309
50330,2,1,4,1,69829,69837,2022-03-12 20:53:04.816487
50339,1,0,0,0,9804,9805,2022-03-12 20:53:12.184147
50343,4,0,1,4,8,17,2022-03-12 20:53:15.953262
50346,6,0,3,0,39525,39534,2022-03-12 20:53:16.266085
50347,0,0,0,0,0,0,2022-03-12 20:53:17.038162
50348,1,0,0,0,12293,12294,2022-03-12 20:53:19.412348
50352,1,106,0,2,10,119,2022-03-12 20:53:21.840148
50353,0,0,0,0,0,0,2022-03-12 20:53:22.70137
50359,0,0,0,0,0,0,2022-03-12 20:53:24.279837
50360,7,3,2,1,56030,56043,2022-03-12 20:53:24.553231
50362,0,0,0,0,0,0,2022-03-12 20:53:25.39063
50363,0,0,0,0,0,0,2022-03-12 20:53:26.198759
50364,874,985,30,47,535,2471,2022-03-12 20:53:26.371806
50384,0,0,0,0,1244,1244,2022-03-12 20:53:30.223616
50385,0,0,0,0,0,0,2022-03-12 20:53:31.117536
50387,0,0,0,0,0,0,2022-03-12 20:53:31.942172
50391,0,0,0,0,0,0,2022-03-12 20:53:33.799185
50404,0,0,1,0,17227,17228,2022-03-12 20:53:39.261092
50405,0,0,0,0,936,936,2022-03-12 20:53:41.650062
50410,3,0,2,0,38212,38217,2022-03-12 20:53:47.479327
50411,303,1,30,46,370,750,2022-03-12 20:53:48.443304
50418,406,0,38,182,858,1484,2022-03-12 20:53:54.66422
50422,4,61,1,4,16,86,2022-03-12 20:53:59.323618
50425,0,0,0,0,3802,3802,2022-03-12 20:54:00.999523
50429,0,0,0,0,359,359,2022-03-12 20:54:03.372378
50430,172,0,18,24,266,480,2022-03-12 20:54:04.246412
50432,0,0,0,0,91,91,2022-03-12 20:54:07.474707
50438,0,0,0,0,2734,2734,2022-03-12 20:54:23.359924
50439,0,0,0,0,1,1,2022-03-12 20:54:26.212611
50441,124,0,6,16,158,304,2022-03-12 20:54:40.115589
50443,0,0,0,0,0,0,2022-03-12 20:54:47.01452
50444,157,0,9,14,104,284,2022-03-12 20:54:47.981458
50445,0,0,0,0,0,0,2022-03-12 20:54:48.739457
50446,0,0,0,0,0,0,2022-03-12 20:54:49.502509
50447,0,0,0,0,0,0,2022-03-12 20:54:50.297591
50448,0,0,0,0,0,0,2022-03-12 20:54:51.035582
50450,0,0,0,0,0,0,2022-03-12 20:54:52.04753
50456,0,0,0,0,0,0,2022-03-12 20:54:53.149339
50461,6,0,0,1,22260,22267,2022-03-12 20:54:53.945054
50469,0,0,1,0,1522,1523,2022-03-12 20:54:56.738676
50470,0,0,0,0,937,937,2022-03-12 20:54:58.375532
50473,0,0,0,0,0,0,2022-03-12 20:54:59.107111
50475,785,6099,136,158,3658,10836,2022-03-12 20:55:02.373455
50480,5,88,2,9,51,155,2022-03-12 20:55:04.594417
50481,1,0,0,0,2887,2888,2022-03-12 20:55:06.144473
50482,2,49,1,1,7,60,2022-03-12 20:55:07.172381
50484,1,26,0,4,6,37,2022-03-12 20:55:09.108394
50485,1,29,0,1,4,35,2022-03-12 20:55:10.062509
50486,1,22,0,1,4,28,2022-03-12 20:55:10.881679
50500,0,0,0,0,0,0,2022-03-12 20:55:15.514535
50503,29,194,4,16,151,394,2022-03-12 20:55:18.092299
50506,0,0,0,0,0,0,2022-03-12 20:55:19.819206
50508,0,0,0,0,0,0,2022-03-12 20:55:20.803483
50513,4,136,1,2,11,154,2022-03-12 20:55:22.368644
50515,199,0,32,13,365,609,2022-03-12 20:55:23.788535
50522,58,0,14,53,258,383,2022-03-12 20:55:26.30473
50523,0,0,0,0,0,0,2022-03-12 20:55:27.135947
50528,0,0,2,0,20882,20884,2022-03-12 20:55:29.903326
50532,805,2459,203,35,6013,9515,2022-03-12 20:55:30.818229
50542,0,0,0,0,0,0,2022-03-12 20:55:34.076895
50547,0,0,0,0,0,0,2022-03-12 20:55:36.467387
50564,0,0,0,0,0,0,2022-03-12 20:55:40.15358
50566,0,0,0,0,0,0,2022-03-12 20:55:41.411564
50568,0,0,0,0,0,0,2022-03-12 20:55:42.412532
50572,36,0,7,11,140,194,2022-03-12 20:55:44.100421
50573,0,0,0,0,0,0,2022-03-12 20:55:45.128368
50575,0,0,0,0,0,0,2022-03-12 20:55:46.084382
50579,0,0,0,0,0,0,2022-03-12 20:55:47.264529
50583,1,0,0,0,1288,1289,2022-03-12 20:55:49.623405
50586,0,0,0,0,336,336,2022-03-12 20:55:51.876315
50590,0,0,0,0,749,749,2022-03-12 20:56:27.171445
50594,0,0,0,0,9329,9329,2022-03-12 20:57:36.812547
50596,0,0,0,0,0,0,2022-03-12 20:58:07.427376
50597,13,201,3,10,108,335,2022-03-12 20:58:09.393683
50599,2070,0,89,110,2615,4884,2022-03-12 20:58:10.41763
50600,0,0,0,0,88,88,2022-03-12 20:58:11.578461
50602,1,0,2,0,18429,18432,2022-03-12 20:58:14.147058
50603,35,0,5,13,136,189,2022-03-12 20:58:15.41873
50604,75,12,12,14,240,353,2022-03-12 20:58:16.369616
50606,0,0,0,0,2533,2533,2022-03-12 20:58:19.163442
50607,1,0,0,0,1686,1687,2022-03-12 20:58:19.381425
50608,1,0,0,1,65104,65106,2022-03-12 20:58:19.721586
50612,1,1,3,0,53913,53918,2022-03-12 20:58:22.797561
50617,0,0,0,0,0,0,2022-03-12 20:58:27.47031
50618,0,0,0,0,0,0,2022-03-12 20:58:28.952241
50621,7,26,2,9,21,65,2022-03-12 20:58:30.584906
50629,101,0,11,17,133,262,2022-03-12 20:58:31.874525
50631,4,0,0,0,106274,106278,2022-03-12 20:58:32.170741
50633,0,0,0,0,0,0,2022-03-12 20:58:34.193442
50636,0,0,0,0,0,0,2022-03-12 20:58:36.024418
50638,1,0,0,0,3440,3441,2022-03-12 20:58:39.191601
50639,4,41,2,2,6,55,2022-03-12 20:58:40.142503
50644,14,38,3,15,35,105,2022-03-12 20:58:43.346608
50647,211,0,14,25,205,455,2022-03-12 20:58:46.14749
50650,0,0,0,0,0,0,2022-03-12 20:58:46.927479
50653,0,1,1,0,27943,27945,2022-03-12 20:58:48.773487
50657,82,0,6,18,77,183,2022-03-12 20:58:52.817595
50662,3,31,0,10,11,55,2022-03-12 20:58:54.380141
50663,0,0,1,0,9644,9645,2022-03-12 20:58:59.476024
50664,0,0,2,0,27054,27056,2022-03-12 20:59:08.128585
50666,0,0,0,0,0,0,2022-03-12 20:59:14.411075
50667,288,0,14,21,299,622,2022-03-12 20:59:18.490797
50668,0,0,0,0,3790,3790,2022-03-12 20:59:22.264619
50669,3,126,2,2,10,143,2022-03-12 20:59:23.834602
50672,1,0,1,0,9525,9527,2022-03-12 20:59:24.027634
50673,424,1717,78,40,1544,3803,2022-03-12 20:59:26.708191
50674,0,0,0,0,0,0,2022-03-12 20:59:27.534166
50675,0,0,0,0,884,884,2022-03-12 20:59:29.197081
50678,2,0,1,0,3069,3072,2022-03-12 20:59:30.26492
50679,0,0,0,0,0,0,2022-03-12 20:59:31.170175
50681,34,0,8,32,47,121,2022-03-12 20:59:33.387669
50686,0,0,0,0,0,0,2022-03-12 20:59:37.936653
50687,0,0,0,0,0,0,2022-03-12 20:59:38.732635
50696,350,6647,82,77,2230,9386,2022-03-12 20:59:40.766726
50700,0,0,0,0,0,0,2022-03-12 20:59:42.127078
50709,0,0,0,0,2169,2169,2022-03-12 20:59:46.325004
50731,0,0,0,0,0,0,2022-03-12 20:59:49.240372
50738,1,0,2,0,30770,30773,2022-03-12 20:59:51.466066
50740,19,825,3,1,109,957,2022-03-12 20:59:55.185741
50746,6,33,3,10,23,75,2022-03-12 20:59:56.383334
50747,4,80,5,1,30,120,2022-03-12 20:59:57.670879
50748,8,103,3,4,41,159,2022-03-12 20:59:58.098141
50762,47,203,9,11,329,599,2022-03-12 21:00:03.217414
50766,0,0,0,0,0,0,2022-03-12 21:00:04.348121
50767,0,0,0,0,0,0,2022-03-12 21:00:05.138947
50772,0,0,0,0,0,0,2022-03-12 21:00:09.556363
50774,4,162,4,2,16,188,2022-03-12 21:00:11.746861
50775,0,0,0,0,0,0,2022-03-12 21:00:12.688308
50784,2,53,1,1,5,62,2022-03-12 21:00:13.607162
50793,0,0,0,0,0,0,2022-03-12 21:00:17.150946
50796,1,0,0,0,2950,2951,2022-03-12 21:00:19.600571
50797,4,5,0,6,29,44,2022-03-12 21:00:20.54446
50799,0,0,0,0,0,0,2022-03-12 21:00:21.367556
50803,1,0,0,0,23113,23114,2022-03-12 21:00:24.038287
50805,0,0,0,0,0,0,2022-03-12 21:00:24.8773
50807,0,0,0,0,0,0,2022-03-12 21:00:26.584255
50811,0,0,0,0,0,0,2022-03-12 21:00:28.604227
50814,0,0,0,0,0,0,2022-03-12 21:00:29.417488
50815,2,205,4,2,28,241,2022-03-12 21:00:30.649836
50823,0,0,0,0,0,0,2022-03-12 21:00:31.483263
50842,18,14,6,7,82,127,2022-03-12 21:00:33.055576
50844,0,0,0,0,0,0,2022-03-12 21:00:33.37621
50851,2,40,0,2,6,50,2022-03-12 21:00:35.154761
50854,0,0,0,0,653,653,2022-03-12 21:00:36.939908
50855,0,0,0,0,821,821,2022-03-12 21:00:38.724702
50856,0,0,0,0,0,0,2022-03-12 21:00:39.723338
50863,0,0,0,0,208,208,2022-03-12 21:00:41.701721
50864,1,0,0,0,1314,1315,2022-03-12 21:00:43.532917
50869,2,0,0,0,1355,1357,2022-03-12 21:00:45.260148
50872,0,0,0,0,0,0,2022-03-12 21:00:46.801768
50873,0,0,0,0,0,0,2022-03-12 21:00:47.698956
50874,0,0,0,0,0,0,2022-03-12 21:00:48.548231
50876,2,44,3,1,7,57,2022-03-12 21:00:49.562878
50882,0,0,0,0,0,0,2022-03-12 21:00:51.842879
50890,0,0,0,0,0,0,2022-03-12 21:00:53.043724
50905,0,0,0,0,1059,1059,2022-03-12 21:00:54.770122
50916,0,0,0,0,11646,11646,2022-03-12 21:00:57.223208
50923,0,0,0,0,1291,1291,2022-03-12 21:00:59.814093
50924,1,23,0,0,3,27,2022-03-12 21:01:00.735523
50925,120,0,5,12,82,219,2022-03-12 21:01:02.169222
50930,98,0,22,15,329,464,2022-03-12 21:01:03.543237
50932,0,0,0,0,762,762,2022-03-12 21:01:06.586415
50934,356,1,23,20,89,489,2022-03-12 21:01:06.801412
50935,0,0,0,0,0,0,2022-03-12 21:01:07.558786
50937,0,0,0,0,0,0,2022-03-12 21:01:08.546924
50953,0,0,0,0,3619,3619,2022-03-12 21:01:11.932397
50955,0,0,0,0,1843,1843,2022-03-12 21:01:12.394371
50962,0,0,0,0,0,0,2022-03-12 21:01:13.316483
50980,0,0,0,0,0,0,2022-03-12 21:01:16.901594
50995,0,0,0,0,0,0,2022-03-12 21:01:20.529192
50999,0,0,0,0,531,531,2022-03-12 21:01:25.73558
51001,0,0,0,0,0,0,2022-03-12 21:01:27.984277
51002,0,0,0,0,0,0,2022-03-12 21:01:28.868362
51004,2,48,0,1,7,58,2022-03-12 21:01:30.029429
51005,2,43,0,1,9,55,2022-03-12 21:01:30.975947
51006,5,16,1,4,10,36,2022-03-12 21:01:31.877149
51008,12,99,2,7,101,221,2022-03-12 21:01:33.17729
51009,1,0,2,0,17260,17263,2022-03-12 21:01:33.357289
51019,0,0,5,2,35915,35922,2022-03-12 21:01:34.540531
51033,0,0,0,0,0,0,2022-03-12 21:01:36.894158
51035,2,6,0,1,11,20,2022-03-12 21:01:37.787011
51036,7,53,6,8,55,129,2022-03-12 21:01:38.955783
51037,0,0,0,0,36,36,2022-03-12 21:01:39.314091
51048,2,35,0,2,7,46,2022-03-12 21:01:41.186699
51050,1,44,0,1,6,52,2022-03-12 21:01:42.286544
51055,0,0,0,0,0,0,2022-03-12 21:01:43.435346
51066,0,0,0,0,0,0,2022-03-12 21:01:45.861384
51080,0,0,0,0,0,0,2022-03-12 21:01:49.402816
51082,0,0,0,0,0,0,2022-03-12 21:01:50.567209
51084,0,0,0,0,0,0,2022-03-12 21:01:51.832625
51087,2,57,0,1,8,68,2022-03-12 21:01:53.234331
51090,4,27,1,0,2,34,2022-03-12 21:01:54.301795
51099,0,0,0,0,0,0,2022-03-12 21:01:58.066634
51109,1,44,1,1,5,52,2022-03-12 21:02:02.063242
51113,0,0,0,0,0,0,2022-03-12 21:02:03.580003
51116,0,0,0,0,598,598,2022-03-12 21:02:05.258559
51119,1,0,0,0,4061,4062,2022-03-12 21:02:05.680526
51121,0,0,0,0,0,0,2022-03-12 21:02:06.660566
51123,0,20,1,2,7,30,2022-03-12 21:02:25.483199
51127,0,0,0,0,0,0,2022-03-12 21:02:28.214316
51128,1,0,0,0,725,726,2022-03-12 21:02:29.72628
51129,0,0,0,0,0,0,2022-03-12 21:02:30.532066
51131,46,1,5,12,34,98,2022-03-12 21:02:31.654095
51132,9,11,4,11,22,57,2022-03-12 21:02:32.649495
51133,0,0,0,0,0,0,2022-03-12 21:02:33.760314
51135,0,0,0,0,0,0,2022-03-12 21:02:34.566327
51137,0,0,0,0,0,0,2022-03-12 21:02:35.669904
51139,0,0,0,0,0,0,2022-03-12 21:02:36.539273
51142,0,0,0,0,0,0,2022-03-12 21:02:38.425182
51147,0,0,0,0,110,110,2022-03-12 21:02:39.963509
51149,56,149,26,8,352,591,2022-03-12 21:02:41.516674
51150,5,53,3,3,14,78,2022-03-12 21:02:42.605527
51151,1,26,1,2,5,35,2022-03-12 21:02:43.530234
51158,0,14,2,3,5,24,2022-03-12 21:02:45.649547
51163,4,83,1,2,23,113,2022-03-12 21:02:55.00403
51172,0,0,0,0,0,0,2022-03-12 21:03:00.807321
51175,0,0,0,0,0,0,2022-03-12 21:03:03.95265
51183,26,1,8,7,92,134,2022-03-12 21:03:08.008438
51194,56,37,17,8,350,468,2022-03-12 21:03:10.469199
51195,124,168,17,13,634,956,2022-03-12 21:03:12.361862
51196,17,10,6,5,44,82,2022-03-12 21:03:13.509545
51198,7,13,4,7,28,59,2022-03-12 21:03:16.439674
51213,9,0,2,0,3079,3090,2022-03-12 21:03:21.711871
51215,6,0,2,0,8618,8626,2022-03-12 21:03:22.016486
51218,412,7,31,7,411,868,2022-03-12 21:03:27.903926
51219,2,0,0,0,835,837,2022-03-12 21:03:28.199586
51225,129,416,25,7,591,1168,2022-03-12 21:03:31.28879
45898,0,0,0,0,0,0,2022-03-21 11:49:22.487089
45906,0,0,0,0,0,0,2022-03-21 11:49:24.785902
45910,0,0,0,0,0,0,2022-03-21 11:49:26.11646
45923,0,0,0,0,0,0,2022-03-21 11:49:31.117791
45933,0,0,0,0,0,0,2022-03-21 11:49:35.609034
45944,0,0,0,0,0,0,2022-03-21 11:49:41.550497
45948,0,0,0,0,0,0,2022-03-21 11:49:43.891312
45959,0,0,0,0,0,0,2022-03-21 11:49:46.426491
45962,0,0,0,0,0,0,2022-03-21 11:49:47.554035
45965,0,0,0,0,0,0,2022-03-21 11:49:48.659846
45969,0,0,0,0,0,0,2022-03-21 11:49:49.894586
45975,0,0,0,0,0,0,2022-03-21 11:49:52.354638
45978,0,0,0,0,0,0,2022-03-21 11:49:54.093606
45980,0,0,0,0,0,0,2022-03-21 11:49:56.162504
45987,0,0,0,0,0,0,2022-03-21 11:49:58.669609
45989,0,0,0,0,0,0,2022-03-21 11:50:01.291409
45990,0,0,0,0,0,0,2022-03-21 11:50:02.12688
46182,0,0,0,0,0,0,2022-03-21 11:51:28.394878
46193,0,0,0,0,0,0,2022-03-21 11:51:32.015552
46198,0,0,0,0,0,0,2022-03-21 11:51:33.217309
46222,0,0,0,0,0,0,2022-03-21 11:51:40.378947
46232,0,0,0,0,0,0,2022-03-21 11:51:44.019471
46243,0,0,0,0,0,0,2022-03-21 11:51:48.23538
46248,0,0,0,0,0,0,2022-03-21 11:51:51.273634
46252,0,0,0,0,0,0,2022-03-21 11:51:52.943007
46350,0,0,0,0,0,0,2022-03-21 11:52:32.078189
46359,0,0,0,0,0,0,2022-03-21 11:52:36.939491
46362,0,0,0,0,0,0,2022-03-21 11:52:38.126561
46372,0,0,0,0,0,0,2022-03-21 11:52:41.987945
46376,0,0,0,0,0,0,2022-03-21 11:52:45.916664
46378,0,0,0,0,0,0,2022-03-21 11:52:47.804452
46380,0,0,0,0,0,0,2022-03-21 11:52:49.351188
46708,0,0,0,0,0,0,2022-03-21 11:55:17.824758
46719,0,0,0,0,0,0,2022-03-21 11:55:22.061486
46720,0,0,0,0,0,0,2022-03-21 11:55:22.968173
46819,0,0,0,0,0,0,2022-03-21 11:56:19.112467
46832,0,0,0,0,0,0,2022-03-21 11:56:24.353316
46833,0,0,0,0,0,0,2022-03-21 11:56:25.228241
46836,0,0,0,0,0,0,2022-03-21 11:56:26.357464
46839,0,0,0,0,0,0,2022-03-21 11:56:27.585367
46853,0,0,0,0,0,0,2022-03-21 11:56:32.32268
46871,0,0,0,0,0,0,2022-03-21 11:56:39.557618
46874,0,0,0,0,0,0,2022-03-21 11:56:40.747291
46881,0,0,0,0,0,0,2022-03-21 11:56:43.731559
46882,0,0,0,0,0,0,2022-03-21 11:56:44.648543
46883,0,0,0,0,0,0,2022-03-21 11:56:45.49903
46912,0,0,0,0,0,0,2022-03-21 11:56:54.34854
46913,0,0,0,0,0,0,2022-03-21 11:56:55.215791
46918,0,0,0,0,0,0,2022-03-21 11:56:57.438052
46939,0,0,0,0,0,0,2022-03-21 11:57:04.649769
46951,0,0,0,0,0,0,2022-03-21 11:57:07.201277
46954,0,0,0,0,0,0,2022-03-21 11:57:08.367706
46960,0,0,0,0,0,0,2022-03-21 11:57:12.201482
46962,0,0,0,0,0,0,2022-03-21 11:57:13.239756
46968,0,0,0,0,0,0,2022-03-21 11:57:16.167311
47081,0,0,0,0,0,0,2022-03-21 11:58:17.117106
47084,0,0,0,0,0,0,2022-03-21 11:58:18.353468
47087,0,0,0,0,0,0,2022-03-21 11:58:19.517808
47112,0,0,0,0,0,0,2022-03-21 11:58:27.899067
47115,0,0,0,0,0,0,2022-03-21 11:58:29.116951
47118,0,0,0,0,0,0,2022-03-21 11:58:30.351509
47127,0,0,0,0,0,0,2022-03-21 11:58:35.210088
47130,0,0,0,0,0,0,2022-03-21 11:58:36.420467
47144,0,0,0,0,0,0,2022-03-21 11:58:42.260345
47157,0,0,0,0,0,0,2022-03-21 11:58:47.735415
47158,0,0,0,0,18479,18479,2022-03-21 11:58:51.256512
47353,0,0,0,0,0,0,2022-03-21 12:00:13.706741
47360,0,0,0,0,0,0,2022-03-21 12:00:15.982329
47363,0,0,0,0,0,0,2022-03-21 12:00:17.214624
47369,0,0,0,0,0,0,2022-03-21 12:00:19.607205
47372,0,0,0,0,0,0,2022-03-21 12:00:21.978558
47375,0,0,0,0,0,0,2022-03-21 12:00:23.191568
47379,0,0,0,0,0,0,2022-03-21 12:00:24.885389
47381,0,0,0,0,0,0,2022-03-21 12:00:26.728939
47385,0,0,0,0,0,0,2022-03-21 12:00:29.243372
47392,0,0,0,0,0,0,2022-03-21 12:00:34.094561
47396,0,0,0,0,0,0,2022-03-21 12:00:36.619474
47563,0,0,0,0,0,0,2022-03-21 12:02:04.214143
47567,0,0,0,0,0,0,2022-03-21 12:02:07.076598
47568,0,0,0,0,0,0,2022-03-21 12:02:07.918464
1,147376,892264,88519,33659,408817,1570635,2022-03-20 19:49:25.381861
5,5421,243685,2401,936,73677,326120,2022-03-20 19:49:25.552183
6,34908,386333,29124,15987,178914,645266,2022-03-20 19:49:27.104998
7,4812,48749,5508,5724,39097,103890,2022-03-20 19:49:27.284128
16,13430,87717,13007,12220,116047,242421,2022-03-20 19:49:33.325627
17,934,14979,916,1263,4453,22545,2022-03-20 19:49:33.547682
18,7989,112871,3886,1665,22073,148484,2022-03-20 19:49:37.167709
19,91447,280596,59731,28094,356276,816144,2022-03-20 19:49:37.340129
20,183697,1944104,80118,117288,92416,2417623,2022-03-20 19:49:37.693683
21,1224843,51,234295,161019,188841,1809049,2022-03-20 19:49:37.860037
26,13415,53649,10850,9069,127168,214151,2022-03-20 19:49:43.50938
47570,0,0,0,0,0,0,2022-03-21 12:02:08.946015
47576,0,0,0,0,0,0,2022-03-21 12:02:11.976264
47577,0,0,0,0,0,0,2022-03-21 12:02:12.872804
27,8440,92743,9260,9889,49898,170230,2022-03-20 19:49:48.752033
28,5731,43343,6211,4988,28449,88722,2022-03-20 19:49:54.225748
29,990,7596,795,683,9006,19070,2022-03-20 19:49:54.407747
30,95021,1060699,45884,26242,277786,1505632,2022-03-20 19:49:54.880007
32,11418,645196,3257,1965,101906,763742,2022-03-20 19:50:01.001807
33,25538,331066,14986,10541,138511,520642,2022-03-20 19:50:01.37163
43,9935,367475,4099,2184,158609,542302,2022-03-20 19:50:01.544412
44,7456,163917,3437,2047,76492,253349,2022-03-20 19:50:01.788937
48,7329,96720,8761,12777,44151,169738,2022-03-20 19:50:02.498764
49,1148,36303,924,962,10371,49708,2022-03-20 19:50:10.736963
51,886,34041,784,1376,8983,46070,2022-03-20 19:50:12.02817
52,1829,34533,2724,2963,12176,54225,2022-03-20 19:50:15.351946
53,4588,63852,4457,6254,23677,102828,2022-03-20 19:50:16.292817
55,634,7434,747,962,5314,15091,2022-03-20 19:50:20.747301
1382,271,4815,186,215,3283,8770,2022-03-20 20:08:45.118663
56,647,8212,732,1313,5653,16557,2022-03-20 19:50:20.948442
57,13244,147982,11650,9428,116232,298536,2022-03-20 19:50:23.809026
58,3131,33906,2733,3428,29307,72505,2022-03-20 19:50:26.956365
59,17179,293567,19486,24213,87756,442201,2022-03-20 19:50:28.04364
61,5489,122812,7843,11531,28724,176399,2022-03-20 19:50:35.273948
63,4236,101261,3270,5945,23743,138455,2022-03-20 19:50:40.670434
64,6203,120326,6320,8355,48577,189781,2022-03-20 19:50:41.426025
47716,0,0,0,0,0,0,2022-03-21 12:03:22.249803
47719,0,0,0,0,0,0,2022-03-21 12:03:23.425194
47723,0,0,0,0,0,0,2022-03-21 12:03:24.629756
47730,0,0,0,0,0,0,2022-03-21 12:03:25.896208
65,2207,77070,2193,1756,15612,98838,2022-03-20 19:50:46.469024
66,15877,154856,17248,14078,89926,291985,2022-03-20 19:50:50.200294
67,7675,87589,6804,7480,61155,170703,2022-03-20 19:50:50.384807
68,11387,153540,12427,11939,62240,251533,2022-03-20 19:50:54.002801
71,19565,283855,17395,15468,115126,451409,2022-03-20 19:50:58.416341
72,6045,217719,4766,3883,41996,274409,2022-03-20 19:51:02.332189
73,5143,188228,4057,2451,43863,243742,2022-03-20 19:51:02.539559
47731,0,0,0,0,0,0,2022-03-21 12:03:27.050173
47741,0,0,0,0,0,0,2022-03-21 12:03:29.5123
47744,0,0,0,0,0,0,2022-03-21 12:03:30.690422
47747,0,0,0,0,0,0,2022-03-21 12:03:32.439004
74,2816,63511,3050,3167,18558,91102,2022-03-20 19:51:03.974983
75,2391,17414,1967,2132,19959,43863,2022-03-20 19:51:07.642698
76,3617,50478,3031,2807,35676,95609,2022-03-20 19:51:10.172481
77,1534,42383,1151,893,14640,60601,2022-03-20 19:51:10.344761
79,12020,161791,10213,14268,62189,260481,2022-03-20 19:51:14.224715
80,9351,60807,6240,3530,32958,112886,2022-03-20 19:51:14.479614
81,2815,49325,1630,891,16697,71358,2022-03-20 19:51:17.746764
83,177,8958,146,158,2942,12381,2022-03-20 19:51:22.247279
84,1190,27457,788,508,8116,38059,2022-03-20 19:51:23.840345
85,4781,37834,2982,1195,15474,62266,2022-03-20 19:51:24.867893
87,615,30905,292,202,8729,40743,2022-03-20 19:51:28.896545
88,491,19058,254,215,6641,26659,2022-03-20 19:51:32.536487
89,1445,11381,1212,682,8824,23544,2022-03-20 19:51:34.981165
90,6771,103119,6515,4827,24397,145629,2022-03-20 19:51:35.167441
91,635,37053,314,279,6340,44621,2022-03-20 19:51:35.658113
92,1755,17577,1833,1081,9674,31920,2022-03-20 19:51:35.830299
95,2728,16651,2537,1596,17266,40778,2022-03-20 19:51:40.005534
96,2984,42293,2735,1763,11639,61414,2022-03-20 19:51:40.226005
97,6487,81059,6887,5340,60808,160581,2022-03-20 19:51:40.470173
98,3792,62797,3824,4468,32942,107823,2022-03-20 19:51:46.995997
99,1255,32465,1271,1696,11738,48425,2022-03-20 19:51:47.359943
100,1787,36223,1587,1868,16665,58130,2022-03-20 19:51:47.597213
101,8088,179994,8603,10577,71905,279167,2022-03-20 19:51:48.62629
2817,192,4320,130,213,2138,6993,2022-03-20 20:28:02.077599
102,4044,63722,4203,5330,19079,96378,2022-03-20 19:51:48.837241
107,1472,17390,1520,1813,12884,35079,2022-03-20 19:51:53.699154
108,313,7598,230,182,3965,12288,2022-03-20 19:51:53.900333
110,1083,9196,931,910,5577,17697,2022-03-20 19:51:59.347989
111,587,7637,771,1042,4013,14050,2022-03-20 19:51:59.82711
112,285,3844,262,612,2988,7991,2022-03-20 19:52:00.265127
113,905,11251,1004,1044,8320,22524,2022-03-20 19:52:00.434328
115,305,6645,339,368,2860,10517,2022-03-20 19:52:00.867179
122,4252,56003,5082,5849,28552,99738,2022-03-20 19:52:02.308621
127,788,11559,979,1249,6018,20593,2022-03-20 19:52:03.492046
133,2951,82184,2261,5714,18571,111681,2022-03-20 19:52:08.773821
134,7341,87975,8168,8731,62104,174319,2022-03-20 19:52:11.952492
135,6258,68292,6952,7231,34988,123721,2022-03-20 19:52:15.081236
136,35767,315793,19584,18629,120792,510565,2022-03-20 19:52:15.292613
137,2582,89226,1006,920,20594,114328,2022-03-20 19:52:16.249013
47748,0,0,0,0,0,0,2022-03-21 12:03:33.916126
47749,0,0,0,0,0,0,2022-03-21 12:03:34.737963
47755,0,0,0,0,0,0,2022-03-21 12:03:36.624372
47771,0,0,0,0,0,0,2022-03-21 12:03:42.76455
138,2814,114398,996,941,17964,137113,2022-03-20 19:52:17.319989
139,2564,105496,974,867,18587,128488,2022-03-20 19:52:17.501587
141,447,5043,498,739,3865,10592,2022-03-20 19:52:22.044452
142,1678,35158,1939,2142,9999,50916,2022-03-20 19:52:22.221822
144,1597,34785,1583,2667,19914,60546,2022-03-20 19:52:26.406204
145,13229,83863,11399,8851,80159,197501,2022-03-20 19:52:26.605685
146,2132,35200,2050,2515,15223,57120,2022-03-20 19:52:26.835723
4121,41,158,23,74,324,620,2022-03-20 20:41:24.140558
149,4597,87054,4277,9609,26153,131690,2022-03-20 19:52:27.531032
156,2983,41564,3469,3213,24109,75338,2022-03-20 19:52:28.651368
163,229,4364,247,479,1724,7043,2022-03-20 19:52:34.646707
164,14714,894484,4200,1729,153458,1068585,2022-03-20 19:52:35.022131
165,4520,48759,4742,4571,46564,109156,2022-03-20 19:52:39.014864
167,3684,44595,3761,3498,32274,87812,2022-03-20 19:52:42.515109
168,2722,46384,2748,3026,22209,77089,2022-03-20 19:52:45.327477
30481,32,245,46,71,558,952,2022-03-20 22:36:44.565984
170,19750,130046,14807,9284,74319,248206,2022-03-20 19:52:48.54062
171,215,1708,182,242,2441,4788,2022-03-20 19:52:52.304798
173,2239,16257,2509,2394,15285,38684,2022-03-20 19:52:55.843207
174,8377,107686,6520,9321,42143,174047,2022-03-20 19:52:59.349844
175,1457,14186,1405,1856,8342,27246,2022-03-20 19:53:02.253112
176,225,3379,154,203,2541,6502,2022-03-20 19:53:05.052111
177,10160,113644,11972,12782,63082,211640,2022-03-20 19:53:08.763884
31235,31,57,18,45,455,606,2022-03-20 22:42:14.414245
178,1362,16504,1448,1703,9356,30373,2022-03-20 19:53:11.954088
179,84,3454,82,77,1567,5264,2022-03-20 19:53:12.150911
180,2254,55831,1911,2577,15591,78164,2022-03-20 19:53:12.41985
181,900,41976,753,646,5972,50247,2022-03-20 19:53:12.682509
185,19303,188364,10528,6101,73008,297304,2022-03-20 19:53:13.427042
190,868,69398,619,502,9689,81076,2022-03-20 19:53:18.494254
191,397,49576,330,196,5035,55534,2022-03-20 19:53:22.470887
192,410,44150,331,205,5213,50309,2022-03-20 19:53:22.65828
193,4106,61371,3188,4513,18411,91589,2022-03-20 19:53:26.639419
194,1007,23330,718,484,10286,35825,2022-03-20 19:53:30.723344
195,4469,118174,2953,4559,32197,162352,2022-03-20 19:53:30.903713
196,1985,63607,1558,2262,13707,83119,2022-03-20 19:53:31.423414
197,1031,12793,1023,1731,6780,23358,2022-03-20 19:53:31.600132
200,1756,10330,1635,1694,9683,25098,2022-03-20 19:53:34.646759
201,767,15036,626,520,8963,25912,2022-03-20 19:53:34.848232
30999,6,25,3,47,63,144,2022-03-21 09:22:59.424528
202,14400,146339,15921,12734,110889,300283,2022-03-20 19:53:35.273838
206,1341,12758,1298,1231,11919,28547,2022-03-20 19:53:38.040259
207,3310,26682,2088,1777,25354,59211,2022-03-20 19:53:39.102831
208,1282,41579,896,648,16441,60846,2022-03-20 19:53:40.055611
209,2539,34263,3213,2677,22035,64727,2022-03-20 19:53:42.332283
210,21697,110313,25155,19257,46654,223076,2022-03-20 19:53:42.675647
215,102,1329,70,81,745,2327,2022-03-20 19:53:47.367452
47832,0,0,0,0,0,0,2022-03-21 12:04:03.126401
47835,0,0,0,0,0,0,2022-03-21 12:04:04.306917
216,76,1582,56,69,871,2654,2022-03-20 19:53:51.076789
218,2611,22011,2339,1897,19388,48246,2022-03-20 19:53:53.942934
222,864,9923,821,1005,6665,19278,2022-03-20 19:53:57.026378
223,47982,717120,33490,29324,60171,888087,2022-03-20 19:53:57.290533
225,12241,480722,8787,24283,32074,558107,2022-03-20 19:53:57.536289
230,1759,18401,1710,3192,10451,35513,2022-03-20 19:54:01.54348
231,355,2906,346,528,3016,7151,2022-03-20 19:54:04.187592
47856,0,0,0,0,0,0,2022-03-21 12:04:10.299813
47862,0,0,0,0,0,0,2022-03-21 12:04:12.677991
232,27441,239805,23889,16028,78490,385653,2022-03-20 19:54:04.513493
233,1510,12239,1944,1615,5334,22642,2022-03-20 19:54:04.942698
234,202,1987,181,310,1161,3841,2022-03-20 19:54:08.570397
235,137944,2,64273,42277,56869,301365,2022-03-20 19:54:08.741724
236,686,8519,857,1084,4310,15456,2022-03-20 19:54:08.926403
238,3002,32280,3015,3087,19015,60399,2022-03-20 19:54:12.594517
239,11175,76148,9710,6982,118134,222149,2022-03-20 19:54:13.654471
240,6099,82851,5280,4895,64750,163875,2022-03-20 19:54:15.201102
242,1408,24677,1108,1118,11661,39972,2022-03-20 19:54:15.961186
243,2991,81020,2535,5511,18995,111052,2022-03-20 19:54:19.012496
244,425,2198,548,661,3123,6955,2022-03-20 19:54:22.205134
245,55341,391441,39344,21401,198610,706137,2022-03-20 19:54:25.574672
246,5530,44460,6984,7638,27682,92294,2022-03-20 19:54:26.012483
248,3626,67682,2857,4743,27803,106711,2022-03-20 19:54:27.504578
33295,0,0,0,0,2628,2628,2022-03-21 09:33:10.703534
47869,0,0,0,0,0,0,2022-03-21 12:04:15.162011
47879,0,0,0,0,0,0,2022-03-21 12:04:16.344907
249,69982,367552,64439,53703,141233,696909,2022-03-20 19:54:27.765402
251,10219,40985,9815,9541,31834,102394,2022-03-20 19:54:28.187149
258,505,7771,405,531,6983,16195,2022-03-20 19:54:29.362012
266,671,7700,486,594,5667,15118,2022-03-20 19:54:30.696344
273,1069,8204,1013,1076,12921,24283,2022-03-20 19:54:31.872614
280,204,695,297,384,1018,2598,2022-03-20 19:54:33.04726
287,6238,69350,2689,3000,21681,102958,2022-03-20 19:54:34.485655
33319,7,27,3,38,60,135,2022-03-21 09:33:28.629616
293,736,12227,692,1210,5773,20638,2022-03-20 19:54:35.463234
300,793,14934,670,809,7850,25056,2022-03-20 19:54:36.640572
307,51,611,53,153,257,1125,2022-03-20 19:54:39.779721
308,875,4152,866,929,11742,18564,2022-03-20 19:54:39.989582
314,106,1109,100,107,1094,2516,2022-03-20 19:54:41.725655
322,7405,107900,5089,5114,62573,188081,2022-03-20 19:54:42.701572
335,1648,19631,1912,2073,10923,36187,2022-03-20 19:54:45.027998
340,1236,11754,794,869,7963,22616,2022-03-20 19:54:46.986726
343,4088,33927,4526,5214,22723,70478,2022-03-20 19:54:50.95579
345,2267,19972,1787,1586,24684,50296,2022-03-20 19:54:53.896777
346,589,7055,482,680,5738,14544,2022-03-20 19:54:56.954975
347,336,3546,369,489,2549,7289,2022-03-20 19:54:57.234295
348,647,9292,870,1505,5296,17610,2022-03-20 19:55:00.16986
349,255,1823,168,269,2538,5053,2022-03-20 19:55:00.345713
351,710,13732,562,502,2894,18400,2022-03-20 19:55:03.769246
352,615,13175,609,725,3383,18507,2022-03-20 19:55:03.969192
355,22085,308359,19727,22721,127695,500587,2022-03-20 19:55:07.86382
356,35066,591322,22951,27362,176568,853269,2022-03-20 19:55:08.309983
357,4333,132808,3039,6004,34813,180997,2022-03-20 19:55:08.749156
358,780,13138,632,639,9052,24241,2022-03-20 19:55:13.129459
359,138,2680,99,131,2034,5082,2022-03-20 19:55:14.196675
360,251,2344,260,330,2338,5523,2022-03-20 19:55:17.81645
361,190,2761,170,236,2746,6103,2022-03-20 19:55:20.025527
47883,0,0,0,0,0,0,2022-03-21 12:04:19.267178
47886,0,0,0,0,0,0,2022-03-21 12:04:21.124016
47889,0,0,0,0,0,0,2022-03-21 12:04:22.346794
362,108,2046,100,80,1342,3676,2022-03-20 19:55:24.816649
363,97,1610,94,80,1273,3154,2022-03-20 19:55:27.072664
364,750,3514,751,705,7334,13054,2022-03-20 19:55:27.251204
366,1226,17157,861,1490,9420,30154,2022-03-20 19:55:30.746789
367,63,1445,71,94,791,2464,2022-03-20 19:55:32.783854
369,5930,33713,4878,4890,63303,112714,2022-03-20 19:55:32.971429
371,791,78762,500,291,10348,90692,2022-03-20 19:55:36.528361
372,1251,89025,626,439,13838,105179,2022-03-20 19:55:36.73193
377,334,5667,217,355,3271,9844,2022-03-20 19:55:41.202335
378,87,3239,65,69,1173,4633,2022-03-20 19:55:44.491138
379,5196,49919,7161,7710,30173,100159,2022-03-20 19:55:44.689673
380,353,16742,295,228,3854,21472,2022-03-20 19:55:44.954252
381,354,14476,317,222,3734,19103,2022-03-20 19:55:45.491113
384,11260,201450,8131,15775,86135,322751,2022-03-20 19:55:49.144588
385,1645,11550,1916,2876,18834,36821,2022-03-20 19:55:50.177485
33913,14,40,3,43,59,159,2022-03-21 09:40:53.498189
386,521,3692,464,412,3628,8717,2022-03-20 19:55:52.97589
387,10929,104354,8980,6030,113144,243437,2022-03-20 19:55:56.339345
388,1237,12939,980,1113,7203,23472,2022-03-20 19:55:56.519539
389,2214,32880,2345,2062,21225,60726,2022-03-20 19:55:58.124
390,4287,64088,3534,4628,31276,107813,2022-03-20 19:55:58.310986
391,573,13321,566,399,6895,21754,2022-03-20 19:55:58.842747
392,61362,302768,48226,22059,149007,583422,2022-03-20 19:55:59.296584
34304,69,681,30,78,706,1564,2022-03-21 09:46:00.931319
397,599,14517,440,294,5874,21724,2022-03-20 19:56:04.210914
398,406,11245,218,155,4437,16461,2022-03-20 19:56:05.356209
399,73,1754,56,89,1168,3140,2022-03-20 19:56:08.008617
400,6893,70671,5684,3381,52254,138883,2022-03-20 19:56:10.600208
401,1225,59228,738,459,15825,77475,2022-03-20 19:56:10.780136
402,44,901,35,46,669,1695,2022-03-20 19:56:14.037818
403,1235,18102,852,1239,7831,29259,2022-03-20 19:56:14.266367
404,1055,19171,791,1147,9826,31990,2022-03-20 19:56:17.036327
405,1417,74743,738,627,23066,100591,2022-03-20 19:56:19.881932
406,474,8141,425,840,3997,13877,2022-03-20 19:56:20.060637
407,1511,16427,1677,1300,10844,31759,2022-03-20 19:56:22.74715
408,587,52129,318,200,9855,63089,2022-03-20 19:56:25.854794
411,3426,38024,3731,3790,22113,71084,2022-03-20 19:56:28.998957
412,2574,46190,2856,4741,16657,73018,2022-03-20 19:56:31.6669
413,797,48771,283,985,10401,61237,2022-03-20 19:56:34.620595
415,579,28083,439,479,10938,40518,2022-03-20 19:56:37.465403
416,2149,167459,1025,584,33912,205129,2022-03-20 19:56:37.653159
417,1707,28604,1819,3599,10395,46124,2022-03-20 19:56:38.136171
418,228,16071,188,122,3225,19834,2022-03-20 19:56:38.391484
421,384,5385,414,535,3941,10659,2022-03-20 19:56:38.990782
428,189,10311,113,95,2578,13286,2022-03-20 19:56:40.439658
433,4896,106393,2384,1354,82241,197268,2022-03-20 19:56:43.880923
435,2680,33325,2667,2400,18576,59648,2022-03-20 19:56:44.542384
446,271,4782,351,464,3682,9550,2022-03-20 19:56:47.295412
454,250,14378,231,361,4662,19882,2022-03-20 19:56:51.94492
455,1291,8363,1364,1236,17803,30057,2022-03-20 19:56:52.157367
457,63986,264661,48694,22959,324610,724910,2022-03-20 19:56:53.14033
459,1783,89432,511,448,10761,102935,2022-03-20 19:56:53.627192
465,606,51984,478,286,8578,61932,2022-03-20 19:56:54.571609
473,278,3532,289,347,2407,6853,2022-03-20 19:56:55.887517
481,22084,265653,20028,21031,18983,347779,2022-03-20 19:57:00.005166
47898,0,0,0,0,0,0,2022-03-21 12:04:25.986494
482,10631,141800,10880,14714,12675,190700,2022-03-20 19:57:00.214534
483,1453,8610,1555,1334,15503,28455,2022-03-20 19:57:00.475775
484,166,6033,148,121,2703,9171,2022-03-20 19:57:01.531263
486,14725,98578,9832,5819,138542,267496,2022-03-20 19:57:02.124023
492,293,12722,173,124,3354,16666,2022-03-20 19:57:05.418964
493,233,10031,134,131,2972,13501,2022-03-20 19:57:05.626155
495,1130,7715,1067,1240,8009,19161,2022-03-20 19:57:05.790248
501,727,13845,677,1132,2654,19035,2022-03-20 19:57:06.640561
508,2205,27926,4443,10594,7490,52658,2022-03-20 19:57:07.777136
509,1021,24368,1004,1514,7816,35723,2022-03-20 19:57:10.182358
510,308,1897,248,313,2847,5613,2022-03-20 19:57:10.435706
516,8254,24037,11214,9684,15224,68413,2022-03-20 19:57:11.466455
523,10307,777078,2989,1380,108269,900023,2022-03-20 19:57:12.895069
529,3319,42952,3333,4000,36182,89786,2022-03-20 19:57:13.841998
536,272,17794,209,126,3989,22390,2022-03-20 19:57:15.254533
544,327,6370,147,96,5434,12374,2022-03-20 19:57:18.123568
548,713,19232,362,360,12370,33037,2022-03-20 19:57:24.343951
550,7809,167676,6202,8517,22367,212571,2022-03-20 19:57:24.796333
551,2590,47627,996,851,10861,62925,2022-03-20 19:57:25.242757
552,10191,317064,7945,9343,20409,364952,2022-03-20 19:57:25.948847
553,2060,29715,1794,2327,15670,51566,2022-03-20 19:57:26.116957
558,1235,55622,578,586,7352,65373,2022-03-20 19:57:27.031539
565,1283,48391,631,386,23008,73699,2022-03-20 19:57:28.451658
35169,6,17,1,40,35,99,2022-03-21 09:57:24.367934
571,137,1507,100,179,1386,3309,2022-03-20 19:57:35.37789
573,1247,17165,1192,1235,8279,29118,2022-03-20 19:57:39.680962
574,161,1414,150,210,1664,3599,2022-03-20 19:57:39.890621
576,1372,20351,1022,1466,8437,32648,2022-03-20 19:57:42.343921
578,7756,417741,3442,1533,129375,559847,2022-03-20 19:57:48.324439
579,1074,19707,959,1319,9292,32351,2022-03-20 19:57:48.540731
580,130,3981,142,291,1382,5926,2022-03-20 19:57:51.648236
581,299,5751,173,168,2967,9358,2022-03-20 19:57:52.059012
582,787,3398,721,673,5970,11549,2022-03-20 19:57:52.371717
584,3824,32810,4272,3429,40335,84670,2022-03-20 19:57:54.916704
586,2558,27613,2416,1862,31124,65573,2022-03-20 19:57:58.506295
587,2494,58090,1729,1518,30354,94185,2022-03-20 19:57:59.544938
588,274,9221,182,246,2929,12852,2022-03-20 19:57:59.724256
593,1838,13150,1736,1518,21819,40061,2022-03-20 19:58:02.1747
600,335,5793,259,747,3860,10994,2022-03-20 19:58:03.369174
607,359,1881,400,535,3420,6595,2022-03-20 19:58:04.523498
615,592,7271,501,571,6384,15319,2022-03-20 19:58:08.151864
616,220,913,230,258,2000,3621,2022-03-20 19:58:11.760811
618,1388,20303,1093,1666,13207,37657,2022-03-20 19:58:14.914745
619,110,2556,63,56,1393,4178,2022-03-20 19:58:17.802804
620,1153,10586,1031,998,10715,24483,2022-03-20 19:58:17.980181
621,734,8452,691,739,7550,18166,2022-03-20 19:58:20.356435
623,285,1656,304,399,3056,5700,2022-03-20 19:58:23.276108
624,895,10825,568,1231,5082,18601,2022-03-20 19:58:23.51501
625,104,1344,74,106,1156,2784,2022-03-20 19:58:23.770643
626,456,3262,453,541,3057,7769,2022-03-20 19:58:24.029689
632,115,4313,103,125,1667,6323,2022-03-20 19:58:29.182241
633,502,4633,341,364,5293,11133,2022-03-20 19:58:29.448197
634,3167,33682,2105,3025,36455,78434,2022-03-20 19:58:32.438697
636,360,5503,346,316,3663,10188,2022-03-20 19:58:35.911536
637,549,11818,363,532,4461,17723,2022-03-20 19:58:36.386162
641,224,14022,218,143,3080,17687,2022-03-20 19:58:38.626911
642,245,13951,240,149,3478,18063,2022-03-20 19:58:38.812929
644,383,21215,422,265,7109,29394,2022-03-20 19:58:40.423905
645,371,17010,198,181,4344,22104,2022-03-20 19:58:40.603906
647,118,1653,84,102,1387,3344,2022-03-20 19:58:41.286166
655,222,4321,211,192,2440,7386,2022-03-20 19:58:42.427691
661,126,1622,94,130,1236,3208,2022-03-20 19:58:43.811839
669,272,7106,257,290,3373,11298,2022-03-20 19:58:47.976857
670,1555,22316,1251,1853,12466,39441,2022-03-20 19:58:48.416547
671,320,3390,387,554,3227,7878,2022-03-20 19:58:50.830514
673,202,8121,215,177,2696,11411,2022-03-20 19:58:51.006131
675,145,1514,121,169,1537,3486,2022-03-20 19:58:52.926721
676,95,1026,64,116,925,2226,2022-03-20 19:58:53.147818
678,676,5477,621,628,5425,12827,2022-03-20 19:58:57.342951
679,144,3212,92,105,1591,5144,2022-03-20 19:58:57.56852
681,63,1213,29,43,611,1959,2022-03-20 19:58:57.841046
682,625,7442,525,768,4633,13993,2022-03-20 19:58:58.338436
685,297,4472,264,327,3120,8480,2022-03-20 19:58:58.840144
710,2746,69297,2161,2257,30189,106650,2022-03-20 19:59:07.530604
712,620,8585,628,672,4229,14734,2022-03-20 19:59:08.314607
714,179,1155,218,257,1492,3301,2022-03-20 19:59:12.111669
715,176,2677,109,119,1840,4921,2022-03-20 19:59:12.322125
718,301,3334,203,266,2571,6675,2022-03-20 19:59:12.578855
719,761,26105,400,687,6636,34589,2022-03-20 19:59:15.401486
721,7299,70678,7671,5559,56481,147688,2022-03-20 19:59:18.023363
722,108,3822,70,118,1620,5738,2022-03-20 19:59:20.661956
723,77,2367,63,86,1033,3626,2022-03-20 19:59:21.104181
725,65,1698,34,56,799,2652,2022-03-20 19:59:23.67189
727,226,469,215,208,1411,2529,2022-03-20 19:59:24.112634
729,330,1021,278,236,2514,4379,2022-03-20 19:59:26.166649
730,179,4941,97,241,1693,7151,2022-03-20 19:59:28.491295
731,884,50655,424,332,13165,65460,2022-03-20 19:59:28.72336
732,1084,53691,521,438,17030,72764,2022-03-20 19:59:29.236472
733,254,7851,141,230,2307,10783,2022-03-20 19:59:29.427631
743,1685,76055,794,477,28234,107245,2022-03-20 19:59:34.251617
744,307,2094,275,400,1949,5025,2022-03-20 19:59:34.51131
746,793,40913,253,787,4364,47110,2022-03-20 19:59:34.773988
750,383,4830,430,671,3768,10082,2022-03-20 19:59:35.511105
759,4374,152175,1801,742,84863,243955,2022-03-20 19:59:36.713339
760,420,14572,268,236,5731,21227,2022-03-20 19:59:39.89792
761,617,68598,422,353,8198,78188,2022-03-20 19:59:40.388406
762,1138,99877,595,421,12886,114917,2022-03-20 19:59:40.564098
769,268,5822,224,241,2593,9148,2022-03-20 19:59:44.236361
771,232,2903,276,283,3281,6975,2022-03-20 19:59:47.569818
773,164,1657,102,128,2081,4132,2022-03-20 19:59:50.169264
776,348,4521,390,519,2790,8568,2022-03-20 19:59:52.204223
777,69385,479953,39627,20554,190786,800305,2022-03-20 19:59:52.547992
779,634,58116,219,252,3722,62943,2022-03-20 19:59:52.895723
780,480,51637,214,253,3432,56016,2022-03-20 19:59:53.06535
785,611,15755,366,289,10685,27706,2022-03-20 19:59:53.707044
793,865,44060,559,296,14785,60565,2022-03-20 19:59:56.967484
796,54,963,28,67,724,1836,2022-03-20 19:59:59.462735
797,182,6895,143,123,1869,9212,2022-03-20 20:00:00.326102
798,508,4825,422,445,6743,12943,2022-03-20 20:00:03.612907
799,239,2291,272,425,2750,5977,2022-03-20 20:00:03.797206
800,1360,11010,1220,1323,16833,31746,2022-03-20 20:00:04.031292
801,7944,123290,5941,2356,68777,208308,2022-03-20 20:00:04.297092
811,740,15484,624,576,7076,24500,2022-03-20 20:00:07.592207
812,1078,12432,1111,1624,12242,28487,2022-03-20 20:00:07.81184
813,41788,925597,23269,28014,53668,1072336,2022-03-20 20:00:08.220916
816,420,5444,353,663,3234,10114,2022-03-20 20:00:08.711284
834,1088,90538,643,395,13622,106286,2022-03-20 20:00:11.063051
842,672,5924,386,531,5110,12623,2022-03-20 20:00:14.858051
844,136,5398,118,107,2086,7845,2022-03-20 20:00:15.075983
845,4406,36872,4521,5410,21758,72967,2022-03-20 20:00:15.333913
849,33238,537223,27029,22691,213005,833186,2022-03-20 20:00:19.401731
850,2718,39045,2317,4024,14228,62332,2022-03-20 20:00:22.811553
852,1888,4384,1243,829,11098,19442,2022-03-20 20:00:25.410244
853,45443,753482,32002,29994,128969,989890,2022-03-20 20:00:25.900316
854,940,10392,769,1407,7447,20955,2022-03-20 20:00:26.078204
857,12667,217457,11403,16327,67693,325547,2022-03-20 20:00:31.844978
859,2115,62091,2653,4673,8372,79904,2022-03-20 20:00:32.55127
48135,0,0,0,0,0,0,2022-03-21 12:06:28.825229
48144,0,0,0,0,0,0,2022-03-21 12:06:32.028744
861,15439,134391,14977,12722,106476,284005,2022-03-20 20:00:39.365557
863,1493,17065,1321,2185,12169,34233,2022-03-20 20:00:39.841846
864,199,7996,142,167,3066,11570,2022-03-20 20:00:43.220463
865,333,1022,252,206,2981,4794,2022-03-20 20:00:46.875189
866,262,13144,208,124,4400,18138,2022-03-20 20:00:47.057308
867,273,13060,209,129,4113,17784,2022-03-20 20:00:47.316521
868,252,13430,210,122,4107,18121,2022-03-20 20:00:50.304506
873,2394,43805,3050,3753,17413,70415,2022-03-20 20:00:58.432218
874,4136,153858,4091,4496,12520,179101,2022-03-20 20:01:01.559221
879,1783,12432,1828,2240,20756,39039,2022-03-20 20:01:13.290303
880,1769,46096,1688,1258,11017,61828,2022-03-20 20:01:16.669631
881,247,23007,214,220,2891,26579,2022-03-20 20:01:19.194596
882,510,19380,323,234,7369,27816,2022-03-20 20:01:20.183432
883,415,17680,320,204,6835,25454,2022-03-20 20:01:20.358427
884,356,11708,188,180,4981,17413,2022-03-20 20:01:22.932698
885,2931,58492,1200,616,53681,116920,2022-03-20 20:01:27.332993
886,1263,36087,971,1392,8214,47927,2022-03-20 20:01:30.174918
887,73,3212,42,65,1080,4472,2022-03-20 20:01:32.150054
888,607,13096,758,1250,4852,20563,2022-03-20 20:01:32.825744
889,39969,514154,27903,18077,251737,851840,2022-03-20 20:01:33.228191
890,1190,6142,1139,805,9351,18627,2022-03-20 20:01:36.32002
891,518,48719,334,297,5711,55579,2022-03-20 20:01:38.886106
892,395,43900,305,261,5451,50312,2022-03-20 20:01:41.809385
893,481,46163,332,270,6231,53477,2022-03-20 20:01:42.062427
894,662,102453,335,278,5258,108986,2022-03-20 20:01:42.70349
896,824,112406,352,313,5725,119620,2022-03-20 20:01:47.300657
897,636,98559,338,291,5665,105489,2022-03-20 20:01:50.196189
898,803,120733,358,293,5779,127966,2022-03-20 20:01:50.378651
899,623,105570,349,254,5389,112185,2022-03-20 20:01:52.041863
900,620,100763,348,279,5751,107761,2022-03-20 20:01:55.158593
901,1002,134257,395,325,6159,142138,2022-03-20 20:01:55.43656
37142,88,0,34,44,74,240,2022-03-21 10:20:07.131629
902,594,98899,343,266,5733,105835,2022-03-20 20:01:55.615202
903,774,108905,366,292,5883,116220,2022-03-20 20:01:57.62707
905,896,122856,365,299,6116,130532,2022-03-20 20:01:58.488274
908,915,47568,862,491,16464,66300,2022-03-20 20:02:01.755835
911,135,4213,124,96,1977,6545,2022-03-20 20:02:09.095246
913,398,1619,336,474,2580,5407,2022-03-20 20:02:14.518717
914,1045,4874,763,1088,7857,15627,2022-03-20 20:02:14.705717
916,1477,25744,1206,1803,12432,42662,2022-03-20 20:02:17.955965
917,488,10797,187,104,6743,18319,2022-03-20 20:02:18.21106
918,178856,279665,105544,46601,312840,923506,2022-03-20 20:02:18.46506
925,177,2130,156,201,930,3594,2022-03-20 20:02:19.244243
938,167,3279,68,119,1519,5152,2022-03-20 20:02:21.601245
958,790,7228,980,1087,6869,16954,2022-03-20 20:02:24.07401
966,27011,7,15110,15824,12175,70127,2022-03-20 20:02:27.865688
967,12365,38095,10454,6288,47952,115154,2022-03-20 20:02:28.913255
968,207,1051,137,142,1809,3346,2022-03-20 20:02:29.086023
975,1127,15104,505,284,15635,32655,2022-03-20 20:02:34.849012
976,485,9845,239,143,6316,17028,2022-03-20 20:02:35.04152
978,639,6334,410,345,5416,13144,2022-03-20 20:02:37.949629
979,158,12457,94,86,1935,14730,2022-03-20 20:02:40.091144
980,249,1497,254,420,2268,4688,2022-03-20 20:02:40.262864
981,448,20462,361,267,4279,25817,2022-03-20 20:02:42.688588
982,274,7209,294,499,3454,11730,2022-03-20 20:02:43.134655
983,48,1802,66,58,898,2872,2022-03-20 20:02:45.458641
984,508,38260,305,298,5422,44793,2022-03-20 20:02:45.819125
985,789,87932,296,283,4995,94295,2022-03-20 20:02:45.987818
986,608,85061,297,260,4660,90886,2022-03-20 20:02:47.924007
987,593,59890,311,379,5580,66753,2022-03-20 20:02:50.070101
989,36,340,17,41,433,867,2022-03-20 20:02:53.01211
991,317,3180,148,257,2129,6031,2022-03-20 20:02:56.687404
992,514,10609,462,537,4330,16452,2022-03-20 20:02:58.890148
993,96,3906,74,73,902,5051,2022-03-20 20:03:02.308408
994,72,1612,40,54,1090,2868,2022-03-20 20:03:04.867267
995,912,34950,566,443,5483,42354,2022-03-20 20:03:07.408993
996,2438,74019,2000,1232,20153,99842,2022-03-20 20:03:11.094785
997,553,40478,351,270,7304,48956,2022-03-20 20:03:12.733491
998,1216,12354,1180,1292,10791,26833,2022-03-20 20:03:15.335092
999,146,3615,159,118,1964,6002,2022-03-20 20:03:19.118779
1001,41,1224,42,28,468,1803,2022-03-20 20:03:22.244517
1002,2291,40510,1392,964,25034,70191,2022-03-20 20:03:22.503357
1003,378,20591,364,215,4065,25613,2022-03-20 20:03:25.981977
1005,468,7047,580,820,3181,12096,2022-03-20 20:03:26.792282
1006,422,16675,211,155,4319,21782,2022-03-20 20:03:27.056383
1008,262,13148,212,156,3645,17423,2022-03-20 20:03:31.426317
1010,238,11500,180,120,3161,15199,2022-03-20 20:03:32.399106
1011,353,12743,233,171,3885,17385,2022-03-20 20:03:32.60534
1013,3057,15424,3512,3397,29175,54565,2022-03-20 20:03:33.037048
1020,255,5554,183,231,3724,9947,2022-03-20 20:03:40.135218
1021,712,4361,656,885,5686,12300,2022-03-20 20:03:40.355402
1022,302,4198,313,367,3639,8819,2022-03-20 20:03:40.622056
1024,102,3596,71,83,1449,5301,2022-03-20 20:03:45.353507
1025,1255,8592,1056,1072,16075,28050,2022-03-20 20:03:45.87858
1026,127,1779,72,89,1888,3955,2022-03-20 20:03:46.142184
1028,236,5222,168,141,5595,11362,2022-03-20 20:03:48.203458
1029,1867,79000,1071,794,35953,118685,2022-03-20 20:03:48.399555
1036,103,2954,79,114,1576,4826,2022-03-20 20:03:52.293962
1037,338,3559,285,549,3847,8578,2022-03-20 20:03:52.722296
1039,108,2083,71,74,1204,3540,2022-03-20 20:03:55.34352
1041,194,8901,88,178,2409,11770,2022-03-20 20:03:59.718223
1042,160,8020,69,178,1646,10073,2022-03-20 20:04:02.231503
1043,327,10845,289,267,5762,17490,2022-03-20 20:04:02.413504
1044,129,4653,87,104,2481,7454,2022-03-20 20:04:05.309037
1045,967,12157,876,1215,8042,23257,2022-03-20 20:04:05.487539
1046,330,8253,333,269,2757,11942,2022-03-20 20:04:05.74234
1047,441,21596,175,105,8044,30361,2022-03-20 20:04:05.999626
1051,1576,27907,962,991,19711,51147,2022-03-20 20:04:06.719268
1060,2944,21801,2213,2151,17398,46507,2022-03-20 20:04:08.014628
1069,306,4074,297,332,1811,6820,2022-03-20 20:04:09.180968
1078,262,23566,241,176,5347,29592,2022-03-20 20:04:12.815895
1080,792,7439,530,534,7530,16825,2022-03-20 20:04:13.729663
1082,759,5499,660,1024,5641,13583,2022-03-20 20:04:17.699345
1083,159,914,152,173,2101,3499,2022-03-20 20:04:20.126833
1084,208,6096,190,201,2684,9379,2022-03-20 20:04:20.298667
1085,473,6060,313,300,5661,12807,2022-03-20 20:04:23.291818
1086,1092,9320,846,867,7882,20007,2022-03-20 20:04:25.608657
1088,5404,39613,4018,2368,43602,95005,2022-03-20 20:04:31.55518
1089,948,25497,432,293,14210,41380,2022-03-20 20:04:32.514947
1090,623,25624,306,239,6429,33221,2022-03-20 20:04:34.913609
1094,434,25216,331,226,5812,32019,2022-03-20 20:04:44.292203
1095,952,21537,379,189,15419,38476,2022-03-20 20:04:44.9908
1096,787,17332,307,176,11185,29787,2022-03-20 20:04:47.438531
1097,602,4008,357,625,4244,9836,2022-03-20 20:04:50.306695
1098,433,5047,452,766,2804,9502,2022-03-20 20:04:52.467135
1099,56,1118,32,78,782,2066,2022-03-20 20:04:52.662521
1100,179,1465,120,131,2605,4500,2022-03-20 20:04:55.271226
1101,249,11145,169,118,2913,14594,2022-03-20 20:04:55.459447
1102,104,2087,69,132,1266,3658,2022-03-20 20:04:57.323338
1103,970,5370,668,852,7956,15816,2022-03-20 20:04:57.499156
1104,299,4099,206,187,2781,7572,2022-03-20 20:04:59.622964
1105,116,3547,82,110,2131,5986,2022-03-20 20:05:01.810177
1106,186,4749,98,138,3948,9119,2022-03-20 20:05:03.940974
1107,1249,21517,428,300,18932,42426,2022-03-20 20:05:04.149187
1108,630,8470,645,846,5399,15990,2022-03-20 20:05:04.691202
1109,161,6127,131,195,3334,9948,2022-03-20 20:05:07.334841
1110,1069,31078,1208,1473,4855,39683,2022-03-20 20:05:07.539803
1111,158,4535,107,125,2196,7121,2022-03-20 20:05:10.239439
1112,155,4639,106,123,2125,7148,2022-03-20 20:05:12.48278
1115,92,2090,46,59,1330,3617,2022-03-20 20:05:14.793324
1116,138,2572,70,93,2888,5761,2022-03-20 20:05:17.056901
1118,843,154825,267,305,4189,160429,2022-03-20 20:05:20.835564
1119,697,132645,286,349,4137,138114,2022-03-20 20:05:23.885605
1122,476,96068,279,276,4345,101444,2022-03-20 20:05:32.853527
1123,299,4577,371,379,1649,7275,2022-03-20 20:05:35.635713
1124,164,5381,109,79,2269,8002,2022-03-20 20:05:35.81599
1126,541,3639,653,537,6736,12106,2022-03-20 20:05:36.064652
1127,890,9134,744,988,6744,18500,2022-03-20 20:05:40.187104
1128,312,5803,241,208,2391,8955,2022-03-20 20:05:40.364777
1129,95,2290,71,61,987,3504,2022-03-20 20:05:40.625121
1132,2865,122558,3002,4935,9003,142363,2022-03-20 20:05:45.821793
1135,241,7282,167,117,3603,11410,2022-03-20 20:05:49.439905
1136,661,4708,770,840,6404,13383,2022-03-20 20:05:50.919944
1137,490,9692,579,701,3071,14533,2022-03-20 20:05:51.093976
1138,1995,38435,2383,3231,7003,53047,2022-03-20 20:05:54.931029
1139,36,352,28,98,241,755,2022-03-20 20:05:56.647216
1141,157,3207,90,127,3133,6714,2022-03-20 20:06:00.295954
1144,268,10961,193,113,3481,15016,2022-03-20 20:06:04.784632
1145,620,3134,530,549,7951,12784,2022-03-20 20:06:05.031988
1146,254,10706,159,131,3067,14317,2022-03-20 20:06:05.301134
1152,354,5686,258,175,3220,9693,2022-03-20 20:06:08.522438
1153,468,4083,378,428,4623,9980,2022-03-20 20:06:08.962033
1154,46,656,24,41,531,1298,2022-03-20 20:06:10.572197
1155,96,821,79,91,914,2001,2022-03-20 20:06:10.757047
1159,65,935,52,48,566,1666,2022-03-20 20:06:15.642908
1161,326,2281,378,420,2606,6011,2022-03-20 20:06:18.576915
1162,101,1705,80,93,1077,3056,2022-03-20 20:06:20.779308
1163,784,2959,778,823,6774,12118,2022-03-20 20:06:20.963811
1164,949,10465,909,815,6553,19691,2022-03-20 20:06:21.192032
1165,164,2822,128,132,1998,5244,2022-03-20 20:06:23.230546
1166,135,2179,107,103,1653,4177,2022-03-20 20:06:23.404009
1169,172,2671,130,85,2629,5687,2022-03-20 20:06:28.480364
1170,293,13556,270,142,3850,18111,2022-03-20 20:06:30.522625
1171,321,13909,265,162,4292,18949,2022-03-20 20:06:32.414197
1174,480,10440,275,234,7456,18885,2022-03-20 20:06:34.884838
1175,158,1190,150,205,2043,3746,2022-03-20 20:06:35.404388
1176,90,787,36,67,820,1800,2022-03-20 20:06:35.574566
1179,387,2049,352,304,3446,6538,2022-03-20 20:06:36.121678
1186,347,3960,340,509,3289,8445,2022-03-20 20:06:37.34406
1194,856,9677,1030,1335,6320,19218,2022-03-20 20:06:40.699892
1198,793,9614,677,927,6530,18541,2022-03-20 20:06:48.627008
1199,1730,0,1008,1395,2198,6331,2022-03-20 20:06:48.836701
1200,375,924,333,682,4773,7087,2022-03-20 20:06:50.860868
1202,232,8930,150,147,3351,12810,2022-03-20 20:06:51.046866
1203,205,3888,115,98,4372,8678,2022-03-20 20:06:51.319884
1204,147,4397,65,73,3298,7980,2022-03-20 20:06:51.571255
1209,175,4812,93,85,3447,8612,2022-03-20 20:06:52.440771
1218,1703,29029,1282,1920,11706,45640,2022-03-20 20:06:56.633519
1219,1139,9402,1337,1698,6298,19874,2022-03-20 20:06:56.822711
1220,239,6236,139,130,4476,11220,2022-03-20 20:06:57.078719
1221,1709,14157,2347,4216,7631,30060,2022-03-20 20:06:57.596144
1228,114,1841,69,94,1252,3370,2022-03-20 20:07:00.676165
1230,1026,12338,1133,1178,9817,25492,2022-03-20 20:07:03.113747
1232,164,4989,150,165,2074,7542,2022-03-20 20:07:05.692748
1234,126,2463,114,120,1144,3967,2022-03-20 20:07:09.383571
1236,149,877,192,239,894,2351,2022-03-20 20:07:10.212685
1237,424,21468,320,220,5799,28231,2022-03-20 20:07:14.101328
1238,406,20281,309,224,5813,27033,2022-03-20 20:07:14.274178
1240,367,30545,294,208,6006,37420,2022-03-20 20:07:17.404749
1241,302,17215,195,175,4067,21954,2022-03-20 20:07:17.918427
1243,1720,10509,1913,2430,12595,29167,2022-03-20 20:07:18.179599
1246,488,3835,422,563,5905,11213,2022-03-20 20:07:18.741599
1253,842,37601,576,411,5683,45113,2022-03-20 20:07:19.894101
1260,207,11666,134,122,2625,14754,2022-03-20 20:07:21.083747
1268,100,1533,100,102,1453,3288,2022-03-20 20:07:22.244757
1280,421,5232,422,498,4195,10768,2022-03-20 20:07:25.819088
1281,17397,75049,12215,6364,50955,161980,2022-03-20 20:07:26.281532
1283,79,2415,76,88,1165,3823,2022-03-20 20:07:27.84566
1286,124,5552,77,71,1565,7389,2022-03-20 20:07:33.133749
1287,93,1444,81,81,1332,3031,2022-03-20 20:07:35.514785
1288,1360,13467,798,432,13707,29764,2022-03-20 20:07:35.693084
1289,338,4164,203,117,3993,8815,2022-03-20 20:07:35.943735
1290,178,6572,129,114,3552,10545,2022-03-20 20:07:36.210784
1296,114,3910,62,63,1313,5462,2022-03-20 20:07:39.117497
1297,92,3411,59,53,1196,4811,2022-03-20 20:07:41.489928
1299,870,4377,981,1022,11474,18724,2022-03-20 20:07:44.512502
1300,175,1300,229,294,1672,3670,2022-03-20 20:07:46.414641
1301,387,8948,221,179,7539,17274,2022-03-20 20:07:46.585093
1302,200,4468,142,121,3379,8310,2022-03-20 20:07:46.857183
1303,1193,55175,680,610,15213,72871,2022-03-20 20:07:47.122866
1314,104,702,83,134,955,1978,2022-03-20 20:07:49.33002
1316,552,10906,306,597,2288,14649,2022-03-20 20:07:52.977104
1324,298,4840,262,373,3993,9766,2022-03-20 20:07:55.505824
1327,728,7146,655,736,3656,12921,2022-03-20 20:07:58.266691
1329,103,1283,55,52,1758,3251,2022-03-20 20:08:00.353614
1333,33,448,50,132,218,881,2022-03-20 20:08:02.550967
1336,207,5073,166,190,2035,7671,2022-03-20 20:08:05.158789
1337,194,804,198,385,2013,3594,2022-03-20 20:08:07.560186
1338,198,3270,89,100,2641,6298,2022-03-20 20:08:09.518634
1341,282,6508,120,159,3830,10899,2022-03-20 20:08:14.81818
1342,235,5987,101,130,3016,9469,2022-03-20 20:08:15.036087
1343,153,5091,80,121,2142,7587,2022-03-20 20:08:16.899101
1346,516,7484,283,275,6365,14923,2022-03-20 20:08:23.537198
1347,2478,16475,1561,1167,20705,42386,2022-03-20 20:08:24.587737
1348,294,5713,183,144,3593,9927,2022-03-20 20:08:27.027303
1349,449,5132,356,559,4015,10511,2022-03-20 20:08:27.210302
1350,610,6208,266,219,8079,15382,2022-03-20 20:08:27.470465
1356,973,15256,759,484,9900,27372,2022-03-20 20:08:28.456428
1366,458,41489,213,230,3431,45821,2022-03-20 20:08:32.440101
1367,554,44766,249,295,4061,49925,2022-03-20 20:08:32.822444
1368,162,11996,127,120,2267,14672,2022-03-20 20:08:32.986081
1369,229,15706,128,140,2292,18495,2022-03-20 20:08:33.531128
1374,986,11069,841,939,6406,20241,2022-03-20 20:08:36.802548
1375,608,7362,506,496,5242,14214,2022-03-20 20:08:37.003031
1376,317,6257,202,237,2089,9102,2022-03-20 20:08:39.365721
1377,165,1625,166,129,1987,4072,2022-03-20 20:08:41.109248
1378,119,3009,72,83,1501,4784,2022-03-20 20:08:41.281341
1379,1061,31060,588,271,18568,51548,2022-03-20 20:08:41.804033
1380,224,6757,151,153,3225,10510,2022-03-20 20:08:44.673873
1381,66,2038,54,89,1241,3488,2022-03-20 20:08:44.853721
1392,68,1439,37,74,707,2325,2022-03-20 20:08:52.365716
1393,65,1438,39,74,730,2346,2022-03-20 20:08:52.590971
1394,75,1274,48,66,789,2252,2022-03-20 20:08:52.849463
1395,77,1287,44,73,776,2257,2022-03-20 20:08:54.249926
1398,298,6878,245,174,4679,12274,2022-03-20 20:08:54.99761
1414,106,3491,94,87,2174,5952,2022-03-20 20:08:58.15814
1415,123,4539,106,87,2228,7083,2022-03-20 20:08:58.362358
1418,180,6035,116,115,3020,9466,2022-03-20 20:09:05.188874
1419,172,6659,125,124,2880,9960,2022-03-20 20:09:07.275172
1420,121,3497,99,87,2035,5839,2022-03-20 20:09:07.464286
1421,104,3635,83,83,2018,5923,2022-03-20 20:09:10.649141
1422,118,3640,95,104,2317,6274,2022-03-20 20:09:11.003016
1423,101,3269,93,88,2038,5589,2022-03-20 20:09:11.264217
1424,114,3484,101,96,2275,6070,2022-03-20 20:09:11.785289
1426,859,7407,674,429,9288,18657,2022-03-20 20:09:12.197882
1427,87,3029,86,94,1912,5208,2022-03-20 20:09:16.168934
1428,105,2874,69,87,1752,4887,2022-03-20 20:09:16.343961
1429,103,3083,89,89,2077,5441,2022-03-20 20:09:17.320635
1430,1355,81034,540,353,17421,100703,2022-03-20 20:09:17.516626
1434,98,3810,89,92,2046,6135,2022-03-20 20:09:18.228272
1444,150,2631,147,178,1454,4560,2022-03-20 20:09:24.625141
1445,592,7529,862,1532,2860,13375,2022-03-20 20:09:26.906108
1448,546,6391,673,952,2612,11174,2022-03-20 20:09:27.104769
1450,539,3334,522,505,6653,11553,2022-03-20 20:09:27.841475
1451,109,2589,50,96,1238,4082,2022-03-20 20:09:30.252363
1453,4605,17022,3550,2468,33200,60845,2022-03-20 20:09:33.663637
1454,3147,20707,2426,2414,38210,66904,2022-03-20 20:09:33.884649
1456,173,1742,199,304,1827,4245,2022-03-20 20:09:36.321993
1457,1036,5670,792,758,10926,19182,2022-03-20 20:09:36.579205
1458,136,897,115,192,1401,2741,2022-03-20 20:09:38.573798
1459,787,6177,739,600,6303,14606,2022-03-20 20:09:39.015278
1460,124,2239,95,106,1297,3861,2022-03-20 20:09:39.218105
1468,342,9767,145,116,5289,15659,2022-03-20 20:09:42.913229
1469,1305,27573,1987,3313,5806,39984,2022-03-20 20:09:43.167474
1472,518,10566,336,265,6341,18026,2022-03-20 20:09:45.501148
1473,625,10139,378,316,7191,18649,2022-03-20 20:09:46.454586
1477,175,4046,120,93,2695,7129,2022-03-20 20:09:47.218565
1484,241,4314,111,150,3142,7958,2022-03-20 20:09:48.643003
1490,546,3392,593,609,5726,10866,2022-03-20 20:09:49.664563
1498,2977,69599,2802,3201,18502,97081,2022-03-20 20:09:56.655735
1500,444,4924,267,317,3640,9592,2022-03-20 20:09:59.050784
1501,97,4700,75,94,1690,6656,2022-03-20 20:10:01.367408
1502,295,2793,273,356,3047,6764,2022-03-20 20:10:01.919927
1504,122,5968,112,106,2162,8470,2022-03-20 20:10:07.24706
1506,611,43826,251,287,4357,49332,2022-03-20 20:10:13.616569
1508,414,2408,388,629,4191,8030,2022-03-20 20:10:13.827973
1509,784,15670,761,1157,4571,22943,2022-03-20 20:10:16.602227
1514,169,4349,146,135,1939,6738,2022-03-20 20:10:16.768835
1515,134,1736,79,74,1307,3330,2022-03-20 20:10:19.078906
1516,2534,12624,3021,4149,6108,28436,2022-03-20 20:10:19.513857
1520,2784,12513,1742,1297,16535,34871,2022-03-20 20:10:27.278816
1524,776,4089,812,635,10097,16409,2022-03-20 20:10:32.187897
1525,174,18631,171,182,3140,22298,2022-03-20 20:10:35.732435
1526,518,98523,269,276,4248,103834,2022-03-20 20:10:38.378777
1528,69,889,50,76,769,1853,2022-03-20 20:10:44.089968
1529,86,1314,67,103,1137,2707,2022-03-20 20:10:45.924811
1530,7974,158929,7359,6629,70938,251829,2022-03-20 20:10:46.11632
1531,488,24521,388,208,7908,33513,2022-03-20 20:10:46.38098
1532,1683,30202,1383,2328,11222,46818,2022-03-20 20:10:46.649495
1536,7091,97352,6866,8881,41888,162078,2022-03-20 20:10:47.386133
1543,1885,19916,1280,1346,13070,37497,2022-03-20 20:10:51.232654
1544,120,2190,89,104,1280,3783,2022-03-20 20:10:51.455676
1546,4555,44912,4047,5132,27398,86044,2022-03-20 20:10:56.624897
38932,4,143,0,9,47,203,2022-03-21 10:45:55.556338
1547,30,214,31,143,261,679,2022-03-20 20:10:56.809558
1549,103,1767,89,109,2049,4117,2022-03-20 20:11:00.086612
1550,419,3921,438,665,2529,7972,2022-03-20 20:11:02.521484
1552,42,445,27,57,464,1035,2022-03-20 20:11:04.067857
1553,240,3031,208,153,2936,6568,2022-03-20 20:11:04.242916
1554,735,11973,896,975,8413,22992,2022-03-20 20:11:06.771333
1555,1797,18411,1497,1840,11514,35059,2022-03-20 20:11:07.00211
1556,735,8310,467,440,9130,19082,2022-03-20 20:11:07.527805
1557,3270,24045,2614,2418,19874,52221,2022-03-20 20:11:10.43034
1559,14576,183918,8778,7534,58114,272920,2022-03-20 20:11:13.790085
1560,173,1742,93,114,1429,3551,2022-03-20 20:11:16.638914
1561,358,3441,347,656,3127,7929,2022-03-20 20:11:18.604886
1562,6829,95461,5739,7265,32181,147475,2022-03-20 20:11:21.219429
1564,3783,142263,4018,6755,9963,166782,2022-03-20 20:11:27.012422
1565,3931,101493,3958,6808,8967,125157,2022-03-20 20:11:27.211492
39126,3,25,1,28,32,89,2022-03-21 10:48:29.77463
1566,1692,60444,957,407,28594,92094,2022-03-20 20:11:27.719585
1569,2619,32314,1866,2454,19953,59206,2022-03-20 20:11:28.48544
1570,1488,19932,1256,1968,9540,34184,2022-03-20 20:11:33.28604
1571,8860,115524,7582,7575,73254,212795,2022-03-20 20:11:36.00545
1572,283,3317,431,612,2309,6952,2022-03-20 20:11:38.076118
1573,708,6087,716,855,4064,12430,2022-03-20 20:11:38.255875
1575,90512,1462510,52109,38145,298923,1942199,2022-03-20 20:11:40.869125
1578,562,4882,355,484,4508,10791,2022-03-20 20:11:44.221204
1579,3497,62040,2915,3955,20012,92419,2022-03-20 20:11:46.801115
1580,87,884,48,64,898,1981,2022-03-20 20:11:46.977731
1581,1173,17807,904,1369,8871,30124,2022-03-20 20:11:47.264244
1582,101,1536,56,83,941,2717,2022-03-20 20:11:47.523893
1589,4367,27699,4559,4991,38654,80270,2022-03-20 20:11:48.700464
1597,252,2215,341,513,1768,5089,2022-03-20 20:11:49.900178
1611,92,1655,66,102,1147,3062,2022-03-20 20:11:53.796068
1619,376,13611,267,185,4606,19045,2022-03-20 20:11:54.665581
1628,420,4155,307,460,3831,9173,2022-03-20 20:12:00.715079
1630,83,2234,77,99,1265,3758,2022-03-20 20:12:03.079974
1631,201,7279,167,200,3992,11839,2022-03-20 20:12:03.341938
1637,232,8646,116,174,4075,13243,2022-03-20 20:12:05.960075
1638,142,2395,166,218,1153,4074,2022-03-20 20:12:07.877206
1640,366,13771,292,773,4389,19591,2022-03-20 20:12:08.143475
1641,94,1321,44,49,938,2446,2022-03-20 20:12:10.054017
1642,2047,19981,2045,2066,9626,35765,2022-03-20 20:12:10.2252
1643,63,908,33,63,625,1692,2022-03-20 20:12:10.47795
1644,76,982,44,62,818,1982,2022-03-20 20:12:12.005185
1645,193,2909,135,139,2315,5691,2022-03-20 20:12:13.712675
1647,354,4758,149,312,4382,9955,2022-03-20 20:12:16.846613
1648,132,3638,104,91,1707,5672,2022-03-20 20:12:17.060685
1650,1261,7643,1051,710,13638,24303,2022-03-20 20:12:17.317112
1651,272,3363,206,195,3451,7487,2022-03-20 20:12:17.587404
1656,21,173,14,82,138,428,2022-03-20 20:12:18.327622
1663,339,3961,356,360,4161,9177,2022-03-20 20:12:21.678226
1664,168,1312,122,228,1363,3193,2022-03-20 20:12:23.409388
1665,78,1178,66,114,927,2363,2022-03-20 20:12:25.06209
1666,86,525,90,155,778,1634,2022-03-20 20:12:26.517001
1667,96,708,76,166,906,1952,2022-03-20 20:12:28.475057
1668,645,38241,650,1298,3157,43991,2022-03-20 20:12:31.222181
1670,112,8185,92,154,1460,10003,2022-03-20 20:12:35.024983
1671,83,982,59,55,982,2161,2022-03-20 20:12:37.122598
1672,83,1614,92,211,679,2679,2022-03-20 20:12:37.31484
1673,56,964,50,126,523,1719,2022-03-20 20:12:38.051485
1674,501,22595,393,629,2532,26650,2022-03-20 20:12:41.186867
1675,303,6135,287,579,1142,8446,2022-03-20 20:12:43.451211
1676,197,2259,179,236,2084,4955,2022-03-20 20:12:43.635068
1677,50,1169,54,66,865,2204,2022-03-20 20:12:45.334266
1678,1553,13430,2534,2416,9937,29870,2022-03-20 20:12:48.665092
1679,201,7733,172,148,2064,10318,2022-03-20 20:12:48.838813
1681,791,24688,440,291,13886,40096,2022-03-20 20:12:51.850307
1682,468,9109,440,536,5740,16293,2022-03-20 20:12:52.053785
1683,379,2664,561,717,2333,6654,2022-03-20 20:12:52.303351
1684,171,1819,155,229,1253,3627,2022-03-20 20:12:54.59284
1685,521,15369,633,2465,2456,21444,2022-03-20 20:12:57.115104
1686,2196,226395,947,603,17360,247501,2022-03-20 20:12:59.878739
1688,818,10682,844,1255,7802,21401,2022-03-20 20:13:00.051409
1689,14786,620265,7375,5649,180065,828140,2022-03-20 20:13:00.575451
1691,18310,289841,13381,17610,79686,418828,2022-03-20 20:13:08.312597
1692,242,6541,168,276,2476,9703,2022-03-20 20:13:10.962227
1693,428,3158,415,718,3488,8207,2022-03-20 20:13:11.14419
1694,1081,7183,1123,1776,10311,21474,2022-03-20 20:13:11.41052
1695,1297,9713,1283,1035,11949,25277,2022-03-20 20:13:11.680937
1703,586,2892,369,587,6210,10644,2022-03-20 20:13:18.796119
1704,514,3445,378,500,4804,9641,2022-03-20 20:13:19.006614
1706,406,4073,449,431,3996,9355,2022-03-20 20:13:21.434916
1707,619,9994,672,1168,2516,14969,2022-03-20 20:13:21.892212
1708,142,804,82,150,1074,2252,2022-03-20 20:13:23.545552
1709,401,65125,217,199,3836,69778,2022-03-20 20:13:23.722275
1719,712,47317,536,394,8858,57817,2022-03-20 20:13:27.544076
1720,193,3674,162,127,2354,6510,2022-03-20 20:13:30.222179
1721,794,9125,763,1076,7306,19064,2022-03-20 20:13:30.773354
1722,6052,52127,4239,4342,27138,93898,2022-03-20 20:13:30.946588
1726,10439,197593,8866,12629,53766,283293,2022-03-20 20:13:37.449977
1727,1725,13253,1252,1627,12445,30302,2022-03-20 20:13:40.63077
1728,1388,8027,1755,1632,5729,18531,2022-03-20 20:13:40.807774
1729,611,12590,419,337,6462,20419,2022-03-20 20:13:41.080296
1731,1862,28605,1484,1205,16641,49797,2022-03-20 20:13:41.342033
1739,58,123,63,109,284,637,2022-03-20 20:13:45.195803
1740,86,291,66,134,823,1400,2022-03-20 20:13:49.687867
1741,49,1023,39,56,508,1675,2022-03-20 20:13:49.869722
1742,148,936,103,142,1505,2834,2022-03-20 20:13:50.134985
1743,125,2084,187,601,1161,4158,2022-03-20 20:13:52.544468
1744,1045,9068,1576,1736,3774,17199,2022-03-20 20:13:54.892203
1745,46,305,38,85,460,934,2022-03-20 20:13:56.34271
1746,297,6582,368,816,2387,10450,2022-03-20 20:13:56.52958
1747,821,8812,646,575,11364,22218,2022-03-20 20:13:56.795792
1748,91,1272,100,106,929,2498,2022-03-20 20:13:58.561355
1749,213,11236,157,187,2252,14045,2022-03-20 20:13:58.73611
1750,299,9995,168,192,2570,13224,2022-03-20 20:14:01.051328
1751,56,5324,54,78,1037,6549,2022-03-20 20:14:01.235715
1752,62,2164,42,72,858,3198,2022-03-20 20:14:03.670714
1754,72,2167,40,78,635,2992,2022-03-20 20:14:04.466111
1757,47,2584,30,67,578,3306,2022-03-20 20:14:06.645132
1758,42,1153,36,59,625,1915,2022-03-20 20:14:06.840742
1761,243,5179,129,97,3307,8955,2022-03-20 20:14:09.98037
1762,949,7705,695,843,9528,19720,2022-03-20 20:14:10.203843
1764,244,12223,173,143,3827,16610,2022-03-20 20:14:12.695621
1766,94,1354,44,56,1106,2654,2022-03-20 20:14:15.011231
1767,161,2220,69,79,2293,4822,2022-03-20 20:14:17.491482
1768,80,1653,64,78,812,2687,2022-03-20 20:14:18.425519
1769,211,2683,210,669,1200,4973,2022-03-20 20:14:18.58959
1771,104,922,60,95,832,2013,2022-03-20 20:14:20.463513
1772,76,908,43,101,783,1911,2022-03-20 20:14:22.047563
1773,273,6421,151,121,3502,10468,2022-03-20 20:14:22.227298
1774,49,1483,51,48,782,2413,2022-03-20 20:14:22.40313
1775,341,1549,228,353,3886,6357,2022-03-20 20:14:23.799049
1776,31,681,12,43,342,1109,2022-03-20 20:14:25.43608
1777,151,2764,72,64,2272,5323,2022-03-20 20:14:25.627
1778,191,1668,153,201,1497,3710,2022-03-20 20:14:26.364362
1794,112,2652,79,55,1416,4314,2022-03-20 20:14:27.282768
1803,119,2790,79,51,1704,4743,2022-03-20 20:14:31.169932
1804,387,3480,282,307,4457,8913,2022-03-20 20:14:31.392887
1806,201,1690,212,282,1556,3941,2022-03-20 20:14:32.088809
1816,3040,48301,3740,6210,6053,67344,2022-03-20 20:14:33.413847
1828,60,920,31,71,797,1879,2022-03-20 20:14:38.152392
1829,1270,98821,887,615,24860,126453,2022-03-20 20:14:40.934714
1831,89,1360,50,52,1003,2554,2022-03-20 20:14:43.960671
1832,184,2795,112,131,1937,5159,2022-03-20 20:14:47.254103
1835,611,7179,617,681,3010,12098,2022-03-20 20:14:49.61588
1836,1395,32675,1274,2084,14927,52355,2022-03-20 20:14:51.904714
1837,252,2403,216,286,2308,5465,2022-03-20 20:14:53.98016
1838,661,17830,277,518,5090,24376,2022-03-20 20:14:54.198407
1839,51,716,77,169,349,1362,2022-03-20 20:14:57.621321
1840,10247,395459,5573,6220,43581,461080,2022-03-20 20:14:59.813501
1841,108,5891,82,68,1460,7609,2022-03-20 20:15:00.095396
1842,1192,53312,567,565,7359,62995,2022-03-20 20:15:03.990895
1843,57,2081,50,46,736,2970,2022-03-20 20:15:06.851116
1844,593,5998,834,800,4640,12865,2022-03-20 20:15:07.028563
1845,251,1643,244,223,2058,4419,2022-03-20 20:15:09.133204
1846,518,4323,461,430,5099,10831,2022-03-20 20:15:11.18655
1847,172,19970,197,85,2733,23157,2022-03-20 20:15:13.565494
1848,187,731,153,205,1556,2832,2022-03-20 20:15:14.028617
1849,54,429,43,63,594,1183,2022-03-20 20:15:15.556288
1851,25,323,21,45,351,765,2022-03-20 20:15:17.691287
1852,3324,29497,3266,3029,32430,71546,2022-03-20 20:15:17.969871
1853,479,2667,527,504,4481,8658,2022-03-20 20:15:18.211213
1857,112,1024,75,79,1553,2843,2022-03-20 20:15:18.955905
1864,501,4490,321,370,4406,10088,2022-03-20 20:15:20.157133
1874,97,3715,87,90,1111,5100,2022-03-20 20:15:24.506158
1878,231,2900,216,262,2831,6440,2022-03-20 20:15:24.712272
1879,327,4884,111,89,4253,9664,2022-03-20 20:15:24.975154
1880,122,3452,58,58,1337,5027,2022-03-20 20:15:28.686742
1881,329,3034,293,366,3174,7196,2022-03-20 20:15:30.894499
1882,143,2033,103,127,1586,3992,2022-03-20 20:15:31.120423
1883,84,983,78,183,659,1987,2022-03-20 20:15:33.713226
1884,135,1001,137,246,906,2425,2022-03-20 20:15:33.927336
1885,117,516,118,244,879,1874,2022-03-20 20:15:34.38538
1887,35402,331191,35763,41800,147534,591690,2022-03-20 20:15:37.922942
1888,423,17510,297,188,4465,22883,2022-03-20 20:15:38.135156
1889,18302,286802,13496,10810,107517,436927,2022-03-20 20:15:41.415649
1890,158,8925,100,85,3152,12420,2022-03-20 20:15:44.711246
1891,91,896,69,131,722,1909,2022-03-20 20:15:44.897346
48156,0,0,0,0,0,0,2022-03-21 12:06:35.69471
48159,0,0,0,0,0,0,2022-03-21 12:06:36.852788
1892,36,562,25,65,316,1004,2022-03-20 20:15:45.932249
1893,127,1226,129,243,888,2613,2022-03-20 20:15:49.676293
1894,463,63135,211,241,4164,68214,2022-03-20 20:15:49.867332
1898,109,1925,60,58,944,3096,2022-03-20 20:15:51.821527
1899,181,1034,149,199,1333,2896,2022-03-20 20:15:53.451105
1900,54,950,45,60,549,1658,2022-03-20 20:15:53.738715
1901,192,5134,111,118,4382,9937,2022-03-20 20:15:56.387175
1903,51,853,35,52,574,1565,2022-03-20 20:15:58.878777
1904,113,1330,74,89,1507,3113,2022-03-20 20:15:59.128486
1905,91,1353,58,88,1041,2631,2022-03-20 20:16:00.886734
1906,177,2450,101,117,2679,5524,2022-03-20 20:16:01.0606
1915,1893,31607,1871,1585,12987,49943,2022-03-20 20:16:02.624677
1922,139,3878,103,94,2160,6374,2022-03-20 20:16:03.762525
1929,749,9670,707,659,4033,15818,2022-03-20 20:16:04.960201
1938,85,754,42,55,867,1803,2022-03-20 20:16:10.566469
1939,78,1325,76,151,1038,2668,2022-03-20 20:16:10.7793
1940,235,4035,108,85,2449,6912,2022-03-20 20:16:13.330764
1941,443,3517,402,529,5210,10101,2022-03-20 20:16:15.370899
1942,314,3225,287,340,3674,7840,2022-03-20 20:16:15.554182
1943,8006,289230,3386,1729,144671,447022,2022-03-20 20:16:16.540818
1944,520,7861,306,364,4103,13154,2022-03-20 20:16:19.072902
1947,120,465,88,140,1064,1877,2022-03-20 20:16:21.439418
1949,53,2411,33,47,654,3198,2022-03-20 20:16:23.755036
1951,885,13449,354,179,12911,27778,2022-03-20 20:16:24.260493
1952,568,8489,396,358,6409,16220,2022-03-20 20:16:26.479098
1953,840,33688,919,835,11526,47808,2022-03-20 20:16:26.679711
1954,303,9319,303,248,4139,14312,2022-03-20 20:16:26.916884
1956,2715,47705,1939,2459,17771,72589,2022-03-20 20:16:29.091307
1957,151,3658,120,132,1369,5430,2022-03-20 20:16:31.269265
1958,78,5757,48,55,1334,7272,2022-03-20 20:16:33.115553
1959,94,734,49,72,1234,2183,2022-03-20 20:16:33.300146
1960,740,0,384,889,891,2904,2022-03-20 20:16:34.573535
1961,381,13098,229,256,7245,21209,2022-03-20 20:16:37.469769
1962,101,644,64,121,917,1847,2022-03-20 20:16:37.884599
1965,3360,54943,3165,3238,30845,95551,2022-03-20 20:16:38.475264
1967,198,7729,156,163,3218,11464,2022-03-20 20:16:38.900875
1978,151,5690,87,65,3079,9072,2022-03-20 20:16:42.299335
1979,75,2556,32,52,1104,3819,2022-03-20 20:16:44.335904
1980,380,7656,235,205,6267,14743,2022-03-20 20:16:46.613365
1981,175,3082,102,101,3294,6754,2022-03-20 20:16:46.789269
1982,29,2735,22,55,413,3254,2022-03-20 20:16:49.275626
1983,93,2529,84,84,1676,4466,2022-03-20 20:16:50.889244
1986,90,441,62,121,762,1476,2022-03-20 20:16:55.210881
1988,463,4895,468,434,4218,10478,2022-03-20 20:16:57.54238
1989,34,1958,24,59,377,2452,2022-03-20 20:16:58.996567
1990,34,745,22,41,400,1242,2022-03-20 20:17:00.849418
1991,261,2267,213,331,2201,5273,2022-03-20 20:17:01.025716
1992,84,895,53,79,762,1873,2022-03-20 20:17:02.836332
1994,184,7028,178,233,3738,11361,2022-03-20 20:17:06.303368
1996,135,6480,107,110,2461,9293,2022-03-20 20:17:07.184048
1998,199,5649,160,170,2640,8818,2022-03-20 20:17:09.384945
1999,83,1456,70,68,1136,2813,2022-03-20 20:17:09.57437
2000,965,12868,351,163,15903,30250,2022-03-20 20:17:10.053806
2001,83274,923842,64974,49545,294501,1416136,2022-03-20 20:17:10.419248
2009,68,1223,44,67,1013,2415,2022-03-20 20:17:13.517623
2010,110,2549,90,70,1661,4480,2022-03-20 20:17:15.454414
2011,212,3153,155,118,2173,5811,2022-03-20 20:17:15.681961
2013,188,4594,123,91,2647,7643,2022-03-20 20:17:16.982551
2015,70,1259,52,55,895,2331,2022-03-20 20:17:17.41191
2024,66,183,56,131,270,706,2022-03-20 20:17:24.652403
2025,43815,495190,36093,25295,250813,851206,2022-03-20 20:17:24.961918
2026,15840,103867,16966,16615,56738,210026,2022-03-20 20:17:28.291904
2029,120,2127,81,102,2303,4733,2022-03-20 20:17:32.839793
2031,1547,15359,1277,2059,12282,32524,2022-03-20 20:17:36.645415
2032,451,3039,408,600,4176,8674,2022-03-20 20:17:36.936392
2033,209,3532,131,144,4596,8612,2022-03-20 20:17:38.009222
2034,22219,325997,16323,17182,133075,514796,2022-03-20 20:17:38.210217
2036,210,1567,289,297,1352,3715,2022-03-20 20:17:42.677336
2038,301,1421,248,223,1941,4134,2022-03-20 20:17:46.226844
2039,168,707,192,160,1364,2591,2022-03-20 20:17:46.417173
2040,147,485,124,181,1438,2375,2022-03-20 20:17:47.464707
2041,332,5533,594,967,2022,9448,2022-03-20 20:17:47.640128
2042,286,5680,141,99,5291,11497,2022-03-20 20:17:49.933582
2043,1089,7603,1111,1090,6456,17349,2022-03-20 20:17:50.113982
2044,1110,3908,889,617,5718,12242,2022-03-20 20:17:54.834718
2045,43,545,27,64,611,1290,2022-03-20 20:17:55.275813
2046,40,502,28,58,565,1193,2022-03-20 20:17:57.451173
2047,50,2824,22,64,815,3775,2022-03-20 20:17:59.505247
2048,476,3040,291,188,4443,8438,2022-03-20 20:18:01.440201
2049,54,1024,36,61,759,1934,2022-03-20 20:18:01.610454
2051,91,934,80,114,1001,2220,2022-03-20 20:18:04.099857
2052,69,592,36,68,844,1609,2022-03-20 20:18:05.849936
2053,79,1438,54,63,1109,2743,2022-03-20 20:18:06.056596
2055,73,907,40,51,942,2013,2022-03-20 20:18:09.966447
2056,50,1347,33,58,779,2267,2022-03-20 20:18:11.508296
2057,79,1669,40,67,1036,2891,2022-03-20 20:18:11.940579
2058,40,777,25,53,466,1361,2022-03-20 20:18:12.6757
2059,66,673,50,87,748,1624,2022-03-20 20:18:13.939085
2060,163,2956,97,90,2789,6095,2022-03-20 20:18:14.195793
2061,73,1846,51,51,886,2907,2022-03-20 20:18:16.343443
2062,68,1669,50,51,871,2709,2022-03-20 20:18:16.509238
2063,82,1387,49,57,1008,2583,2022-03-20 20:18:17.043627
2067,72,2720,59,54,1189,4094,2022-03-20 20:18:17.695457
2073,45,202,27,49,531,854,2022-03-20 20:18:20.452351
2074,61,376,67,104,597,1205,2022-03-20 20:18:20.920371
2077,108,1553,58,68,1281,3068,2022-03-20 20:18:21.406666
2084,186,1019,141,174,1398,2918,2022-03-20 20:18:22.848666
2096,40,511,15,47,438,1051,2022-03-20 20:18:26.772462
2097,79,1660,45,68,989,2841,2022-03-20 20:18:28.241854
2098,207,4571,128,120,2699,7725,2022-03-20 20:18:28.425748
2099,127,2124,83,72,1783,4189,2022-03-20 20:18:30.194451
2100,88,1532,67,59,1148,2894,2022-03-20 20:18:30.376603
2103,85,1437,33,60,1411,3026,2022-03-20 20:18:30.949423
2110,258,4268,269,273,2369,7437,2022-03-20 20:18:32.371946
2117,190,8960,155,213,1535,11053,2022-03-20 20:18:33.390125
2124,557,24056,492,546,9254,34905,2022-03-20 20:18:37.305979
2125,226,7356,187,172,3916,11857,2022-03-20 20:18:38.347604
2127,114,768,116,156,957,2111,2022-03-20 20:18:43.414151
2129,6829,118216,4302,4455,68794,202596,2022-03-20 20:18:48.527007
2130,4867,34363,4139,4771,25385,73525,2022-03-20 20:18:51.300869
2131,1320,83446,931,947,13670,100314,2022-03-20 20:18:54.136279
2132,274,11720,226,136,4062,16418,2022-03-20 20:18:54.575859
2133,88,1416,57,79,1722,3362,2022-03-20 20:18:54.753225
2141,136,2273,77,83,3451,6020,2022-03-20 20:18:55.025833
2144,1349,168213,716,590,12752,183620,2022-03-20 20:18:55.655479
2153,289,2743,266,415,2721,6434,2022-03-20 20:18:59.090476
2155,1400,7098,974,1500,8890,19862,2022-03-20 20:19:02.818885
2156,2525,77713,1884,4798,5821,92741,2022-03-20 20:19:05.092414
2157,325,2824,259,283,2322,6013,2022-03-20 20:19:09.20856
2158,2434,20083,2311,1994,30421,57243,2022-03-20 20:19:09.406676
2159,5051,46525,4304,2876,33797,92553,2022-03-20 20:19:09.874625
2161,1377,9570,1134,1409,15018,28508,2022-03-20 20:19:10.149153
2165,329,1420,341,413,2353,4856,2022-03-20 20:19:13.535646
2166,896,15910,980,1122,7691,26599,2022-03-20 20:19:16.400087
2167,57737,824636,43086,42621,307339,1275419,2022-03-20 20:19:16.821324
2169,268,4218,223,433,2880,8022,2022-03-20 20:19:17.61362
2170,251,6342,241,158,3256,10248,2022-03-20 20:19:17.886926
2178,419,10365,168,152,5423,16527,2022-03-20 20:19:21.285104
2179,87,1253,61,106,1201,2708,2022-03-20 20:19:21.499273
2180,121,1074,85,98,1474,2852,2022-03-20 20:19:23.267423
2181,88,1386,52,71,962,2559,2022-03-20 20:19:23.461439
2183,145,3019,76,106,1483,4829,2022-03-20 20:19:25.742617
2196,165,2782,65,81,2541,5634,2022-03-20 20:19:30.527982
2198,366,18261,312,201,4939,24079,2022-03-20 20:19:30.742573
2199,188,6301,122,106,4134,10851,2022-03-20 20:19:33.387369
2200,214,1481,187,169,2079,4130,2022-03-20 20:19:33.845338
2201,400,71766,263,274,4238,76941,2022-03-20 20:19:36.330638
2204,558,3389,594,577,5574,10692,2022-03-20 20:19:41.966463
2205,294,9586,219,157,4699,14955,2022-03-20 20:19:42.233704
2207,46,1359,48,51,815,2319,2022-03-20 20:19:46.236935
2211,48,3396,27,44,737,4252,2022-03-20 20:19:51.244124
2213,2001,12928,2486,2079,11649,31143,2022-03-20 20:19:53.826021
2215,396,2305,420,501,2669,6291,2022-03-20 20:19:54.497119
2216,5481,38918,3578,3873,56872,108722,2022-03-20 20:19:57.016991
2219,108,2112,71,121,1718,4130,2022-03-20 20:20:03.760348
2220,141,6433,76,140,1939,8729,2022-03-20 20:20:06.307579
2221,360,3874,404,450,2413,7501,2022-03-20 20:20:06.481196
2222,989,5406,1184,1331,4205,13115,2022-03-20 20:20:09.304392
2223,112,1000,123,204,845,2284,2022-03-20 20:20:09.480891
2224,215,1854,171,223,2153,4616,2022-03-20 20:20:11.609545
2225,968,22252,1032,1237,5880,31369,2022-03-20 20:20:11.796005
2226,19,323,20,94,186,642,2022-03-20 20:20:13.565252
2227,165,3211,169,272,1955,5772,2022-03-20 20:20:16.418412
2228,137,3358,106,208,763,4572,2022-03-20 20:20:18.771446
2229,1168,12427,921,999,5880,21395,2022-03-20 20:20:22.668585
2230,190,1857,223,282,2094,4646,2022-03-20 20:20:22.857769
2231,256,929,204,228,1893,3510,2022-03-20 20:20:25.095618
2232,59,492,27,114,307,999,2022-03-20 20:20:25.271265
2233,65,515,56,102,376,1114,2022-03-20 20:20:25.524045
2234,95,894,173,281,705,2148,2022-03-20 20:20:25.779508
2238,486,13590,277,380,5120,19853,2022-03-20 20:20:27.41937
2244,139,458,103,147,1203,2050,2022-03-20 20:20:29.438186
2248,635,63647,388,305,6394,71369,2022-03-20 20:20:35.856454
2249,125,2878,78,110,1884,5075,2022-03-20 20:20:36.064825
2250,99,1593,37,61,1028,2818,2022-03-20 20:20:36.514278
2251,39532,404862,33722,20810,316279,815205,2022-03-20 20:20:36.777705
2252,1489,7695,989,1332,15231,26736,2022-03-20 20:20:39.913005
2254,332,1115,255,196,2630,4528,2022-03-20 20:20:44.532331
2255,318,1259,236,221,2451,4485,2022-03-20 20:20:47.801387
2256,39,715,30,56,601,1441,2022-03-20 20:20:49.644107
2258,25,444,20,62,305,856,2022-03-20 20:20:51.633525
2260,73,772,81,95,975,1996,2022-03-20 20:20:53.629471
2262,106,3412,50,84,1232,4884,2022-03-20 20:20:58.048318
2263,253,13934,109,136,2092,16524,2022-03-20 20:20:58.253595
2264,81,2467,41,87,1104,3780,2022-03-20 20:20:58.517525
2267,133,4466,119,117,2861,7696,2022-03-20 20:21:00.532672
2269,214,6608,167,209,2773,9971,2022-03-20 20:21:03.092446
2272,44,897,36,70,765,1812,2022-03-20 20:21:04.746899
2273,601,46580,307,236,6472,54196,2022-03-20 20:21:07.074366
2277,154,1473,135,230,1528,3520,2022-03-20 20:21:10.351895
2278,38,1175,32,46,582,1873,2022-03-20 20:21:10.834661
2279,56,2553,28,77,970,3684,2022-03-20 20:21:12.775457
2281,236,5611,377,940,1477,8641,2022-03-20 20:21:15.34988
2282,109,322,85,104,866,1486,2022-03-20 20:21:17.866831
2284,165,3119,146,291,762,4483,2022-03-20 20:21:20.444154
2285,151,2840,188,528,732,4439,2022-03-20 20:21:22.910203
2287,209,2396,249,611,1047,4512,2022-03-20 20:21:28.12711
2288,288,3036,336,508,2488,6656,2022-03-20 20:21:28.336535
2290,80,5868,37,42,1457,7484,2022-03-20 20:21:30.283244
2291,272,3605,149,154,3168,7348,2022-03-20 20:21:32.194363
2292,103,1416,73,88,955,2635,2022-03-20 20:21:33.719567
2293,135,3619,71,73,1958,5856,2022-03-20 20:21:33.909557
2294,240,7285,209,200,2887,10821,2022-03-20 20:21:36.064888
2298,175,10821,137,132,3138,14403,2022-03-20 20:21:36.239891
2300,63,2139,52,87,1332,3673,2022-03-20 20:21:37.164546
2305,64,1712,73,146,1072,3067,2022-03-20 20:21:39.465568
2306,68,1860,60,132,1105,3225,2022-03-20 20:21:40.938918
2308,298,1131,170,260,2280,4139,2022-03-20 20:21:42.949911
2309,85,1956,53,88,978,3160,2022-03-20 20:21:43.217217
2313,156,6284,82,141,2215,8878,2022-03-20 20:21:48.845392
2314,54,345,18,46,584,1047,2022-03-20 20:21:50.538782
2316,98,691,75,225,763,1852,2022-03-20 20:21:50.71879
2317,222,2628,88,162,1943,5043,2022-03-20 20:21:52.774734
2318,43,1100,31,64,553,1791,2022-03-20 20:21:54.3643
2322,173,1891,93,115,1998,4270,2022-03-20 20:21:59.172289
2330,458,7073,416,507,3545,11999,2022-03-20 20:21:59.374406
2331,207,2779,189,261,1570,5006,2022-03-20 20:21:59.639923
2332,372,8014,169,131,4934,13620,2022-03-20 20:22:01.709841
2333,186,1966,200,240,1829,4421,2022-03-20 20:22:01.883744
2335,376,4742,425,423,2290,8256,2022-03-20 20:22:03.747007
2337,282,1138,237,199,2594,4450,2022-03-20 20:22:04.468687
2362,127,604,63,201,1245,2240,2022-03-20 20:22:07.089558
2363,471,21603,723,760,4052,27609,2022-03-20 20:22:09.370413
2364,182,1714,160,315,1652,4023,2022-03-20 20:22:09.818361
2365,64,802,34,53,802,1755,2022-03-20 20:22:11.725154
2366,61,173,31,75,544,884,2022-03-20 20:22:13.081437
2367,1415,10468,1405,2313,11049,26650,2022-03-20 20:22:16.088705
2369,3574,24869,3473,4187,22188,58291,2022-03-20 20:22:18.32479
2382,83,278,62,142,751,1316,2022-03-20 20:22:19.841149
2383,377,3907,312,293,3701,8590,2022-03-20 20:22:22.730327
2384,66,1303,41,57,737,2204,2022-03-20 20:22:24.876404
2386,365,32739,264,259,5278,38905,2022-03-20 20:22:27.936144
2387,113,1765,81,88,2204,4251,2022-03-20 20:22:28.19755
2388,37,300,23,57,622,1039,2022-03-20 20:22:29.99624
2389,553,3481,749,783,3481,9047,2022-03-20 20:22:32.825262
2390,1401,15621,2252,3505,4816,27595,2022-03-20 20:22:35.464524
2391,214,4352,305,1302,1786,7959,2022-03-20 20:22:37.518547
2392,116,10622,49,127,791,11705,2022-03-20 20:22:40.647311
2393,80,6983,48,114,618,7843,2022-03-20 20:22:40.811729
2398,367,42889,246,241,5283,49026,2022-03-20 20:22:44.073554
2399,39,1181,30,75,614,1939,2022-03-20 20:22:44.595798
2400,692,4959,707,642,4575,11575,2022-03-20 20:22:44.757742
2404,5207,79825,5129,7875,33598,131634,2022-03-20 20:22:46.016867
2407,101,4638,68,83,1216,6106,2022-03-20 20:22:48.681609
2408,93,3683,65,93,1219,5153,2022-03-20 20:22:51.071466
2409,760,6559,700,651,5223,13893,2022-03-20 20:22:51.275656
2414,85,1984,62,98,1398,3627,2022-03-20 20:22:54.386388
2415,230,2397,143,216,1174,4160,2022-03-20 20:22:56.659735
2416,130,1236,58,125,631,2180,2022-03-20 20:22:56.949825
2417,165,10902,80,153,1767,13067,2022-03-20 20:23:00.793249
2418,7116,182904,2232,721,104832,297805,2022-03-20 20:23:03.739259
2419,137,2251,75,70,2171,4704,2022-03-20 20:23:06.486754
2420,121,1497,63,61,1704,3446,2022-03-20 20:23:06.688538
2422,82,1307,39,58,1200,2686,2022-03-20 20:23:10.843816
2423,75,1274,35,58,996,2438,2022-03-20 20:23:12.473628
2424,316,20337,298,182,5482,26615,2022-03-20 20:23:14.803648
2427,104,2767,48,90,1821,4830,2022-03-20 20:23:15.23799
2428,40,832,13,57,394,1336,2022-03-20 20:23:16.938353
2429,56,1672,28,69,834,2659,2022-03-20 20:23:18.559606
2448,574,16082,392,275,10001,27324,2022-03-20 20:23:21.206116
2449,761,22928,465,327,12790,37271,2022-03-20 20:23:21.380058
2450,190,6102,72,190,1364,7918,2022-03-20 20:23:23.804701
2451,1257,7118,930,652,8945,18902,2022-03-20 20:23:23.992033
2452,240,4800,135,98,3622,8895,2022-03-20 20:23:24.47963
2454,188,5729,139,121,2418,8595,2022-03-20 20:23:29.057651
2455,71,577,62,81,528,1319,2022-03-20 20:23:30.423066
2456,37,1166,18,50,454,1725,2022-03-20 20:23:31.770297
2457,121,1445,87,101,1067,2821,2022-03-20 20:23:31.960494
2459,120,2889,77,73,1607,4766,2022-03-20 20:23:34.924719
2461,200,2986,76,63,2700,6025,2022-03-20 20:23:38.901281
2462,107,2472,63,104,1095,3841,2022-03-20 20:23:41.51291
2463,288,337,136,77,1610,2448,2022-03-20 20:23:43.988804
2465,103,646,51,100,1326,2226,2022-03-20 20:23:44.434014
2466,55,743,35,40,482,1355,2022-03-20 20:23:44.703973
2467,94,1276,102,261,574,2307,2022-03-20 20:23:48.209896
2468,97,1756,48,59,1696,3656,2022-03-20 20:23:48.387516
2470,139,2688,82,88,1992,4989,2022-03-20 20:23:48.663162
2472,2761,237989,822,631,17529,259732,2022-03-20 20:23:49.108442
2488,322,10375,217,157,7564,18635,2022-03-20 20:23:54.38992
2489,1389,4050,939,710,4872,11960,2022-03-20 20:23:54.610504
2490,305,25751,249,230,4850,31385,2022-03-20 20:23:57.102951
2491,48,1196,43,85,793,2165,2022-03-20 20:23:57.290993
2492,39,1144,36,84,674,1977,2022-03-20 20:24:00.225734
2493,37,1075,41,76,695,1924,2022-03-20 20:24:03.776338
2494,4118,61417,2783,3699,20654,92671,2022-03-20 20:24:03.966898
2495,195,2268,216,356,2082,5117,2022-03-20 20:24:04.207965
2497,435,3859,309,254,3854,8711,2022-03-20 20:24:04.470961
2501,102,520,129,232,614,1597,2022-03-20 20:24:05.187978
2515,122,10761,112,130,1971,13096,2022-03-20 20:24:06.700248
2523,740,4494,488,652,5257,11631,2022-03-20 20:24:09.358233
2527,104,1437,63,79,1082,2765,2022-03-20 20:24:11.662624
2528,113,1121,72,70,1205,2581,2022-03-20 20:24:11.897721
2535,78,1235,69,138,1162,2682,2022-03-20 20:24:12.463564
2545,55,874,50,129,543,1651,2022-03-20 20:24:15.226079
2547,564,11899,453,490,4347,17753,2022-03-20 20:24:17.963132
2548,276,3684,280,312,3087,7639,2022-03-20 20:24:18.233574
2549,241,1562,183,191,2832,5009,2022-03-20 20:24:21.044236
2552,198,487,182,249,1257,2373,2022-03-20 20:24:23.093579
2555,185,1697,137,184,1562,3765,2022-03-20 20:24:26.419302
2556,181,2207,207,370,1104,4069,2022-03-20 20:24:29.075751
2557,302,3827,257,243,2336,6965,2022-03-20 20:24:29.526671
2559,1770,19342,1104,778,20392,43386,2022-03-20 20:24:31.903853
2560,234,4270,148,153,4678,9483,2022-03-20 20:24:34.629468
2561,165,2388,204,332,1044,4133,2022-03-20 20:24:34.866087
2564,692,9439,752,1200,5167,17250,2022-03-20 20:24:38.765594
2565,87,1140,60,196,810,2293,2022-03-20 20:24:40.526549
2567,47,1247,40,169,298,1801,2022-03-20 20:24:42.688888
2568,27,326,27,93,276,749,2022-03-20 20:24:44.083821
2569,157,4644,139,323,995,6258,2022-03-20 20:24:44.265818
2570,85,1383,80,147,811,2506,2022-03-20 20:24:46.207798
2571,136,6741,197,665,700,8439,2022-03-20 20:24:49.019776
2572,85,1700,96,223,790,2894,2022-03-20 20:24:50.933342
2573,85,831,91,125,874,2006,2022-03-20 20:24:51.151191
2574,68,956,55,159,415,1653,2022-03-20 20:24:53.542255
2575,27,591,30,119,169,936,2022-03-20 20:24:53.728653
2576,102,1002,79,187,1046,2416,2022-03-20 20:24:53.980561
2577,260,4286,252,362,2210,7370,2022-03-20 20:24:54.245072
2583,79,2345,48,67,1079,3618,2022-03-20 20:25:01.380961
2584,78,2045,40,64,912,3139,2022-03-20 20:25:01.645579
2585,87,2245,62,63,1357,3814,2022-03-20 20:25:01.897593
2592,147,4370,98,148,2024,6787,2022-03-20 20:25:04.573787
2593,10776,213395,4026,1752,149828,379777,2022-03-20 20:25:06.478406
2594,1535,33802,792,705,24756,61590,2022-03-20 20:25:07.286024
2595,1010,21480,835,1118,10514,34957,2022-03-20 20:25:10.061028
2596,7553,47022,6977,5926,67456,134934,2022-03-20 20:25:13.092912
2598,438,1190,328,230,3306,5492,2022-03-20 20:25:17.521245
2599,37,355,20,51,445,908,2022-03-20 20:25:19.0006
2600,33,329,18,47,409,836,2022-03-20 20:25:20.103455
2601,39,469,24,50,513,1095,2022-03-20 20:25:21.689234
2602,1687,20391,1205,1502,11610,36395,2022-03-20 20:25:22.141558
2603,654,8088,643,875,5616,15876,2022-03-20 20:25:22.331124
2604,1105,10414,1144,1414,8591,22668,2022-03-20 20:25:22.608089
2605,18272,140224,16744,11845,129278,316363,2022-03-20 20:25:26.68779
2606,186,9101,174,170,2913,12544,2022-03-20 20:25:26.871271
2607,146,2649,78,100,2783,5756,2022-03-20 20:25:30.130244
2608,3547,15182,2014,2160,11007,33910,2022-03-20 20:25:30.30824
2611,173,6379,114,144,2505,9315,2022-03-20 20:25:33.309592
2612,72,1089,91,219,343,1814,2022-03-20 20:25:34.998139
2613,74,719,55,104,1068,2020,2022-03-20 20:25:37.481111
2614,45,675,43,88,820,1671,2022-03-20 20:25:38.958654
2615,144,8877,102,106,2023,11252,2022-03-20 20:25:41.346607
2616,43,2738,30,52,897,3760,2022-03-20 20:25:43.263841
2617,171,3270,130,114,2891,6576,2022-03-20 20:25:43.707377
2618,721,7319,488,401,8027,16956,2022-03-20 20:25:46.17824
2619,394,4904,388,635,1930,8251,2022-03-20 20:25:46.372839
2620,152,2907,120,158,926,4263,2022-03-20 20:25:46.626597
2621,135,2504,71,128,2496,5334,2022-03-20 20:25:48.610179
2623,550,6484,268,193,12344,19839,2022-03-20 20:25:52.654287
2624,61,733,50,96,889,1829,2022-03-20 20:25:54.344595
2625,28,1275,21,88,403,1815,2022-03-20 20:25:56.449959
2626,22,810,21,79,326,1258,2022-03-20 20:25:58.689073
2628,24,689,20,77,340,1150,2022-03-20 20:26:00.738888
2629,27,1061,25,84,347,1544,2022-03-20 20:26:01.17162
2630,41,1426,36,93,489,2085,2022-03-20 20:26:01.65862
2631,26,861,22,83,331,1323,2022-03-20 20:26:03.818642
2632,26,898,27,95,348,1394,2022-03-20 20:26:05.126472
2633,26,875,24,84,384,1393,2022-03-20 20:26:06.301809
2634,55,1862,35,98,449,2499,2022-03-20 20:26:10.192947
2639,16,206,12,40,121,395,2022-03-20 20:26:12.862972
2645,25,810,25,75,342,1277,2022-03-20 20:26:15.419846
2646,31,1035,27,70,341,1504,2022-03-20 20:26:15.660621
2647,18,340,13,45,138,554,2022-03-20 20:26:17.280479
2648,68,3386,38,101,732,4325,2022-03-20 20:26:17.73459
2649,40,2038,29,84,437,2628,2022-03-20 20:26:19.458271
2650,34,1205,25,91,416,1771,2022-03-20 20:26:21.015823
2651,30,1572,31,85,424,2142,2022-03-20 20:26:21.191227
2652,37,2189,27,84,420,2757,2022-03-20 20:26:22.981856
2654,57,3739,73,104,565,4538,2022-03-20 20:26:23.821242
2656,69,5538,44,111,564,6326,2022-03-20 20:26:26.408918
2658,42,3193,44,108,584,3971,2022-03-20 20:26:27.597953
2659,53,4279,40,99,483,4954,2022-03-20 20:26:27.857565
2666,46,3244,40,102,510,3942,2022-03-20 20:26:28.890558
2674,53,2679,80,100,772,3684,2022-03-20 20:26:30.215899
2680,361,21426,283,286,4362,26718,2022-03-20 20:26:31.293018
2682,69,1360,49,79,701,2258,2022-03-20 20:26:35.567933
2683,1432,18069,1067,808,12884,34260,2022-03-20 20:26:35.745475
2684,241,5446,187,285,2000,8159,2022-03-20 20:26:36.002289
2685,2189,59460,1418,970,24461,88498,2022-03-20 20:26:39.228786
2686,155,790,213,463,1206,2827,2022-03-20 20:26:39.438861
2688,284,1349,263,291,2579,4766,2022-03-20 20:26:41.936473
2689,38,634,33,56,486,1247,2022-03-20 20:26:42.144952
2690,56,895,25,54,746,1776,2022-03-20 20:26:43.727242
2692,124,1627,96,122,1080,3049,2022-03-20 20:26:45.51858
2693,114,1323,80,114,1594,3225,2022-03-20 20:26:45.951692
2694,147,541,103,130,1895,2816,2022-03-20 20:26:47.674418
2695,183,4587,132,143,3122,8167,2022-03-20 20:26:49.613189
2696,95,1488,61,63,1282,2989,2022-03-20 20:26:51.162311
2697,67,318,62,72,764,1283,2022-03-20 20:26:52.745388
2698,128,1764,68,72,2070,4102,2022-03-20 20:26:54.718337
2699,121,851,94,165,1076,2307,2022-03-20 20:26:55.259401
2700,63,548,55,83,522,1271,2022-03-20 20:26:56.807556
2701,15,86,9,66,91,267,2022-03-20 20:26:57.934372
2702,47,635,35,109,364,1190,2022-03-20 20:26:59.393314
2704,211,1153,250,269,2260,4143,2022-03-20 20:27:01.742993
2705,381,7013,273,552,1501,9720,2022-03-20 20:27:02.015661
2706,172,4193,116,245,731,5457,2022-03-20 20:27:02.275881
2713,240,2870,268,194,2161,5733,2022-03-20 20:27:06.519285
2714,58,515,35,39,603,1250,2022-03-20 20:27:08.101717
2715,58,1180,32,52,1085,2407,2022-03-20 20:27:08.292742
2718,69,720,76,156,749,1770,2022-03-20 20:27:10.484408
2719,262,1275,348,1213,1433,4531,2022-03-20 20:27:12.460971
2722,219,2700,102,86,3818,6925,2022-03-20 20:27:12.630743
2723,149,1042,137,227,1233,2788,2022-03-20 20:27:12.905038
2728,23,2120,7,26,200,2376,2022-03-20 20:27:13.788161
2735,36,133,14,73,198,454,2022-03-20 20:27:16.040319
2740,106,371,58,137,749,1421,2022-03-20 20:27:18.845644
2741,50,231,20,74,348,723,2022-03-20 20:27:19.315879
2744,594,7480,701,978,5806,15559,2022-03-20 20:27:19.80499
2751,288,5097,178,173,5907,11643,2022-03-20 20:27:21.012551
2765,65,1350,32,78,681,2206,2022-03-20 20:27:23.382353
2772,1898,10975,1740,1989,8481,25083,2022-03-20 20:27:24.604847
2781,117,983,104,180,1379,2763,2022-03-20 20:27:28.306109
2782,298,7213,183,217,4194,12105,2022-03-20 20:27:31.285841
2784,131,4977,103,96,1803,7110,2022-03-20 20:27:35.838506
2786,266,999,159,247,1354,3025,2022-03-20 20:27:38.761589
2787,8811,217327,7686,6646,49969,290439,2022-03-20 20:27:38.990713
2789,353,9120,380,1091,1369,12313,2022-03-20 20:27:42.213284
2790,59,1108,22,53,676,1918,2022-03-20 20:27:43.768357
2791,48,1128,14,44,492,1726,2022-03-20 20:27:45.780277
2792,57,1731,33,64,848,2733,2022-03-20 20:27:45.959226
2793,92,1869,54,74,1482,3571,2022-03-20 20:27:46.219462
2795,4197,38907,3623,6045,18155,70927,2022-03-20 20:27:46.487316
2800,1377,15725,1561,1842,5963,26468,2022-03-20 20:27:47.210236
2809,31,186,24,84,165,490,2022-03-20 20:27:53.517803
2810,142,3207,132,204,1367,5052,2022-03-20 20:27:53.730728
2813,184,3779,240,416,751,5370,2022-03-20 20:27:56.787464
2814,28,598,33,114,181,954,2022-03-20 20:27:58.549205
2815,45,1026,70,135,267,1543,2022-03-20 20:27:58.979186
2818,134,815,102,154,898,2103,2022-03-20 20:28:03.71936
2819,371,1621,292,285,2860,5429,2022-03-20 20:28:03.89592
2822,31,360,30,94,196,711,2022-03-20 20:28:07.252799
2823,71,1707,82,337,288,2485,2022-03-20 20:28:09.303252
2824,31,674,21,127,223,1076,2022-03-20 20:28:10.683612
2825,206,4323,193,378,1177,6277,2022-03-20 20:28:12.483837
2826,119,1110,123,176,670,2198,2022-03-20 20:28:14.07931
2827,78,2720,108,373,496,3775,2022-03-20 20:28:15.752389
2828,626,5029,520,424,6204,12803,2022-03-20 20:28:18.113279
2829,599,10458,412,368,6227,18064,2022-03-20 20:28:18.30159
2830,30,382,23,88,341,864,2022-03-20 20:28:20.232795
2832,447,13250,428,262,6714,21101,2022-03-20 20:28:23.610541
2833,31,689,21,79,522,1342,2022-03-20 20:28:25.102034
2834,221,1543,248,274,2049,4335,2022-03-20 20:28:25.370446
2835,770,981,690,475,3795,6711,2022-03-20 20:28:25.627858
2836,77,2100,95,291,474,3037,2022-03-20 20:28:27.763316
2837,54,663,47,64,593,1421,2022-03-20 20:28:27.937576
2839,58,715,44,74,833,1724,2022-03-20 20:28:29.763136
2840,37,1112,32,72,625,1878,2022-03-20 20:28:29.94314
2881,75,858,48,56,1058,2095,2022-03-20 20:28:33.14725
2882,81,1045,106,272,513,2017,2022-03-20 20:28:33.618375
2884,167,5636,115,221,3187,9326,2022-03-20 20:28:35.827907
2885,84,433,77,145,602,1341,2022-03-20 20:28:36.013825
2891,431,9638,278,223,9929,20499,2022-03-20 20:28:41.842927
2899,777,55796,584,305,14384,71846,2022-03-20 20:28:49.171418
2901,62,986,33,76,715,1872,2022-03-20 20:28:49.437824
2904,47642,1274284,21594,15154,173768,1532442,2022-03-20 20:28:50.17691
2911,171,2757,130,123,2107,5288,2022-03-20 20:28:51.001846
2922,112,1948,58,132,1879,4129,2022-03-20 20:28:55.150705
2923,11068,123182,10760,15791,40139,200940,2022-03-20 20:28:55.631989
2924,8997,123503,8029,6908,90690,238127,2022-03-20 20:28:56.846353
39155,1,8,2,30,28,69,2022-03-21 10:48:47.173688
2928,352,13602,267,294,6034,20549,2022-03-20 20:29:02.942452
2929,197,2049,173,146,1979,4544,2022-03-20 20:29:03.149288
2930,16,58,10,66,109,259,2022-03-20 20:29:04.423493
2931,754,3105,723,926,8447,13955,2022-03-20 20:29:04.598365
2937,195,11838,186,135,3747,16101,2022-03-20 20:29:08.467805
2938,308,1804,270,236,2198,4816,2022-03-20 20:29:09.010673
2941,30,927,18,61,318,1354,2022-03-20 20:29:10.512284
2942,1279,9997,1393,1319,13325,27313,2022-03-20 20:29:10.692755
2953,90,10906,50,57,1694,12797,2022-03-20 20:29:15.509612
2954,91,4840,120,110,1630,6791,2022-03-20 20:29:17.990306
2959,165,1234,90,125,803,2417,2022-03-20 20:29:18.159307
2961,803,98230,304,354,5166,104857,2022-03-20 20:29:18.433122
2962,333,38451,228,219,3703,42934,2022-03-20 20:29:18.690298
2966,35196,431545,28753,18675,215905,730074,2022-03-20 20:29:22.587875
2967,246,2149,157,255,2257,5064,2022-03-20 20:29:24.734864
2969,437,29575,299,244,6666,37221,2022-03-20 20:29:24.93228
2970,1916,18029,1712,2513,10973,35143,2022-03-20 20:29:27.335111
2971,744,13920,590,376,6600,22230,2022-03-20 20:29:29.920089
2973,95,2814,56,65,1494,4524,2022-03-20 20:29:33.961728
2974,71,1217,30,62,849,2229,2022-03-20 20:29:35.736628
2978,454,4672,281,276,3477,9160,2022-03-20 20:29:35.939531
2980,73,413,75,105,637,1303,2022-03-20 20:29:37.742868
2981,960,32027,348,540,15272,49147,2022-03-20 20:29:37.923833
2983,127,4468,78,86,2256,7015,2022-03-20 20:29:38.184713
2985,3249,31301,3156,3414,22060,63180,2022-03-20 20:29:40.45233
2986,4171,46908,4742,4849,23577,84247,2022-03-20 20:29:42.964181
2987,208,800,158,148,2222,3536,2022-03-20 20:29:43.144564
2994,4219,120133,3136,2366,50746,180600,2022-03-20 20:29:47.22474
2997,82,1543,55,64,1398,3142,2022-03-20 20:29:49.349985
2998,64,1252,44,64,1214,2638,2022-03-20 20:29:50.689433
2999,49,1141,42,55,951,2238,2022-03-20 20:29:50.869391
3000,529,3712,513,465,3547,8766,2022-03-20 20:29:53.456691
3001,2986,33221,2615,2584,26639,68045,2022-03-20 20:29:53.651686
3004,113,1830,71,90,1503,3607,2022-03-20 20:30:03.082577
3005,172,2811,87,95,2202,5367,2022-03-20 20:30:03.305054
3006,500,1893,477,584,952,4406,2022-03-20 20:30:06.115959
3007,97,3488,54,134,1378,5151,2022-03-20 20:30:08.097914
3009,378,4594,330,529,3210,9041,2022-03-20 20:30:10.488284
3010,362,7050,386,510,2148,10456,2022-03-20 20:30:15.056047
3012,258,3865,222,420,1042,5807,2022-03-20 20:30:18.986455
3014,589,24581,307,202,8635,34314,2022-03-20 20:30:19.484638
3015,274,7243,210,168,5393,13288,2022-03-20 20:30:19.678964
3019,98,3141,88,85,1993,5405,2022-03-20 20:30:23.561179
3020,56,242,52,122,365,837,2022-03-20 20:30:25.062506
3021,167,617,134,184,1226,2328,2022-03-20 20:30:25.252243
3022,43,405,55,96,390,989,2022-03-20 20:30:25.747764
3023,140,409,133,178,973,1833,2022-03-20 20:30:26.006445
3026,78,1086,57,83,984,2288,2022-03-20 20:30:27.489967
3028,50,427,44,62,704,1287,2022-03-20 20:30:29.779039
3031,223,14832,206,187,3634,19082,2022-03-20 20:30:29.982501
3033,266,18850,193,172,3760,23241,2022-03-20 20:30:33.200197
3036,108,784,99,160,852,2003,2022-03-20 20:30:35.448675
3038,134,1856,89,123,2229,4431,2022-03-20 20:30:38.477184
3043,102,3086,49,100,1526,4863,2022-03-20 20:30:40.437937
3044,580,6576,756,926,3058,11896,2022-03-20 20:30:40.620379
3051,92,3162,75,117,1416,4862,2022-03-20 20:30:43.079794
3053,140,7290,113,278,745,8566,2022-03-20 20:30:43.283767
3054,104,1047,92,160,895,2298,2022-03-20 20:30:45.422778
3057,328,11754,209,370,5053,17714,2022-03-20 20:30:47.969542
3059,229,1528,207,222,1846,4032,2022-03-20 20:30:50.516484
3060,244,2983,173,223,3637,7260,2022-03-20 20:30:52.370608
3061,80,798,88,102,1098,2166,2022-03-20 20:30:54.05387
3064,74,641,65,137,837,1754,2022-03-20 20:30:56.469938
3067,117,1663,78,101,1811,3770,2022-03-20 20:30:58.479124
3069,101,1455,64,97,1482,3199,2022-03-20 20:31:00.454552
3070,36,918,17,46,358,1375,2022-03-20 20:31:00.637432
3071,107,1565,72,92,1569,3405,2022-03-20 20:31:03.063017
3072,124,1472,73,91,1876,3636,2022-03-20 20:31:03.238306
3073,26,67,8,66,122,289,2022-03-20 20:31:04.943643
3075,57,647,59,155,401,1319,2022-03-20 20:31:06.451041
3076,319,15150,282,205,5425,21381,2022-03-20 20:31:06.627868
3079,384,1472,340,226,3245,5667,2022-03-20 20:31:09.669682
3080,142,7594,67,93,2259,10155,2022-03-20 20:31:11.795199
3085,798,12160,504,525,5602,19589,2022-03-20 20:31:14.649655
3086,724,15461,512,479,7398,24574,2022-03-20 20:31:14.861914
3087,1824,54243,784,345,35443,92639,2022-03-20 20:31:18.226798
3089,985,28785,547,450,20382,51149,2022-03-20 20:31:20.939181
3090,448,18951,346,232,5564,25541,2022-03-20 20:31:21.695958
3091,4292,82027,3216,2263,36897,128695,2022-03-20 20:31:24.96927
39167,0,0,1,0,7550,7551,2022-03-21 10:49:03.956108
39168,0,0,0,0,6176,6176,2022-03-21 10:49:04.122257
3092,8277,183926,4442,8524,28119,233288,2022-03-20 20:31:25.145836
3095,132,1105,65,93,1278,2673,2022-03-20 20:31:25.410961
3098,85,808,61,133,533,1620,2022-03-20 20:31:27.639382
3099,134,503,90,121,1028,1876,2022-03-20 20:31:29.259408
3100,31,848,16,38,350,1283,2022-03-20 20:31:31.670794
3101,539,2557,538,691,4013,8338,2022-03-20 20:31:33.912179
3104,87,294,84,127,884,1476,2022-03-20 20:31:35.472627
3110,118,1339,130,174,1516,3277,2022-03-20 20:31:35.785366
3112,246,1209,142,271,1832,3700,2022-03-20 20:31:37.957629
3113,34,589,19,58,384,1084,2022-03-20 20:31:39.397817
3114,49,254,40,91,560,994,2022-03-20 20:31:42.401859
3115,122,1280,54,65,2001,3522,2022-03-20 20:31:42.570375
3116,88,1059,66,134,436,1783,2022-03-20 20:31:42.833855
3120,89,1734,44,71,1591,3529,2022-03-20 20:31:44.654551
3121,606,22609,444,363,4681,28703,2022-03-20 20:31:47.449643
3125,617,2382,491,391,4242,8123,2022-03-20 20:31:47.653277
3127,103,2996,54,69,2017,5239,2022-03-20 20:31:49.584064
3131,29,337,16,117,222,721,2022-03-20 20:31:53.810136
3132,42,513,30,80,396,1061,2022-03-20 20:31:55.260762
3135,291,4177,96,88,4048,8700,2022-03-20 20:31:57.588719
3136,81,1696,98,169,603,2647,2022-03-20 20:31:57.770381
3137,212,2098,192,304,1345,4151,2022-03-20 20:31:59.635702
3138,70,2413,60,43,1094,3680,2022-03-20 20:31:59.808059
3146,137,689,129,154,2073,3182,2022-03-20 20:32:01.829405
3147,44,595,17,43,455,1154,2022-03-20 20:32:03.435789
3151,55,405,61,147,513,1181,2022-03-20 20:32:04.754576
3152,90,1100,27,48,1306,2571,2022-03-20 20:32:06.440899
3153,52,675,36,85,689,1537,2022-03-20 20:32:08.069112
3154,143,1503,96,116,1844,3702,2022-03-20 20:32:08.250982
3157,109,1941,106,96,1273,3525,2022-03-20 20:32:08.774081
3165,203,15070,195,140,3433,19041,2022-03-20 20:32:12.028447
3167,5689,90444,3227,1666,67569,168595,2022-03-20 20:32:14.914069
3174,220,11337,239,161,2878,14835,2022-03-20 20:32:15.136651
3176,93,249,59,97,1093,1591,2022-03-20 20:32:17.242268
3178,66,605,44,55,781,1551,2022-03-20 20:32:19.277589
3180,21,182,11,72,143,429,2022-03-20 20:32:22.160645
3182,87,831,56,79,972,2025,2022-03-20 20:32:23.894888
3183,40,412,17,47,496,1012,2022-03-20 20:32:25.208773
3185,83,536,92,131,941,1783,2022-03-20 20:32:25.630563
3190,35,634,25,45,462,1201,2022-03-20 20:32:28.24775
3192,78,883,38,65,1103,2167,2022-03-20 20:32:28.467212
3193,170,1259,176,255,1195,3055,2022-03-20 20:32:30.316769
3194,73,761,55,136,509,1534,2022-03-20 20:32:30.488938
3196,102,955,55,153,1136,2401,2022-03-20 20:32:32.389755
3199,167,2533,163,276,1954,5093,2022-03-20 20:32:35.070476
3202,55,1467,88,245,655,2510,2022-03-20 20:32:36.72501
3203,38,1182,29,71,470,1790,2022-03-20 20:32:37.015136
3215,89,1859,57,85,1888,3978,2022-03-20 20:32:39.805362
3218,129,2750,124,106,1779,4888,2022-03-20 20:32:40.020503
3220,1054,14479,459,394,17406,33792,2022-03-20 20:32:40.699669
3226,1349,50009,641,568,7016,59583,2022-03-20 20:32:44.414855
3227,111,1545,68,77,1546,3347,2022-03-20 20:32:44.614278
3228,5951,69670,5783,3063,37904,122371,2022-03-20 20:32:44.87489
3229,5293,67569,3016,3461,29891,109230,2022-03-20 20:32:45.150746
3247,515,22436,328,295,6616,30190,2022-03-20 20:32:46.485391
3264,65,461,40,75,673,1314,2022-03-20 20:32:47.691022
3271,131,1772,114,193,545,2755,2022-03-20 20:32:48.865509
3278,30,282,20,74,323,729,2022-03-20 20:32:51.860071
3280,29,415,22,73,348,887,2022-03-20 20:32:53.970394
3285,116,827,119,199,1313,2574,2022-03-20 20:32:58.355089
3287,579,25057,174,582,6559,32951,2022-03-20 20:32:58.561757
3290,59,210,45,103,486,903,2022-03-20 20:33:02.323847
3292,105,2641,121,86,718,3671,2022-03-20 20:33:04.621893
3294,57,232,47,97,395,828,2022-03-20 20:33:06.52032
3295,255,1277,320,447,1881,4180,2022-03-20 20:33:06.699208
3297,4285,34526,2763,2733,68373,112680,2022-03-20 20:33:09.408644
3298,1491,19701,1368,1904,11228,35692,2022-03-20 20:33:09.586918
3305,202,1247,165,174,1359,3147,2022-03-20 20:33:10.823238
3306,78,1805,36,89,1181,3189,2022-03-20 20:33:11.343695
3318,1055,17838,880,781,6894,27448,2022-03-20 20:33:12.121883
3328,457,32934,409,440,7272,41512,2022-03-20 20:33:14.530399
3332,915,1357,623,365,4934,8194,2022-03-20 20:33:14.734965
3349,1012,7339,801,1156,6582,16890,2022-03-20 20:33:15.598601
3363,1668,5678,1529,2087,13380,24342,2022-03-20 20:33:22.175459
3366,4692,26705,4721,6081,34689,76888,2022-03-20 20:33:22.381953
3367,77,1000,36,54,1281,2448,2022-03-20 20:33:24.931507
3369,410,3493,272,245,4053,8473,2022-03-20 20:33:25.107073
3371,887,9544,669,311,9666,21077,2022-03-20 20:33:25.359112
3381,120,1801,88,75,1781,3865,2022-03-20 20:33:30.46263
3388,177,863,151,203,1447,2841,2022-03-20 20:33:32.14241
3389,466,19121,434,663,5598,26282,2022-03-20 20:33:32.329017
3392,272,18051,161,156,3380,22020,2022-03-20 20:33:36.352069
3394,105,2365,62,70,1288,3890,2022-03-20 20:33:36.620979
3398,70,914,36,71,865,1956,2022-03-20 20:33:40.987432
3401,61,6177,86,78,1022,7424,2022-03-20 20:33:45.869646
3406,112,1044,116,143,2075,3490,2022-03-20 20:33:47.758326
3407,3960,33592,3753,6547,30611,78463,2022-03-20 20:33:48.67575
3410,123,2237,114,112,1164,3750,2022-03-20 20:33:48.849244
3414,21,97,10,76,125,329,2022-03-20 20:33:50.427731
3417,198,2639,178,265,1859,5139,2022-03-20 20:33:52.209493
3418,165,586,119,157,1195,2222,2022-03-20 20:33:52.417917
3419,316,7944,200,128,3064,11652,2022-03-20 20:33:52.666307
3420,3350,36276,2925,2555,39629,84735,2022-03-20 20:33:53.619779
3424,136,537,134,157,1762,2726,2022-03-20 20:33:53.965794
3425,78,419,61,91,709,1358,2022-03-20 20:33:55.799063
3430,181,5869,112,118,3296,9576,2022-03-20 20:33:56.527765
3438,126,2814,85,217,697,3939,2022-03-20 20:33:59.395139
3444,155,896,105,215,1284,2655,2022-03-20 20:34:00.366765
3446,308,29857,116,117,2983,33381,2022-03-20 20:34:00.539369
3451,24,152,10,58,164,408,2022-03-20 20:34:02.812402
3456,419,23247,213,201,5621,29701,2022-03-20 20:34:07.294532
3457,18525,422158,12304,28855,68760,550602,2022-03-20 20:34:07.497572
3460,71,760,72,134,518,1555,2022-03-20 20:34:15.656411
3461,97,929,77,95,985,2183,2022-03-20 20:34:18.130113
3463,66,856,49,127,826,1924,2022-03-20 20:34:18.756467
3464,1994,20733,1371,2378,12050,38526,2022-03-20 20:34:19.022563
3467,4678,84212,2957,3962,30411,126220,2022-03-20 20:34:19.598066
3475,88,3259,33,53,1626,5059,2022-03-20 20:34:23.134424
3483,73,1597,64,74,1247,3055,2022-03-20 20:34:30.409533
3484,91,1755,66,68,1499,3479,2022-03-20 20:34:32.702931
3486,188,791,168,168,1317,2632,2022-03-20 20:34:33.534553
3488,265,2798,136,124,5089,8412,2022-03-20 20:34:35.784381
3490,35,839,13,38,470,1395,2022-03-20 20:34:37.900243
3493,216,3835,164,180,1633,6028,2022-03-20 20:34:38.403664
3496,39,348,16,47,342,792,2022-03-20 20:34:38.668957
3497,42,210,17,52,475,796,2022-03-20 20:34:40.097628
3498,37,529,29,54,450,1099,2022-03-20 20:34:41.667512
3500,18,98,11,63,125,315,2022-03-20 20:34:44.490227
3501,224,1891,201,177,2297,4790,2022-03-20 20:34:44.937169
3503,10957,144343,6621,13124,53612,228657,2022-03-20 20:34:45.380931
3512,102,1969,45,61,1634,3811,2022-03-20 20:34:49.330063
3514,44,159,26,99,635,963,2022-03-20 20:34:52.20183
3515,633,30909,404,256,5040,37242,2022-03-20 20:34:52.406594
3522,100,1368,65,68,1594,3195,2022-03-20 20:35:00.368769
3535,111,2016,70,124,1108,3429,2022-03-20 20:35:05.647836
3545,1061,5724,1178,1248,5874,15085,2022-03-20 20:35:05.838228
3546,52,414,35,85,415,1001,2022-03-20 20:35:07.968609
3549,2107,16349,2521,2935,16458,40370,2022-03-20 20:35:12.183635
3550,102,829,93,167,368,1559,2022-03-20 20:35:12.692525
3565,62,581,48,84,402,1177,2022-03-20 20:35:14.859927
3568,163,1158,110,186,1475,3092,2022-03-20 20:35:16.715694
3570,70,603,63,112,1770,2618,2022-03-20 20:35:19.516312
3571,118,1792,132,250,1239,3531,2022-03-20 20:35:20.5476
3573,60,188,54,148,581,1031,2022-03-20 20:35:22.722338
3576,773,15759,710,1443,2381,21066,2022-03-20 20:35:30.459397
3579,469,1845,430,380,3714,6838,2022-03-20 20:35:31.297071
3593,791,12549,455,323,5306,19424,2022-03-20 20:35:35.40069
3594,5508,34883,4242,5379,24362,74374,2022-03-20 20:35:35.658834
3595,125,855,71,80,1286,2417,2022-03-20 20:35:37.867156
3596,35,481,15,47,337,915,2022-03-20 20:35:39.104234
3600,81,788,47,75,1145,2136,2022-03-20 20:35:44.629473
3602,112,2060,90,66,1786,4114,2022-03-20 20:35:44.844103
3603,1851,36822,783,1216,18910,59582,2022-03-20 20:35:45.388487
3604,1171,19024,903,609,7589,29296,2022-03-20 20:35:45.82672
3609,113,1014,107,150,853,2237,2022-03-20 20:35:46.18705
3620,72,1747,63,81,885,2848,2022-03-20 20:35:50.219082
3624,53,1716,59,105,419,2352,2022-03-20 20:35:52.478589
3627,698,17783,584,625,8691,28381,2022-03-20 20:35:59.97421
3630,43,223,34,103,336,739,2022-03-20 20:36:01.364574
3631,71,943,50,157,513,1734,2022-03-20 20:36:01.547086
3638,234,1381,191,249,896,2951,2022-03-20 20:36:04.852894
3640,53,782,30,61,610,1536,2022-03-20 20:36:05.07592
3641,251,4539,158,242,2454,7644,2022-03-20 20:36:07.199766
3646,63,805,42,58,1231,2199,2022-03-20 20:36:09.258173
3652,4722,125127,2780,2089,42849,177567,2022-03-20 20:36:09.522299
3654,2240,23272,1694,2662,11114,40982,2022-03-20 20:36:12.700413
3655,9585,75242,9510,10448,52474,157259,2022-03-20 20:36:15.179351
3656,3623,24881,3268,4815,19703,56290,2022-03-20 20:36:17.836419
3660,186,749,134,156,1305,2530,2022-03-20 20:36:22.546471
3661,46,757,20,41,563,1427,2022-03-20 20:36:24.559138
3665,815,8074,639,293,8036,17857,2022-03-20 20:36:26.563738
3668,567,2415,621,986,3908,8497,2022-03-20 20:36:30.118637
3669,40,674,22,85,404,1225,2022-03-20 20:36:32.856226
3670,346,3863,284,243,3385,8121,2022-03-20 20:36:33.035216
3671,48,722,41,57,654,1522,2022-03-20 20:36:33.209937
3672,69,1451,74,159,694,2447,2022-03-20 20:36:35.42549
3674,271,9070,251,176,5840,15608,2022-03-20 20:36:42.229278
3675,67,779,29,66,830,1771,2022-03-20 20:36:44.097154
3676,112,383,108,124,964,1691,2022-03-20 20:36:44.280226
3683,37,266,21,107,186,617,2022-03-20 20:36:46.211429
3684,41,1763,29,35,923,2791,2022-03-20 20:36:47.927648
3685,21,2601,11,53,329,3015,2022-03-20 20:36:48.128301
3686,111,2989,101,87,1264,4552,2022-03-20 20:36:48.645431
3689,47,364,30,86,308,835,2022-03-20 20:36:49.989633
3692,446,4916,351,319,3034,9066,2022-03-20 20:36:52.933972
3695,39,332,22,46,439,878,2022-03-20 20:36:54.432503
3701,6559,44489,4600,3188,73234,132070,2022-03-20 20:36:55.09523
3702,6504,121445,4639,5076,55841,193505,2022-03-20 20:36:57.933702
3710,567,4106,595,695,4834,10797,2022-03-20 20:37:02.128009
3712,8275,349317,4879,5095,41499,409065,2022-03-20 20:37:05.014352
3713,4020,50379,3688,2639,35136,95862,2022-03-20 20:37:05.19569
3723,35,411,30,108,189,773,2022-03-20 20:37:09.406804
3724,73,333,63,103,351,923,2022-03-20 20:37:09.619163
3727,79,6089,54,121,676,7019,2022-03-20 20:37:11.612418
3755,23,538,11,58,277,907,2022-03-20 20:37:24.036223
3731,10173,171798,6888,11542,57860,258261,2022-03-20 20:37:11.940502
3734,80,956,65,83,1021,2205,2022-03-20 20:37:12.108254
3735,62,432,31,62,700,1287,2022-03-20 20:37:15.519015
3737,94,4996,79,248,1047,6464,2022-03-20 20:37:18.26888
3738,53,4156,39,115,327,4690,2022-03-20 20:37:18.523577
3743,27,1530,14,53,314,1938,2022-03-20 20:37:19.600041
3744,72,3298,46,100,763,4279,2022-03-20 20:37:19.767061
3754,115,1142,98,178,820,2353,2022-03-20 20:37:22.10106
3757,42,811,17,53,390,1313,2022-03-20 20:37:25.338103
3759,620,40521,450,450,8474,50515,2022-03-20 20:37:29.014257
3761,77,1939,87,183,422,2708,2022-03-20 20:37:33.93115
3762,45,385,26,43,430,929,2022-03-20 20:37:35.172836
3763,44,418,28,41,443,974,2022-03-20 20:37:35.992437
3765,59,562,48,123,516,1308,2022-03-20 20:37:37.387497
3768,60,211,42,108,483,904,2022-03-20 20:37:37.651868
3776,41,440,39,93,237,850,2022-03-20 20:37:39.587645
3778,37,395,22,55,393,902,2022-03-20 20:37:41.218085
3782,2930,172603,1474,536,39888,217431,2022-03-20 20:37:42.149148
3783,2743,162676,1294,509,39227,206449,2022-03-20 20:37:44.508098
3784,6287,365597,2457,1044,79623,455008,2022-03-20 20:37:44.684418
3785,4691,282147,2053,809,76290,365990,2022-03-20 20:37:45.20129
3786,3684,110996,1175,374,160602,276831,2022-03-20 20:37:46.634417
3801,72,2434,48,94,1141,3789,2022-03-20 20:37:56.975689
3805,225,2491,138,163,2630,5647,2022-03-20 20:37:57.222986
3809,116,1793,86,172,934,3101,2022-03-20 20:38:03.961334
3811,94,631,107,156,726,1714,2022-03-20 20:38:06.509152
3813,35,234,17,43,411,740,2022-03-20 20:38:08.518375
3816,52,835,33,51,552,1523,2022-03-20 20:38:10.439809
3817,30,309,14,40,333,726,2022-03-20 20:38:11.709365
3819,112,389,62,146,797,1506,2022-03-20 20:38:12.924364
3820,44,2188,19,38,719,3008,2022-03-20 20:38:13.093832
3825,38,314,31,109,465,957,2022-03-20 20:38:15.490296
3827,74,413,56,119,684,1346,2022-03-20 20:38:17.049764
3828,16,83,10,57,146,312,2022-03-20 20:38:18.133527
3829,161,2828,94,115,3963,7161,2022-03-20 20:38:20.019946
3832,32,247,22,39,323,663,2022-03-20 20:38:22.073999
3834,25,286,22,90,182,605,2022-03-20 20:38:23.391882
3835,94,834,73,184,958,2143,2022-03-20 20:38:25.518784
3836,96,1389,100,194,928,2707,2022-03-20 20:38:27.201241
3838,49,343,36,82,408,918,2022-03-20 20:38:29.127192
3840,837,5835,835,1495,6970,15972,2022-03-20 20:38:30.008862
3847,47,1051,20,75,590,1783,2022-03-20 20:38:33.395891
3848,642,46036,474,391,8552,56095,2022-03-20 20:38:33.607824
3853,44,1357,28,79,510,2018,2022-03-20 20:38:35.898593
3854,76,897,70,87,1183,2313,2022-03-20 20:38:36.242725
3861,483,11872,396,312,5920,18983,2022-03-20 20:38:41.390053
3863,31,581,26,51,274,963,2022-03-20 20:38:42.783555
3864,68,1373,50,68,868,2427,2022-03-20 20:38:42.97731
3868,91,1180,76,105,1779,3231,2022-03-20 20:38:46.678245
3869,37,159,34,89,216,535,2022-03-20 20:38:48.071292
3874,121,881,89,156,691,1938,2022-03-20 20:38:50.877289
3875,54,691,54,116,453,1368,2022-03-20 20:38:52.435038
3876,43,285,35,87,455,905,2022-03-20 20:38:53.06487
3878,81,594,76,139,888,1778,2022-03-20 20:38:55.040001
3879,65,346,38,101,496,1046,2022-03-20 20:38:56.419212
3880,66,305,39,96,578,1084,2022-03-20 20:38:57.925337
3881,68,364,49,108,540,1129,2022-03-20 20:38:58.372848
3882,136,2117,54,70,1504,3881,2022-03-20 20:39:00.391624
3886,82,3186,42,92,1220,4622,2022-03-20 20:39:04.621442
3887,102,10181,93,98,1883,12357,2022-03-20 20:39:04.822635
3889,256,4385,96,124,2577,7438,2022-03-20 20:39:06.857115
3898,107,2204,68,101,1468,3948,2022-03-20 20:39:07.036299
3900,134,458,124,189,1035,1940,2022-03-20 20:39:09.127751
3901,2161,135000,1625,955,26778,166519,2022-03-20 20:39:12.304791
3905,49,973,29,80,1007,2138,2022-03-20 20:39:12.480034
3907,639,5707,430,414,6363,13553,2022-03-20 20:39:17.415209
3909,33,204,31,94,306,668,2022-03-20 20:39:17.593594
3913,143,1094,84,75,1340,2736,2022-03-20 20:39:19.384876
3914,250,6379,122,196,5068,12015,2022-03-20 20:39:21.957351
3915,109,692,111,237,1034,2183,2022-03-20 20:39:22.141366
3923,52,668,35,69,394,1218,2022-03-20 20:39:24.002425
3927,4562,110848,2530,1604,17996,137540,2022-03-20 20:39:24.181778
3929,30,916,13,60,218,1237,2022-03-20 20:39:27.016472
3931,452,20115,214,239,5431,26451,2022-03-20 20:39:27.890357
3932,66,331,63,114,479,1053,2022-03-20 20:39:29.314526
3936,36,505,24,97,386,1048,2022-03-20 20:39:30.315962
3937,22,168,11,86,108,395,2022-03-20 20:39:32.05826
3946,78,1863,65,75,1525,3606,2022-03-20 20:39:33.646206
3947,54,223,38,101,549,965,2022-03-20 20:39:34.066678
3952,71,973,59,66,1110,2279,2022-03-20 20:39:36.83595
3956,628,30739,559,402,8229,40557,2022-03-20 20:39:40.353114
3960,30,619,17,41,726,1433,2022-03-20 20:39:44.497796
3962,387,6476,407,812,4006,12088,2022-03-20 20:39:44.759887
3963,108,2097,118,132,2001,4456,2022-03-20 20:39:45.014074
3969,58,348,40,113,430,989,2022-03-20 20:39:47.398539
3974,4421,40827,3294,2793,36623,87958,2022-03-20 20:39:51.553903
3977,77,1561,78,79,1238,3033,2022-03-20 20:39:52.234851
4012,106,5292,35,83,1280,6796,2022-03-20 20:39:57.341895
4013,43,394,31,96,273,837,2022-03-20 20:39:59.408668
4015,817,44976,725,424,11653,58595,2022-03-20 20:40:00.016489
4021,1606,18029,1434,2106,11806,34981,2022-03-20 20:40:00.278178
4025,34,695,34,125,360,1248,2022-03-20 20:40:02.686628
4028,1184,23354,1227,1135,7888,34788,2022-03-20 20:40:04.968538
4033,194,5206,139,160,3653,9352,2022-03-20 20:40:07.892743
4037,842,24827,544,334,16570,43117,2022-03-20 20:40:08.151985
4038,2698,13352,2317,2701,21790,42858,2022-03-20 20:40:11.171068
4039,3497,9871,2798,2554,19384,38104,2022-03-20 20:40:11.349667
4042,107,1611,59,69,1079,2925,2022-03-20 20:40:11.876523
4044,92,526,90,167,785,1660,2022-03-20 20:40:13.734892
4050,160,1502,150,202,1079,3093,2022-03-20 20:40:19.442064
4051,134,785,122,270,596,1907,2022-03-20 20:40:19.903058
4053,663,27048,381,345,4877,33314,2022-03-20 20:40:22.686586
4058,52,939,39,52,741,1823,2022-03-20 20:40:26.465338
4059,2235,255459,1022,770,24979,284465,2022-03-20 20:40:26.740156
4060,168,2036,133,179,1577,4093,2022-03-20 20:40:29.331184
4062,152,532,134,158,1215,2191,2022-03-20 20:40:32.012128
4066,1111,7329,1002,1649,7234,18325,2022-03-20 20:40:35.958911
4067,120,442,82,148,1483,2275,2022-03-20 20:40:38.215137
4068,89,340,58,112,1102,1701,2022-03-20 20:40:40.894366
4069,197,6082,256,408,858,7801,2022-03-20 20:40:41.066065
4070,45,1141,47,76,802,2111,2022-03-20 20:40:42.965145
4071,69,1430,61,79,1151,2790,2022-03-20 20:40:44.673867
4073,55,482,41,97,369,1044,2022-03-20 20:40:46.730926
4075,64,1387,50,54,909,2464,2022-03-20 20:40:48.956737
4078,123,4122,89,66,1785,6185,2022-03-20 20:40:49.216898
4080,2156,16800,1694,1009,9613,31272,2022-03-20 20:40:49.465533
4085,44,322,31,56,807,1260,2022-03-20 20:40:51.970755
4087,13287,59866,10692,6078,84178,174101,2022-03-20 20:40:56.136809
4088,48,202,87,171,348,856,2022-03-20 20:40:58.012261
4094,431,20550,238,301,5493,27013,2022-03-20 20:41:02.441042
4095,69,2807,46,49,1658,4629,2022-03-20 20:41:06.111807
4097,18,274,13,58,235,598,2022-03-20 20:41:07.594923
4098,41,271,22,52,619,1005,2022-03-20 20:41:09.250963
4103,49,1140,17,51,521,1778,2022-03-20 20:41:13.263872
4104,21,314,16,63,166,580,2022-03-20 20:41:14.68893
4106,1903,90370,814,365,29973,123425,2022-03-20 20:41:14.954526
4107,2549,103904,1337,822,37994,146606,2022-03-20 20:41:15.408561
4114,228,1977,177,204,1895,4481,2022-03-20 20:41:20.540203
4119,136,345,89,115,1075,1760,2022-03-20 20:41:22.557931
4124,88,2712,75,111,1422,4408,2022-03-20 20:41:24.324168
4126,20,448,11,44,309,832,2022-03-20 20:41:26.289332
4129,18,383,15,44,265,725,2022-03-20 20:41:27.700941
4134,941,47339,522,472,10621,59895,2022-03-20 20:41:33.536999
4136,1026,7029,883,1177,5983,16098,2022-03-20 20:41:36.007034
4138,37,2294,23,66,387,2807,2022-03-20 20:41:38.91852
4147,52,1802,42,105,1038,3039,2022-03-20 20:41:39.123609
4150,49,1404,35,58,808,2354,2022-03-20 20:41:43.275601
4151,4035,28929,2846,3740,23785,63335,2022-03-20 20:41:43.852817
4154,69,1103,56,159,456,1843,2022-03-20 20:41:45.347291
4155,2997,182104,878,637,20055,206671,2022-03-20 20:41:45.524462
4156,116,11335,103,71,2139,13764,2022-03-20 20:41:48.48602
4158,29,2080,18,37,647,2811,2022-03-20 20:41:50.771221
4162,107,2750,80,52,1462,4451,2022-03-20 20:41:50.957436
4163,1189,37704,648,366,10020,49927,2022-03-20 20:41:53.601098
4166,236,3349,145,120,2427,6277,2022-03-20 20:41:56.247059
4173,159,1827,215,188,1608,3997,2022-03-20 20:41:56.466292
4176,56,1193,33,62,941,2285,2022-03-20 20:41:56.728492
4177,7347,65851,5653,4746,44943,128540,2022-03-20 20:42:00.498143
4181,33996,727724,18970,15081,265235,1061006,2022-03-20 20:42:00.671976
4182,1352,107886,751,428,20433,130850,2022-03-20 20:42:01.145697
4186,10130,128639,6119,7397,44012,196297,2022-03-20 20:42:05.025634
4187,63,921,32,48,897,1961,2022-03-20 20:42:05.282357
49220,0,0,0,0,6167,6167,2022-03-21 12:14:34.255307
4188,1469,15290,744,529,11351,29383,2022-03-20 20:42:05.546622
4192,4350,72676,3332,3394,23971,107723,2022-03-20 20:42:06.24815
4202,63,1068,95,62,750,2038,2022-03-20 20:42:09.721523
4205,191,8979,142,85,2436,11833,2022-03-20 20:42:09.93646
4209,356,2535,327,480,1830,5528,2022-03-20 20:42:13.18413
4210,66,707,26,71,995,1865,2022-03-20 20:42:14.779651
4211,128,309,67,109,1108,1721,2022-03-20 20:42:16.90967
4213,98,1321,69,58,1136,2682,2022-03-20 20:42:17.086154
4214,9084,324098,5581,7912,35681,382356,2022-03-20 20:42:17.353383
4224,86608,1472108,50975,55565,265169,1930425,2022-03-20 20:42:21.92195
4232,295,7427,195,192,3112,11221,2022-03-20 20:42:24.127844
4240,140,520,142,131,1165,2098,2022-03-20 20:42:27.37638
4244,60,241,51,78,618,1048,2022-03-20 20:42:30.517157
4246,666,29509,523,445,12086,43229,2022-03-20 20:42:33.077436
4250,36,869,11,57,274,1247,2022-03-20 20:42:34.452551
4252,62,656,36,48,603,1405,2022-03-20 20:42:35.967425
4262,2367,23429,1740,2540,14801,44877,2022-03-20 20:42:38.372505
4264,389,1319,372,624,3595,6299,2022-03-20 20:42:40.496137
4266,77,365,38,100,980,1560,2022-03-20 20:42:40.687594
4280,2479,152791,1267,448,37620,194605,2022-03-20 20:42:41.164798
4282,4034,152646,1856,794,55749,215079,2022-03-20 20:42:42.155619
4286,111,442,105,193,506,1357,2022-03-20 20:42:43.741587
4298,62,432,35,72,648,1249,2022-03-20 20:42:45.565244
4306,83,1218,54,70,1815,3240,2022-03-20 20:42:47.665388
4312,202,4635,119,106,2560,7622,2022-03-20 20:42:47.835711
4318,73,982,36,63,805,1959,2022-03-20 20:42:51.476328
4320,139,4997,110,98,2312,7656,2022-03-20 20:42:53.446159
4331,62,210,44,193,189,698,2022-03-20 20:42:54.786803
4334,2397,15072,2477,5603,11292,36841,2022-03-20 20:42:59.414469
4339,91,762,67,170,768,1858,2022-03-20 20:43:01.566878
4353,131,4856,105,181,1772,7045,2022-03-20 20:43:03.846383
4361,205,3032,181,115,2471,6004,2022-03-20 20:43:06.14076
4362,266,6955,153,300,1861,9535,2022-03-20 20:43:08.488435
4382,15459,347313,10730,9992,95002,478496,2022-03-20 20:43:10.971615
4383,37,840,29,57,505,1468,2022-03-20 20:43:13.09471
4385,59,1268,41,77,678,2123,2022-03-20 20:43:15.19266
4387,66,1298,44,82,595,2085,2022-03-20 20:43:18.932404
4391,38,1181,17,53,221,1510,2022-03-20 20:43:23.545077
4392,22,749,7,56,168,1002,2022-03-20 20:43:25.04648
4393,29,1421,15,52,202,1719,2022-03-20 20:43:27.53227
4394,25,773,10,53,144,1005,2022-03-20 20:43:29.307902
4395,21,643,9,57,127,857,2022-03-20 20:43:29.48547
4397,21,911,9,52,140,1133,2022-03-20 20:43:32.46878
4398,38,2301,21,69,731,3160,2022-03-20 20:43:34.020217
4406,73,1310,39,87,666,2175,2022-03-20 20:43:35.886293
4411,77,576,65,125,543,1386,2022-03-20 20:43:37.393794
4415,2274,29000,1883,2624,13667,49448,2022-03-20 20:43:40.062326
4416,132,1291,111,135,1714,3383,2022-03-20 20:43:41.965652
4417,11,85,11,56,112,275,2022-03-20 20:43:43.171088
4418,22,824,23,41,319,1229,2022-03-20 20:43:44.805174
4419,76,1211,55,94,1125,2561,2022-03-20 20:43:44.986858
4427,83,331,76,118,635,1243,2022-03-20 20:43:47.659371
4437,2196,208826,839,612,18173,230646,2022-03-20 20:43:47.842976
4454,211,8292,137,145,3245,12030,2022-03-20 20:43:51.823643
4461,32,1436,13,27,503,2011,2022-03-20 20:43:56.291385
4462,18,1244,5,42,106,1415,2022-03-20 20:43:57.764958
4467,25,1642,10,35,390,2102,2022-03-20 20:43:57.959724
4468,37,401,22,72,244,776,2022-03-20 20:43:58.229942
4469,162,6365,168,216,3335,10246,2022-03-20 20:44:00.350366
4472,1392,100724,825,577,20371,123889,2022-03-20 20:44:06.945133
4476,139,2180,92,92,1795,4298,2022-03-20 20:44:07.848875
4477,2832,90789,2136,1243,19033,116033,2022-03-20 20:44:10.541376
4481,82,1491,40,98,1009,2720,2022-03-20 20:44:12.097074
4483,1295,7734,1110,980,13416,24535,2022-03-20 20:44:13.120497
4485,108,815,63,75,1403,2464,2022-03-20 20:44:16.973289
4503,246,3734,246,250,2460,6936,2022-03-20 20:44:17.633598
4504,40,265,27,78,298,708,2022-03-20 20:44:19.274867
4508,185,3204,153,141,2833,6516,2022-03-20 20:44:20.289978
4511,30,342,37,96,305,810,2022-03-20 20:44:23.261728
4513,118,2467,60,106,2018,4769,2022-03-20 20:44:23.461217
4514,61,1315,47,156,346,1925,2022-03-20 20:44:25.498108
4515,44,830,41,126,375,1416,2022-03-20 20:44:25.681549
4521,21,316,17,53,237,644,2022-03-20 20:44:28.178203
4524,86,748,35,56,783,1708,2022-03-20 20:44:30.826609
4532,157,691,142,132,1945,3067,2022-03-20 20:44:35.71138
4533,87,1224,39,50,1060,2460,2022-03-20 20:44:37.57634
4534,48,482,31,46,547,1154,2022-03-20 20:44:38.910785
4536,65,422,50,109,482,1128,2022-03-20 20:44:42.995927
4540,113,2815,69,110,1719,4826,2022-03-20 20:44:46.635576
4547,27,70,7,70,131,305,2022-03-20 20:44:49.334755
4549,568,5550,434,461,4350,11363,2022-03-20 20:44:50.568781
4551,4993,69057,3929,4468,31689,114136,2022-03-20 20:44:56.01096
4553,20,163,10,66,131,390,2022-03-20 20:44:57.317288
4554,62,289,55,109,551,1066,2022-03-20 20:44:58.69903
4563,99,865,64,142,634,1804,2022-03-20 20:44:58.873301
4565,4183,126736,1696,1093,57220,190928,2022-03-20 20:44:59.850449
4566,61,1147,55,62,818,2143,2022-03-20 20:45:02.202323
4574,46,233,30,98,379,786,2022-03-20 20:45:04.063328
4578,72,696,47,97,965,1877,2022-03-20 20:45:04.295629
4581,5513,53327,4035,4615,46625,114115,2022-03-20 20:45:04.808627
4618,1860,24644,1723,1994,14617,44838,2022-03-20 20:45:08.072943
4621,12,73,4,67,106,262,2022-03-20 20:45:09.827362
4639,311,2180,221,214,4174,7100,2022-03-20 20:45:12.435889
4640,51,356,23,59,728,1217,2022-03-20 20:45:14.704265
4646,189,2905,113,133,1695,5035,2022-03-20 20:45:14.988844
4650,169,3795,70,90,2134,6258,2022-03-20 20:45:15.22273
4651,258,967,225,234,1635,3319,2022-03-20 20:45:17.364743
4654,45478,437001,33523,32014,180066,728082,2022-03-20 20:45:17.806191
4657,1290,6171,1177,1827,5176,15641,2022-03-20 20:45:17.976369
4664,242,6306,190,185,4241,11164,2022-03-20 20:45:18.693056
4685,55,1370,24,50,709,2208,2022-03-20 20:45:19.872396
4709,17,242,19,121,159,558,2022-03-20 20:45:22.955677
4712,148,4452,116,171,2162,7049,2022-03-20 20:45:25.266649
4713,663,14982,367,540,13240,29792,2022-03-20 20:45:25.44082
4715,163,12824,120,78,3090,16275,2022-03-20 20:45:25.956991
4718,174,4520,99,122,1946,6861,2022-03-20 20:45:28.354462
4719,5701,40088,3647,7542,30108,87086,2022-03-20 20:45:28.531013
4720,5529,40641,3818,6263,53388,109639,2022-03-20 20:45:28.708667
4723,121,246,91,118,1152,1728,2022-03-20 20:45:30.930758
4737,65,350,53,142,409,1019,2022-03-20 20:45:31.888388
4761,53,648,44,54,989,1788,2022-03-20 20:45:35.264886
4765,415,13371,352,271,7654,22063,2022-03-20 20:45:35.76063
4782,51,218,39,88,288,684,2022-03-20 20:45:43.750856
4786,235,8019,196,193,3011,11654,2022-03-20 20:45:44.20982
4789,5396,79018,4915,3989,62401,155719,2022-03-20 20:45:46.743531
4790,28,223,8,53,345,657,2022-03-20 20:45:46.911364
4792,156,20704,135,184,2040,23219,2022-03-20 20:45:49.83228
4793,210,35916,141,184,2188,38639,2022-03-20 20:45:52.298558
4795,153,14881,135,184,2345,17698,2022-03-20 20:45:55.625973
4798,286,9543,186,167,4100,14282,2022-03-20 20:45:55.831723
4800,53,861,59,106,477,1556,2022-03-20 20:45:57.6069
4801,55,221,28,90,319,713,2022-03-20 20:45:59.367727
4804,215,2731,144,94,2164,5348,2022-03-20 20:46:01.79764
4807,61,515,41,76,432,1125,2022-03-20 20:46:01.96541
4810,301,1768,327,303,2843,5542,2022-03-20 20:46:04.748428
4811,442,14884,260,151,4531,20268,2022-03-20 20:46:04.951084
4814,4078,144329,1785,2097,14169,166458,2022-03-20 20:46:05.224064
4855,49,758,48,49,666,1570,2022-03-20 20:46:09.6139
4856,58,626,24,43,506,1257,2022-03-20 20:46:09.817427
4872,1410,39453,1007,519,18277,60666,2022-03-20 20:46:12.467165
4874,129,10940,123,157,2009,13358,2022-03-20 20:46:12.642218
4876,194,1709,110,74,3465,5552,2022-03-20 20:46:12.91692
4879,3382,15898,3195,3112,31824,57411,2022-03-20 20:46:13.169984
4898,64585,672987,46831,56497,204916,1045816,2022-03-20 20:46:14.399729
4907,19,288,14,70,251,642,2022-03-20 20:46:16.359033
4908,177,1609,148,341,2115,4390,2022-03-20 20:46:18.658894
4910,97,7244,104,141,1951,9537,2022-03-20 20:46:22.40271
4918,1443,44468,776,424,17216,64327,2022-03-20 20:46:27.340422
4921,137,3962,66,106,1579,5850,2022-03-20 20:46:30.466687
4923,89,748,56,106,946,1945,2022-03-20 20:46:32.041184
4926,71,1219,60,72,918,2340,2022-03-20 20:46:33.891824
4927,57,426,27,59,586,1155,2022-03-20 20:46:35.512202
4928,82,270,59,110,783,1304,2022-03-20 20:46:35.723509
4933,53,412,33,90,612,1200,2022-03-20 20:46:36.632408
4935,107,906,137,268,455,1873,2022-03-20 20:46:38.713781
4938,1283,40782,825,497,15079,58466,2022-03-20 20:46:43.929937
4939,142,1043,209,297,1336,3027,2022-03-20 20:46:44.132668
4940,26,124,17,73,250,490,2022-03-20 20:46:44.392008
4941,27,356,14,41,420,858,2022-03-20 20:46:46.348043
4943,59,740,44,69,1044,1956,2022-03-20 20:46:46.539495
4948,51,867,22,72,577,1589,2022-03-20 20:46:46.793678
4975,8862,183290,6881,13455,59942,272430,2022-03-20 20:46:48.076601
4999,7529,140690,4249,5842,33353,191663,2022-03-20 20:46:51.086004
5005,1233,6740,1086,1208,10484,20751,2022-03-20 20:46:56.339185
5013,45,307,12,60,313,737,2022-03-20 20:47:01.175234
5014,51,817,27,43,636,1574,2022-03-20 20:47:03.561554
49703,0,0,0,0,6305,6305,2022-03-21 12:18:41.22379
5017,12,889,5,30,208,1144,2022-03-20 20:47:05.703236
5018,32,171,24,63,336,626,2022-03-20 20:47:05.960007
5019,97,2794,81,81,1792,4845,2022-03-20 20:47:08.207206
5022,49,321,54,102,361,887,2022-03-20 20:47:11.017122
5023,85,381,71,118,1053,1708,2022-03-20 20:47:11.228987
5025,247,2699,115,120,2922,6103,2022-03-20 20:47:13.612417
5027,207,2866,209,530,1719,5531,2022-03-20 20:47:13.813734
5029,330,14444,171,242,3602,18789,2022-03-20 20:47:17.235015
5030,8510,88258,7463,10679,47568,162478,2022-03-20 20:47:17.746104
5031,117,2403,69,74,1265,3928,2022-03-20 20:47:17.936119
5040,10361,122446,7277,5569,64599,210252,2022-03-20 20:47:18.93927
5053,144,2451,90,119,2896,5700,2022-03-20 20:47:23.245427
5060,19337,133438,17186,21619,49466,241046,2022-03-20 20:47:27.956067
5065,239,18010,143,190,4105,22687,2022-03-20 20:47:28.144149
5070,139,1271,91,157,752,2410,2022-03-20 20:47:30.884762
5196,249,6548,211,164,3490,10662,2022-03-20 20:48:40.942571
5071,77,392,59,123,387,1038,2022-03-20 20:47:33.205552
5072,201,6200,130,124,2409,9064,2022-03-20 20:47:33.387758
5074,1744,29459,1241,716,15074,48234,2022-03-20 20:47:36.225605
5079,7657,49921,6587,8477,40980,113622,2022-03-20 20:47:44.002809
5080,283,6046,116,96,3305,9846,2022-03-20 20:47:47.260207
5081,85761,771906,55582,41016,301472,1255737,2022-03-20 20:47:47.523431
5082,221,1143,122,237,1414,3137,2022-03-20 20:47:49.567207
5084,304,6305,187,114,6714,13624,2022-03-20 20:47:49.752583
5085,121,4833,51,119,2134,7258,2022-03-20 20:47:50.010958
5088,36,256,31,103,304,730,2022-03-20 20:47:52.135515
5089,17,103,12,62,149,343,2022-03-20 20:47:53.419673
5090,45,722,19,67,480,1333,2022-03-20 20:47:55.022371
5091,62,806,41,120,342,1371,2022-03-20 20:47:56.722511
5096,99,7560,80,119,626,8484,2022-03-20 20:47:56.895511
5098,25,423,15,79,345,887,2022-03-20 20:47:59.183294
5104,41,501,36,101,316,995,2022-03-20 20:48:00.994327
5114,214964,2039711,95879,43543,419164,2813261,2022-03-20 20:48:02.38348
5118,2996,63207,2878,3003,22757,94841,2022-03-20 20:48:05.312324
5132,332,2164,124,176,2461,5257,2022-03-20 20:48:12.04468
5140,21,126,15,54,194,410,2022-03-20 20:48:14.858329
5141,878,7781,722,828,8907,19116,2022-03-20 20:48:15.076436
5162,1793,44396,1447,1157,14203,62996,2022-03-20 20:48:23.263895
5163,810,22318,822,675,10692,35317,2022-03-20 20:48:23.476954
5165,61,1951,52,85,1148,3297,2022-03-20 20:48:25.669545
5167,90,505,77,82,982,1736,2022-03-20 20:48:27.6036
5168,68,3591,32,48,1315,5054,2022-03-20 20:48:29.335752
5177,5059,77084,2106,1441,53244,138934,2022-03-20 20:48:32.165576
5178,865,24651,403,486,11724,38129,2022-03-20 20:48:34.980978
5184,26,70,14,70,170,350,2022-03-20 20:48:37.276918
5189,34,348,28,103,209,722,2022-03-20 20:48:38.73869
5192,16,155,15,42,191,419,2022-03-20 20:48:38.924683
5193,9,169,9,41,90,318,2022-03-20 20:48:40.757432
5197,67,627,53,119,653,1519,2022-03-20 20:48:41.216881
5199,241,3745,204,150,3470,7810,2022-03-20 20:48:41.480602
5216,332,10079,258,195,4222,15086,2022-03-20 20:48:45.806284
5217,72,906,56,129,536,1699,2022-03-20 20:48:47.70151
5220,3398,20185,3732,5512,22494,55321,2022-03-20 20:48:47.876772
5223,23,448,16,91,117,695,2022-03-20 20:48:50.313032
5225,143,6149,97,110,2616,9115,2022-03-20 20:48:50.487101
5226,1411,4032,1052,1112,9643,17250,2022-03-20 20:48:50.749179
5228,574,25991,258,192,6752,33767,2022-03-20 20:48:51.020977
5235,100,256,75,120,508,1059,2022-03-20 20:48:53.671187
5238,43,505,63,77,1284,1972,2022-03-20 20:48:56.066765
5241,29,195,21,63,224,532,2022-03-20 20:48:57.759411
5244,217,10045,234,145,4594,15235,2022-03-20 20:49:00.496313
5246,45,582,25,71,486,1209,2022-03-20 20:49:02.493091
5249,81,337,81,109,433,1041,2022-03-20 20:49:02.669191
5250,112,775,91,153,1108,2239,2022-03-20 20:49:02.937776
5251,766,23080,305,234,8382,32767,2022-03-20 20:49:05.690501
5252,679,36160,363,262,7826,45290,2022-03-20 20:49:05.868715
5258,8454,181376,3188,1765,41549,236332,2022-03-20 20:49:09.87529
5262,4476,71739,3422,3880,12479,95996,2022-03-20 20:49:12.645658
5266,61,743,37,45,714,1600,2022-03-20 20:49:13.352956
5270,82,3510,57,115,1103,4867,2022-03-20 20:49:16.322761
5272,32,337,11,58,216,654,2022-03-20 20:49:16.517357
5279,748,42244,431,247,8534,52204,2022-03-20 20:49:17.562156
5293,54,625,32,73,587,1371,2022-03-20 20:49:20.878301
5296,71,1078,50,48,908,2155,2022-03-20 20:49:21.08525
5298,157,6748,108,162,2311,9486,2022-03-20 20:49:23.536621
5299,10,614,6,26,156,812,2022-03-20 20:49:26.335629
5303,40,275,23,75,401,814,2022-03-20 20:49:29.396498
5306,1352,17615,833,509,9870,30179,2022-03-20 20:49:34.452416
5307,1672,8664,1490,1953,10286,24065,2022-03-20 20:49:34.710461
5308,92,1559,58,96,1136,2941,2022-03-20 20:49:36.974781
5310,524,20036,265,242,7553,28620,2022-03-20 20:49:39.325583
5311,73,606,57,145,424,1305,2022-03-20 20:49:41.638761
5314,22,267,23,60,320,692,2022-03-20 20:49:43.05914
5322,60,569,38,95,437,1199,2022-03-20 20:49:43.526476
5330,104,981,57,81,1177,2400,2022-03-20 20:49:45.87742
5332,116,7190,105,93,1987,9491,2022-03-20 20:49:46.536398
5333,466,11126,313,256,4972,17133,2022-03-20 20:49:46.815012
5337,1364,50298,849,1985,3670,58166,2022-03-20 20:49:50.324008
5341,14540,315694,9986,4943,98256,443419,2022-03-20 20:49:50.507675
5343,114,546,70,129,1055,1914,2022-03-20 20:49:54.702406
5344,45,258,34,115,392,844,2022-03-20 20:49:54.891746
5348,178,9335,138,159,2380,12190,2022-03-20 20:49:55.322233
5356,10363,98274,8332,8107,82592,207668,2022-03-20 20:49:55.9742
5369,154,5354,79,79,1800,7466,2022-03-20 20:50:01.250772
5374,30,123,9,63,166,391,2022-03-20 20:50:05.786544
5375,35,554,48,185,235,1057,2022-03-20 20:50:08.925568
5386,175,2073,83,125,3541,5997,2022-03-20 20:50:09.109431
5395,73,370,51,77,611,1182,2022-03-20 20:50:09.376342
5397,62,3683,31,117,351,4244,2022-03-20 20:50:13.087598
5415,85,1264,52,89,1745,3235,2022-03-20 20:50:13.316014
5420,4747,20721,3734,2651,45419,77272,2022-03-20 20:50:19.253695
5447,72,1490,42,92,1068,2764,2022-03-20 20:50:21.912618
5449,31,707,25,67,420,1250,2022-03-20 20:50:23.873379
5462,115,6082,108,138,1223,7666,2022-03-20 20:50:30.653891
5466,41,481,36,38,870,1466,2022-03-20 20:50:30.872328
5472,13,398,19,33,269,732,2022-03-20 20:50:33.003919
5474,25,349,33,111,276,794,2022-03-20 20:50:35.180965
5475,47,254,32,114,381,828,2022-03-20 20:50:36.797499
5476,83,383,71,150,663,1350,2022-03-20 20:50:38.157482
5477,27,152,14,68,260,521,2022-03-20 20:50:39.297389
5478,18,151,12,85,157,423,2022-03-20 20:50:40.418165
5484,179,1314,225,149,1275,3142,2022-03-20 20:50:40.599547
5485,890,5491,775,833,6056,14045,2022-03-20 20:50:43.005347
5492,28,369,7,38,273,715,2022-03-20 20:50:44.490525
5493,249,8795,201,135,3141,12521,2022-03-20 20:50:47.568512
5494,331,2253,326,290,3180,6380,2022-03-20 20:50:47.740896
5496,83,1206,41,69,880,2279,2022-03-20 20:50:49.54876
5503,22,273,17,77,338,727,2022-03-20 20:50:51.870865
5504,1226,11703,830,825,8789,23373,2022-03-20 20:50:52.131481
5505,464,4729,400,678,3380,9651,2022-03-20 20:50:52.398249
5521,594,27039,377,240,8255,36505,2022-03-20 20:50:53.104699
5539,111,2046,74,104,1710,4045,2022-03-20 20:50:57.007383
5549,80,1651,53,71,904,2759,2022-03-20 20:50:59.760286
5554,68,774,35,77,865,1819,2022-03-20 20:51:01.973024
5564,67,491,50,124,341,1073,2022-03-20 20:51:03.813509
5578,183,3338,162,123,1460,5266,2022-03-20 20:51:05.863422
5581,28,243,10,44,211,536,2022-03-20 20:51:08.039342
5583,78,6612,39,59,844,7632,2022-03-20 20:51:08.221931
5584,69,885,36,41,778,1809,2022-03-20 20:51:10.889174
5585,116,1018,46,44,1050,2274,2022-03-20 20:51:11.100325
5593,1705,36714,1085,975,17813,58292,2022-03-20 20:51:11.621543
5594,14,94,8,67,111,294,2022-03-20 20:51:13.024077
5597,2884,15680,2186,2928,25523,49201,2022-03-20 20:51:13.206733
5630,19828,297582,14399,10786,176426,519021,2022-03-20 20:51:15.076617
5652,46,749,40,43,646,1524,2022-03-20 20:51:20.207484
5656,45,2146,54,103,730,3078,2022-03-20 20:51:20.395483
5658,265,2498,228,215,1771,4977,2022-03-20 20:51:20.677166
5661,25,992,6,59,175,1257,2022-03-20 20:51:22.16881
5667,3935,131980,1804,1341,21603,160663,2022-03-20 20:51:25.362669
5670,1011,7569,998,1342,7824,18744,2022-03-20 20:51:28.420414
5671,4882,42700,3692,4850,30312,86436,2022-03-20 20:51:31.028092
5673,60,781,46,68,947,1902,2022-03-20 20:51:32.682324
5675,2902,19480,2685,4262,14001,43330,2022-03-20 20:51:32.86306
5678,8529,68423,7886,7996,60623,153457,2022-03-20 20:51:35.832541
5680,44627,613019,29396,29615,213907,930564,2022-03-20 20:51:39.71048
5682,16407,138413,11994,10559,127944,305317,2022-03-20 20:51:44.317379
5684,870,7242,761,763,4806,14442,2022-03-20 20:51:44.507289
5688,351,869,339,304,1991,3854,2022-03-20 20:51:47.913646
39297,1,141,2,11,38,193,2022-03-21 10:50:51.99162
5691,162,3607,123,78,2469,6439,2022-03-20 20:51:52.630115
5702,1584,18081,1130,1175,14838,36808,2022-03-20 20:51:57.155005
5712,167,3715,125,204,1445,5656,2022-03-20 20:51:59.476689
5713,345,21084,294,158,6292,28173,2022-03-20 20:51:59.746344
5715,54,1229,42,57,654,2036,2022-03-20 20:52:01.653976
5717,695,25544,407,329,5138,32113,2022-03-20 20:52:01.826991
5723,86,1338,60,100,1354,2938,2022-03-20 20:52:05.823975
5725,216,6205,169,265,1267,8122,2022-03-20 20:52:09.091326
5742,52,1205,27,59,591,1934,2022-03-20 20:52:12.039203
5751,325,10318,178,190,3141,14152,2022-03-20 20:52:14.701796
5753,102,3676,69,116,1547,5510,2022-03-20 20:52:14.901251
5760,1022,5641,730,813,8448,16654,2022-03-20 20:52:18.946622
5763,70,573,56,119,877,1695,2022-03-20 20:52:20.640569
5764,1169,71583,666,426,12934,86778,2022-03-20 20:52:23.731921
5772,648,30551,361,323,6300,38183,2022-03-20 20:52:24.168519
5774,1152,36644,312,394,6922,45424,2022-03-20 20:52:24.346355
5781,11603,98199,4885,5453,58726,178866,2022-03-20 20:52:24.60531
5799,23,418,8,60,185,694,2022-03-20 20:52:28.083894
5813,16,1678,7,46,189,1936,2022-03-20 20:52:35.083322
5814,15,1046,6,52,125,1244,2022-03-20 20:52:36.572545
5819,116,1968,54,71,2341,4550,2022-03-20 20:52:36.758523
5826,33,1410,12,61,212,1728,2022-03-20 20:52:37.205708
5835,4950,28320,3959,5022,21367,63618,2022-03-20 20:52:38.390371
5849,92,1225,67,107,1254,2745,2022-03-20 20:52:39.563118
5869,16,906,4,46,137,1109,2022-03-20 20:52:42.535026
5870,27,886,10,53,137,1113,2022-03-20 20:52:43.855413
5871,22,704,9,55,126,916,2022-03-20 20:52:44.027427
5878,34,447,20,48,601,1150,2022-03-20 20:52:45.669992
5900,39,268,18,65,500,890,2022-03-20 20:52:47.047001
5914,1938,17378,1415,2135,13392,36258,2022-03-20 20:52:48.30765
5921,36,169,21,63,539,828,2022-03-20 20:52:51.3003
5923,47,217,37,65,551,917,2022-03-20 20:52:53.531688
5925,44,877,20,45,602,1588,2022-03-20 20:52:57.246426
5926,41,703,28,54,555,1381,2022-03-20 20:53:00.030735
5927,35,331,37,56,572,1031,2022-03-20 20:53:01.454774
5928,51,432,24,30,450,987,2022-03-20 20:53:03.26082
5929,50,476,44,68,851,1489,2022-03-20 20:53:03.444827
5930,22,129,11,44,252,458,2022-03-20 20:53:05.140015
5931,24,298,15,63,334,734,2022-03-20 20:53:08.526823
5934,24,499,23,54,342,942,2022-03-20 20:53:10.453505
5935,33,278,34,106,354,805,2022-03-20 20:53:12.074815
5938,87,614,62,124,1055,1942,2022-03-20 20:53:14.033067
5940,9534,102821,5491,8824,39659,166329,2022-03-20 20:53:16.917608
5941,5878,53319,4485,3803,45503,112988,2022-03-20 20:53:17.861077
5943,17,130,8,76,196,427,2022-03-20 20:53:19.675537
5947,337,18751,323,224,8063,27698,2022-03-20 20:53:20.289542
5953,115,1073,95,149,1113,2545,2022-03-20 20:53:23.005382
5955,990,37142,721,530,11146,50529,2022-03-20 20:53:23.268454
5956,29,393,13,48,260,743,2022-03-20 20:53:24.741021
5958,17312,301613,10381,16522,90993,436821,2022-03-20 20:53:30.39621
5962,1919,66987,1337,2631,4378,77252,2022-03-20 20:53:33.103089
5967,202,4909,130,235,1313,6789,2022-03-20 20:53:33.286199
5968,143,4373,84,151,1180,5931,2022-03-20 20:53:33.555148
5984,1999,14536,1724,2172,21386,41817,2022-03-20 20:53:36.906512
5986,16,110,8,52,176,362,2022-03-20 20:53:38.128632
5990,34,441,18,46,360,899,2022-03-20 20:53:39.777328
5992,131,875,123,183,835,2147,2022-03-20 20:53:42.076924
5996,83,4813,66,107,1443,6512,2022-03-20 20:53:43.704775
5997,183,236,147,157,1183,1906,2022-03-20 20:53:44.750911
5998,166,5289,100,123,3359,9037,2022-03-20 20:53:45.758478
6000,39,395,20,36,530,1020,2022-03-20 20:53:47.431999
6008,551,4537,488,771,4166,10513,2022-03-20 20:53:50.581136
6012,44,284,27,81,495,931,2022-03-20 20:53:52.325404
6018,17,72,7,44,123,263,2022-03-20 20:53:56.420306
6023,2075,51527,1576,1841,10611,67630,2022-03-20 20:53:56.663093
6030,6977,73405,5436,8442,40113,134373,2022-03-20 20:54:04.630266
6031,112,644,41,79,920,1796,2022-03-20 20:54:04.837859
6033,16681,264021,9687,12110,28367,330866,2022-03-20 20:54:09.250538
6038,62,1080,34,57,530,1763,2022-03-20 20:54:11.727323
6045,44821,487330,28911,24935,203691,789688,2022-03-20 20:54:12.07314
6046,1163,28052,517,329,16577,46638,2022-03-20 20:54:15.056805
6050,1394,12180,657,431,8440,23102,2022-03-20 20:54:17.912632
6056,62,365,58,110,667,1262,2022-03-20 20:54:23.353659
6060,38,652,18,58,461,1227,2022-03-20 20:54:24.815662
6061,152,958,71,100,1553,2834,2022-03-20 20:54:24.99976
6062,44,426,18,90,406,984,2022-03-20 20:54:26.995137
6063,10,65,5,47,104,231,2022-03-20 20:54:28.067043
6065,38,221,17,58,346,680,2022-03-20 20:54:30.07663
6068,72,1236,54,62,734,2158,2022-03-20 20:54:30.912298
6069,147,1756,85,147,1501,3636,2022-03-20 20:54:31.177986
6078,40,457,28,52,551,1128,2022-03-20 20:54:37.59689
6090,67,909,33,45,671,1725,2022-03-20 20:54:39.685392
6091,30,142,16,46,263,497,2022-03-20 20:54:41.129506
6093,50,266,50,106,540,1012,2022-03-20 20:54:42.61501
6094,142,1593,100,151,2197,4183,2022-03-20 20:54:44.786578
6095,30,495,14,66,287,892,2022-03-20 20:54:46.476315
6096,198,561,120,101,1401,2381,2022-03-20 20:54:48.400216
6098,2038,20101,1554,1625,15365,40683,2022-03-20 20:54:51.404921
6107,37,508,33,68,546,1192,2022-03-20 20:54:52.996233
6112,1427,15809,1047,1272,10311,29866,2022-03-20 20:54:55.494235
6114,23848,154825,18119,13839,141579,352210,2022-03-20 20:54:56.411846
6115,476,23823,259,251,6395,31204,2022-03-20 20:54:59.56808
6116,443,625,402,415,962,2847,2022-03-20 20:55:02.131718
6117,581,2335,492,1085,2960,7453,2022-03-20 20:55:02.313194
6119,130,348,104,176,1124,1882,2022-03-20 20:55:04.441277
6124,17,134,2,60,118,331,2022-03-20 20:55:05.909946
6127,2427,73304,2228,2672,19737,100368,2022-03-20 20:55:06.187113
6129,1522,7651,1340,1982,13638,26133,2022-03-20 20:55:08.83942
6131,224,381,315,765,708,2393,2022-03-20 20:55:13.040189
6137,33,1975,5,28,413,2454,2022-03-20 20:55:13.252525
6149,1308,0,602,794,1213,3917,2022-03-20 20:55:13.979392
6152,216,7744,124,148,2900,11132,2022-03-20 20:55:16.879862
6153,106,4387,87,121,1601,6302,2022-03-20 20:55:19.143737
6154,205,6714,120,165,2153,9357,2022-03-20 20:55:21.999276
6162,462,11438,158,129,6010,18197,2022-03-20 20:55:23.679993
6163,599,25697,380,437,9663,36776,2022-03-20 20:55:26.547621
6164,3886,40616,3043,3616,38761,89922,2022-03-20 20:55:29.045683
6166,9190,110556,5456,8712,47521,181435,2022-03-20 20:55:35.221539
6169,195,3747,139,117,3450,7648,2022-03-20 20:55:37.272104
6172,373,19058,181,143,6272,26027,2022-03-20 20:55:43.360554
6178,406,71174,251,267,4468,76566,2022-03-20 20:55:43.61162
6181,38,651,29,48,422,1188,2022-03-20 20:55:48.250936
6182,43,673,35,54,1023,1828,2022-03-20 20:55:50.70663
6183,29,432,9,47,340,857,2022-03-20 20:55:52.164733
6184,94,1179,44,50,967,2334,2022-03-20 20:55:52.656733
6187,304,19948,240,146,5781,26419,2022-03-20 20:55:53.108733
6189,91,951,56,120,1179,2397,2022-03-20 20:55:53.368733
6195,29,117,17,78,256,497,2022-03-20 20:55:53.640732
6206,15,52,5,48,106,226,2022-03-20 20:55:57.541611
6209,126,3833,142,103,2060,6264,2022-03-20 20:55:59.763279
6211,10262,135912,8033,6350,110680,271237,2022-03-20 20:55:59.942278
6213,29234,322529,18776,14494,157599,542632,2022-03-20 20:56:00.367279
6215,42,1690,32,51,701,2516,2022-03-20 20:56:02.911385
6217,64,3484,33,93,668,4342,2022-03-20 20:56:03.075387
6219,202,2282,106,111,3857,6558,2022-03-20 20:56:04.117076
6226,106,1912,81,150,1655,3904,2022-03-20 20:56:06.973353
6227,76,843,50,61,817,1847,2022-03-20 20:56:07.912299
6229,236,276,109,103,1721,2445,2022-03-20 20:56:08.164298
6230,87,196,36,62,901,1282,2022-03-20 20:56:10.345801
6231,175,8706,129,150,2291,11451,2022-03-20 20:56:10.542803
6234,184,6737,134,123,3086,10264,2022-03-20 20:56:14.318567
6245,78,1019,53,57,718,1925,2022-03-20 20:56:15.918732
6251,77,1170,55,56,912,2270,2022-03-20 20:56:18.229402
6262,100,542,87,160,641,1530,2022-03-20 20:56:21.340085
6266,56,634,35,47,823,1595,2022-03-20 20:56:21.568085
6267,27,153,10,50,379,619,2022-03-20 20:56:23.565768
6270,39,275,24,50,911,1299,2022-03-20 20:56:24.218414
6271,51,167,27,50,875,1170,2022-03-20 20:56:25.901784
6272,28,207,20,59,625,939,2022-03-20 20:56:27.339768
6273,14,72,13,43,235,377,2022-03-20 20:56:28.589268
6275,99,7225,107,141,2053,9625,2022-03-20 20:56:28.769258
6276,130,3491,63,63,2449,6196,2022-03-20 20:56:32.379193
6277,59,526,74,175,464,1298,2022-03-20 20:56:32.586193
6280,993,21690,368,351,4646,28048,2022-03-20 20:56:32.869193
6288,649,46369,358,231,8925,56532,2022-03-20 20:56:40.950284
6291,541,26760,365,233,9051,36950,2022-03-20 20:56:41.14547
6293,169,2151,76,72,1571,4039,2022-03-20 20:56:41.417491
6297,33,496,11,51,261,852,2022-03-20 20:56:43.540193
6299,104,3425,93,92,1563,5277,2022-03-20 20:56:43.965977
6303,117,2260,104,247,424,3152,2022-03-20 20:56:46.814479
6305,42,1504,28,41,786,2401,2022-03-20 20:56:49.155422
6310,37,561,22,66,405,1091,2022-03-20 20:56:50.884552
6311,43,297,23,108,349,820,2022-03-20 20:56:52.315683
6312,93,1534,82,61,1194,2964,2022-03-20 20:56:52.758509
6318,104,978,72,154,640,1948,2022-03-20 20:56:52.934548
6324,9559,154008,4707,6136,48011,222421,2022-03-20 20:56:53.197615
6330,217,7104,267,289,5026,12903,2022-03-20 20:56:55.808508
6331,50,819,40,52,621,1582,2022-03-20 20:56:58.587741
6344,307,8316,196,116,5470,14405,2022-03-20 20:57:02.150395
6346,43,1292,21,49,475,1880,2022-03-20 20:57:02.361926
6347,21440,412893,16165,23609,111247,585354,2022-03-20 20:57:05.308152
6351,2060,214421,1109,687,26482,244759,2022-03-20 20:57:05.490798
6355,29,859,15,41,319,1263,2022-03-20 20:57:09.516873
6361,449,18602,364,222,9731,29368,2022-03-20 20:57:09.690152
6366,31,348,14,58,347,798,2022-03-20 20:57:11.070409
6368,342,4053,199,193,5067,9854,2022-03-20 20:57:11.251068
6372,2003,123233,1223,542,31555,158556,2022-03-20 20:57:11.786163
6377,4284,49642,3419,2058,39139,98542,2022-03-20 20:57:17.660646
6379,193,4800,123,88,2990,8194,2022-03-20 20:57:17.864686
6380,458,13079,244,152,6595,20528,2022-03-20 20:57:20.185037
6381,2690,51651,1682,1605,20806,78434,2022-03-20 20:57:23.242138
6383,385,1006,232,457,1235,3315,2022-03-20 20:57:24.246382
6385,103,9627,98,148,1696,11672,2022-03-20 20:57:28.235362
6392,884,13071,326,446,4922,19649,2022-03-20 20:57:30.420316
6397,35,296,28,103,227,689,2022-03-20 20:57:32.415856
6399,134,10716,95,121,2454,13520,2022-03-20 20:57:32.601903
6401,277,12006,235,190,5654,18362,2022-03-20 20:57:34.966248
6408,1627,33474,874,698,26793,63466,2022-03-20 20:57:35.414705
6412,17,203,12,56,309,597,2022-03-20 20:57:36.870295
6413,48,1318,19,49,534,1968,2022-03-20 20:57:37.058478
6418,118,4229,83,111,1714,6255,2022-03-20 20:57:39.381189
6419,60,324,33,65,615,1097,2022-03-20 20:57:39.556534
6421,4393,101827,2539,977,33625,143361,2022-03-20 20:57:42.772759
6425,784,10845,498,892,6983,20002,2022-03-20 20:57:43.218133
6428,78,274,57,102,532,1043,2022-03-20 20:57:45.383294
6431,20,799,7,44,127,997,2022-03-20 20:57:46.868213
6437,117,1059,94,101,823,2194,2022-03-20 20:57:48.712298
6438,315,15828,143,207,2707,19200,2022-03-20 20:57:49.029138
6444,6617,50868,6728,6330,41931,112474,2022-03-20 20:57:54.163437
6447,41,161,15,45,372,634,2022-03-20 20:57:55.66191
6452,71,336,45,114,740,1306,2022-03-20 20:57:57.400677
6462,38,1030,18,70,446,1602,2022-03-20 20:57:59.411192
6467,658,43613,263,310,4912,49756,2022-03-20 20:58:02.579248
6479,300,18079,160,147,3850,22536,2022-03-20 20:58:06.729692
6482,25,121,21,76,303,546,2022-03-20 20:58:09.817883
6489,1082,33221,574,738,10131,45746,2022-03-20 20:58:11.575325
6492,54,696,30,45,672,1497,2022-03-20 20:58:13.954528
6496,88,1527,75,71,1787,3548,2022-03-20 20:58:15.730937
6500,20003,144331,13254,33216,86018,296822,2022-03-20 20:58:18.401643
6511,91,1250,77,154,768,2340,2022-03-20 20:58:27.027368
6512,9939,170422,5675,6559,52451,245046,2022-03-20 20:58:30.246027
6513,41,648,24,59,460,1232,2022-03-20 20:58:31.563214
6517,11,156,13,59,186,425,2022-03-20 20:58:33.234526
39307,3,11,1,31,25,71,2022-03-21 10:50:57.683338
6518,16,357,11,59,183,626,2022-03-20 20:58:33.668391
6519,12,124,6,57,125,324,2022-03-20 20:58:35.132116
6520,19,200,22,101,246,588,2022-03-20 20:58:36.918184
6523,35,383,34,119,140,711,2022-03-20 20:58:39.638214
6525,131,950,96,339,1294,2810,2022-03-20 20:58:42.664239
6527,95,2702,70,95,1274,4236,2022-03-20 20:58:42.881948
6528,15,82,8,65,195,365,2022-03-20 20:58:43.156102
6533,41,2299,16,40,485,2881,2022-03-20 20:58:45.656887
6535,27,3037,18,83,603,3768,2022-03-20 20:58:45.850397
6546,347,8656,126,460,2574,12163,2022-03-20 20:58:46.116546
6548,292,23674,196,185,4485,28832,2022-03-20 20:58:46.575432
6567,142,2407,74,82,1742,4447,2022-03-20 20:58:47.982355
6573,9485,283126,6019,5676,79255,383561,2022-03-20 20:58:48.902126
6587,178,3430,106,123,2278,6115,2022-03-20 20:58:52.27183
6593,9,118,10,50,131,318,2022-03-20 20:58:54.408451
6594,37448,226270,25372,15137,203492,507719,2022-03-20 20:58:54.920946
6604,342,1032,334,361,2360,4429,2022-03-20 20:58:57.614608
6609,398,11654,311,695,1420,14478,2022-03-20 20:59:01.179972
6610,1652,41629,660,368,23323,67632,2022-03-20 20:59:01.383793
6624,915,25847,602,325,15697,43386,2022-03-20 20:59:05.420289
6625,37,256,48,127,493,961,2022-03-20 20:59:07.271204
6628,117,2926,74,107,1490,4714,2022-03-20 20:59:07.716635
6629,51,291,31,118,274,765,2022-03-20 20:59:09.826048
6630,18,162,6,70,171,427,2022-03-20 20:59:11.350064
6634,2526,41259,1809,1469,18188,65251,2022-03-20 20:59:17.571951
6636,109,297,60,98,801,1365,2022-03-20 20:59:19.180107
6637,1619,102236,1086,496,30492,135929,2022-03-20 20:59:19.643582
6641,66,1903,17,41,914,2941,2022-03-20 20:59:19.846413
6645,2091,25605,1792,4683,11236,45407,2022-03-20 20:59:23.202638
6654,68,6721,35,72,598,7494,2022-03-20 20:59:25.277903
6658,38,173,32,143,319,705,2022-03-20 20:59:28.149205
6666,40,2476,14,29,409,2968,2022-03-20 20:59:28.41304
6670,37,408,31,78,863,1417,2022-03-20 20:59:32.671304
6671,15,189,5,64,133,406,2022-03-20 20:59:33.864686
6672,68,280,72,133,455,1008,2022-03-20 20:59:35.13172
6674,46,282,31,105,450,914,2022-03-20 20:59:36.52489
6676,1559,44518,1228,1225,10605,59135,2022-03-20 20:59:42.67411
6680,31,1002,11,53,571,1668,2022-03-20 20:59:44.274348
6682,7820,157428,5650,11998,39764,222660,2022-03-20 20:59:44.446788
6684,21,376,15,37,232,681,2022-03-20 20:59:46.768406
6695,32,631,19,53,332,1067,2022-03-20 20:59:53.872588
6702,205784,876608,125013,179185,168101,1554691,2022-03-20 20:59:57.046826
6704,578,8633,379,343,4174,14107,2022-03-20 20:59:59.329458
6705,340,4118,179,145,2865,7647,2022-03-20 21:00:02.027419
6707,14410,394498,8494,11415,81353,510170,2022-03-20 21:00:05.490494
6709,183,7230,140,145,2434,10132,2022-03-20 21:00:09.708589
49856,0,0,0,0,0,0,2022-03-21 12:20:05.228211
49858,0,0,0,0,21173,21173,2022-03-21 12:20:05.397709
6712,955,9568,630,514,7407,19074,2022-03-20 21:00:11.994248
6713,148,3847,141,106,2112,6354,2022-03-20 21:00:15.786195
6714,255,15366,198,274,3655,19748,2022-03-20 21:00:18.510096
6718,64,653,50,96,880,1743,2022-03-20 21:00:22.016498
6726,133,2105,118,145,1500,4001,2022-03-20 21:00:24.526811
6727,25,159,10,75,151,420,2022-03-20 21:00:25.83292
6731,25,293,19,105,216,658,2022-03-20 21:00:29.190925
6733,52,743,44,59,778,1676,2022-03-20 21:00:30.816229
6734,46,789,44,59,801,1739,2022-03-20 21:00:32.059688
6735,53,694,39,63,787,1636,2022-03-20 21:00:32.231193
6736,91,4770,84,73,1626,6644,2022-03-20 21:00:32.495254
6743,196,2701,122,142,1833,4994,2022-03-20 21:00:35.842462
6746,88265,725465,71242,52207,333412,1270591,2022-03-20 21:00:39.468553
6747,9759,129963,7134,12106,50099,209061,2022-03-20 21:00:44.269765
6748,134,4415,76,75,1364,6064,2022-03-20 21:00:47.423718
6749,71,3574,57,106,1243,5051,2022-03-20 21:00:47.598888
6758,4423,17432,3191,3912,30309,59267,2022-03-20 21:00:47.862345
6759,9,136,5,48,104,302,2022-03-20 21:00:51.213248
6760,10,125,4,49,96,284,2022-03-20 21:00:52.390378
6768,1003,29210,595,584,13215,44607,2022-03-20 21:00:57.455151
6772,1544,57883,724,529,20096,80776,2022-03-20 21:01:00.57337
6773,8409,146116,7242,6791,53338,221896,2022-03-20 21:01:00.84178
6779,40,435,48,122,200,845,2022-03-20 21:01:03.404425
6783,255,6345,282,215,5755,12852,2022-03-20 21:01:03.601428
6791,1025,30010,559,426,9536,41556,2022-03-20 21:01:07.676306
6793,1337,84682,639,464,18314,105436,2022-03-20 21:01:09.866804
6794,193,5210,140,93,3026,8662,2022-03-20 21:01:12.224477
6797,13,548,11,39,169,780,2022-03-20 21:01:18.078462
6798,39,525,31,90,239,924,2022-03-20 21:01:19.574934
6800,51,1186,32,61,462,1792,2022-03-20 21:01:21.285134
6809,148,2158,73,97,2587,5063,2022-03-20 21:01:27.530771
6823,32,915,8,57,171,1183,2022-03-20 21:01:32.936616
6828,11,632,3,41,79,766,2022-03-20 21:01:35.145725
6829,31,704,6,53,140,934,2022-03-20 21:01:36.986392
6831,16,767,8,46,195,1032,2022-03-20 21:01:38.887049
6832,21,994,8,46,211,1280,2022-03-20 21:01:40.977056
6833,18,911,4,54,145,1132,2022-03-20 21:01:42.320696
6835,30,892,7,57,171,1157,2022-03-20 21:01:44.787587
6837,25,880,9,58,138,1110,2022-03-20 21:01:47.509513
6838,14,1100,6,56,137,1313,2022-03-20 21:01:49.405427
6841,27,822,5,53,183,1090,2022-03-20 21:01:53.902125
6842,11,535,2,42,93,683,2022-03-20 21:01:55.190028
6844,12,849,5,43,115,1024,2022-03-20 21:01:57.655329
6846,14,496,4,38,101,653,2022-03-20 21:01:59.527273
6847,14,535,1,39,89,678,2022-03-20 21:01:59.702292
6848,13,537,6,40,106,702,2022-03-20 21:02:00.937018
6850,10,669,10,43,136,868,2022-03-20 21:02:03.468324
6855,32,487,13,54,335,921,2022-03-20 21:02:09.3163
6857,34,1049,10,59,417,1569,2022-03-20 21:02:11.316881
6864,2181,41073,1069,485,18367,63175,2022-03-20 21:02:18.383043
6867,986,27138,676,850,8292,37942,2022-03-20 21:02:18.715468
6868,25,151,18,89,369,652,2022-03-20 21:02:20.229575
6872,73,1513,62,121,1228,2997,2022-03-20 21:02:20.408621
6875,1253,14360,1010,3689,6429,26741,2022-03-20 21:02:22.233129
6877,108,10121,112,143,1888,12372,2022-03-20 21:02:22.490474
6890,98,1396,57,69,953,2573,2022-03-20 21:02:25.498162
6899,79,1148,47,107,663,2044,2022-03-20 21:02:26.049312
6918,1196,13951,872,2451,6094,24564,2022-03-20 21:02:33.016246
6920,1196,13609,842,2083,7838,25568,2022-03-20 21:02:38.452202
6922,3263,149669,1639,1625,44197,200393,2022-03-20 21:02:38.659364
6927,533,19255,423,365,11444,32020,2022-03-20 21:02:38.917938
6930,58,4484,38,111,518,5209,2022-03-20 21:02:39.185131
6939,51,573,22,63,572,1281,2022-03-20 21:02:39.950066
6958,125,7640,99,69,1772,9705,2022-03-20 21:02:42.300489
6978,44,790,23,54,644,1555,2022-03-20 21:02:49.129068
6979,2269,13302,1450,2842,9911,29774,2022-03-20 21:02:51.873691
6980,1008,5208,903,1256,6631,15006,2022-03-20 21:02:55.783283
6981,43,153,25,66,307,594,2022-03-20 21:02:55.967339
6984,243,11707,206,165,3646,15967,2022-03-20 21:02:58.859191
6985,140,3634,84,158,2380,6396,2022-03-20 21:03:02.159746
6987,2966,85051,1137,1913,17397,108464,2022-03-20 21:03:04.869215
6988,57,4292,72,111,618,5150,2022-03-20 21:03:07.749328
6989,36,158,39,142,238,613,2022-03-20 21:03:09.220726
6992,43,966,32,33,728,1802,2022-03-20 21:03:10.909358
6993,34,1240,12,55,337,1678,2022-03-20 21:03:12.802849
6994,41,873,13,60,386,1373,2022-03-20 21:03:12.983865
6999,85,4217,83,104,1468,5957,2022-03-20 21:03:16.027468
7004,49,1507,64,210,253,2083,2022-03-20 21:03:18.833735
7016,425,6546,347,290,3532,11140,2022-03-20 21:03:21.388598
7017,1281,43770,1023,1239,10561,57874,2022-03-20 21:03:23.984867
7020,16,614,8,43,144,825,2022-03-20 21:03:25.545166
7024,16,1381,9,48,181,1635,2022-03-20 21:03:30.696616
7025,27,1745,15,51,465,2303,2022-03-20 21:03:30.954466
7026,14,748,6,36,136,940,2022-03-20 21:03:32.455602
7027,20,859,8,39,189,1115,2022-03-20 21:03:32.635879
7028,13,1041,7,44,135,1240,2022-03-20 21:03:34.042307
7029,18,716,10,44,203,991,2022-03-20 21:03:35.359884
7030,15,1119,7,49,175,1365,2022-03-20 21:03:37.077093
7031,10,841,12,45,184,1092,2022-03-20 21:03:38.309346
7032,12,697,6,40,121,876,2022-03-20 21:03:39.451002
7041,296,7528,212,169,3887,12092,2022-03-20 21:03:40.292166
7044,831,21806,523,285,13941,37386,2022-03-20 21:03:42.830094
7045,76,7484,73,117,555,8305,2022-03-20 21:03:45.517688
7048,72,828,47,153,421,1521,2022-03-20 21:03:47.955277
7052,35,128,11,65,433,672,2022-03-20 21:03:49.284583
7054,50613,818050,29021,30942,167371,1095997,2022-03-20 21:03:49.654664
7058,6216,43266,4579,6036,31726,91823,2022-03-20 21:03:50.208461
7059,1733,141844,915,865,22730,168087,2022-03-20 21:03:54.015093
7060,81,2835,63,105,1397,4481,2022-03-20 21:03:54.196453
7062,819,15754,615,456,7555,25199,2022-03-20 21:03:54.459365
7081,567,4883,412,493,2339,8694,2022-03-20 21:04:01.170924
7082,1914,48189,1745,4297,11629,67774,2022-03-20 21:04:01.432236
7083,242,4312,173,189,3507,8423,2022-03-20 21:04:07.394044
7090,21,199,9,41,195,465,2022-03-20 21:04:14.206513
7092,56,131,17,55,520,779,2022-03-20 21:04:15.629127
7103,1061,7927,1064,2610,5876,18538,2022-03-20 21:04:17.997312
7108,84,2527,71,88,1714,4484,2022-03-20 21:04:20.162318
7109,35,178,25,75,194,507,2022-03-20 21:04:21.629653
7112,59,597,39,58,1075,1828,2022-03-20 21:04:21.831026
7113,103,4870,53,137,1286,6449,2022-03-20 21:04:23.59744
7117,18,563,5,37,263,886,2022-03-20 21:04:23.798404
7144,114,1778,75,83,1804,3854,2022-03-20 21:04:28.205479
7148,8443,134519,4053,6888,42042,195945,2022-03-20 21:04:28.722845
7152,541,1911,484,607,3863,7406,2022-03-20 21:04:29.156011
7160,134,467,77,127,1151,1956,2022-03-20 21:04:33.033349
7162,47,309,32,92,246,726,2022-03-20 21:04:35.242602
7164,12,423,16,31,198,680,2022-03-20 21:04:36.880037
7169,24,604,13,40,392,1073,2022-03-20 21:04:38.648776
7171,26,1201,13,37,456,1733,2022-03-20 21:04:40.877179
7174,30,911,8,50,197,1196,2022-03-20 21:04:42.516594
7175,34,177,17,106,204,538,2022-03-20 21:04:42.695767
7176,193,1597,215,500,705,3210,2022-03-20 21:04:44.397998
7177,37,91,15,70,237,450,2022-03-20 21:04:45.704968
7189,38,100,30,94,223,485,2022-03-20 21:04:46.961027
7193,12440,65031,10243,8476,102106,198296,2022-03-20 21:04:49.150471
7211,24,64,7,82,151,328,2022-03-20 21:04:51.038566
7222,490,17247,266,219,7047,25269,2022-03-20 21:04:55.004408
7229,97,969,78,116,1305,2565,2022-03-20 21:04:56.818469
7230,49,1068,29,29,776,1951,2022-03-20 21:04:58.259824
7243,26,983,12,35,245,1301,2022-03-20 21:04:58.436879
7244,16,578,7,33,183,817,2022-03-20 21:04:59.970438
7245,38,341,20,77,324,800,2022-03-20 21:05:01.835011
7247,72,210,38,144,228,692,2022-03-20 21:05:03.263871
7254,103,1090,53,80,1374,2700,2022-03-20 21:05:06.266256
7257,34,841,12,60,466,1413,2022-03-20 21:05:07.209686
7279,172,2579,100,149,2318,5318,2022-03-20 21:05:10.862521
7285,46,411,49,62,924,1492,2022-03-20 21:05:13.963634
7294,35,334,22,56,382,829,2022-03-20 21:05:16.037474
7303,177,4733,117,164,2304,7495,2022-03-20 21:05:19.377707
7304,322,16359,134,211,2366,19392,2022-03-20 21:05:24.693985
7305,163,7069,95,201,1724,9252,2022-03-20 21:05:24.879158
7307,141,683,128,169,994,2115,2022-03-20 21:05:26.822252
7308,67,964,48,90,1126,2295,2022-03-20 21:05:27.018851
7311,13268,357649,5726,4465,170246,551354,2022-03-20 21:05:27.36621
7314,30,487,16,62,435,1030,2022-03-20 21:05:27.554014
7336,79,987,54,89,1038,2247,2022-03-20 21:05:30.269275
7337,527,45786,308,302,9583,56506,2022-03-20 21:05:30.470412
7354,21,179,19,105,191,515,2022-03-20 21:05:30.906814
7376,26,311,19,57,338,751,2022-03-20 21:05:34.613299
7377,65,2834,44,64,1201,4208,2022-03-20 21:05:36.557223
7396,360,11041,250,182,5170,17003,2022-03-20 21:05:42.216173
7415,16,1179,14,21,196,1426,2022-03-20 21:05:47.044266
7416,11,118,5,33,98,265,2022-03-20 21:05:47.328286
7419,15,117,13,80,134,359,2022-03-20 21:05:47.606517
7430,72,2043,62,78,1194,3449,2022-03-20 21:05:50.821081
7435,105,1066,52,92,1128,2443,2022-03-20 21:05:51.058581
7436,66,944,51,69,880,2010,2022-03-20 21:05:54.03114
7445,10,538,6,30,101,685,2022-03-20 21:05:56.030852
7446,13,527,7,29,95,671,2022-03-20 21:05:57.873082
7448,25,192,28,76,163,484,2022-03-20 21:05:58.0557
7449,7,262,5,29,83,386,2022-03-20 21:05:58.571237
7451,18,582,7,31,131,769,2022-03-20 21:06:01.196636
7452,20,173,20,63,140,416,2022-03-20 21:06:02.829039
7459,21,138,11,40,145,355,2022-03-20 21:06:03.627099
7465,2593,67846,1268,586,43757,116050,2022-03-20 21:06:06.993906
7466,17,818,1,33,133,1002,2022-03-20 21:06:09.106294
7468,478,8028,268,322,4228,13324,2022-03-20 21:06:09.284394
7471,173,6810,90,191,1649,8913,2022-03-20 21:06:14.15139
7472,2270,107979,1004,758,29663,141674,2022-03-20 21:06:14.591179
7473,21,83,6,55,195,360,2022-03-20 21:06:14.77302
7474,251,7991,155,111,2789,11297,2022-03-20 21:06:17.551841
7475,56,1528,27,57,592,2260,2022-03-20 21:06:18.011033
7479,97,223,49,109,749,1227,2022-03-20 21:06:21.846238
7482,49,687,24,48,583,1391,2022-03-20 21:06:23.509021
7485,36,2023,14,58,221,2352,2022-03-20 21:06:26.109312
7488,11,554,7,30,102,704,2022-03-20 21:06:27.255652
7491,52,714,35,52,712,1565,2022-03-20 21:06:28.599144
7494,14,957,6,47,128,1152,2022-03-20 21:06:30.045633
7495,6,58,14,71,90,239,2022-03-20 21:06:31.279245
7496,26,695,18,62,344,1145,2022-03-20 21:06:32.624789
7497,30,770,9,57,167,1033,2022-03-20 21:06:33.983092
7498,27,695,11,58,158,949,2022-03-20 21:06:34.153727
7500,14,104,13,90,115,336,2022-03-20 21:06:35.278173
7504,11,413,4,34,135,597,2022-03-20 21:06:37.521441
7510,53,500,23,62,780,1418,2022-03-20 21:06:38.444284
7527,15,90,9,91,124,329,2022-03-20 21:06:41.19716
7528,26,769,11,60,275,1141,2022-03-20 21:06:42.843997
7529,16,105,13,86,156,376,2022-03-20 21:06:43.932689
7530,22,519,13,58,195,807,2022-03-20 21:06:45.22796
7531,15,112,10,87,136,360,2022-03-20 21:06:46.507009
7532,26,422,10,55,202,715,2022-03-20 21:06:48.264534
7536,53,766,28,57,683,1587,2022-03-20 21:06:49.263038
7540,114,3300,88,81,1363,4946,2022-03-20 21:06:51.09551
7547,21,230,8,53,167,479,2022-03-20 21:06:51.299094
7549,141,3153,66,62,1637,5059,2022-03-20 21:06:53.126216
7550,89,4164,99,140,1836,6328,2022-03-20 21:06:55.249189
7559,930,23549,654,686,13615,39434,2022-03-20 21:07:01.923874
7561,163,1916,107,304,815,3305,2022-03-20 21:07:02.134156
7568,656,6407,844,825,6692,15424,2022-03-20 21:07:04.792318
7571,61,663,36,39,507,1306,2022-03-20 21:07:06.390315
7578,67,1135,72,69,1619,2962,2022-03-20 21:07:12.23182
7580,1870,26463,1139,1319,14720,45511,2022-03-20 21:07:14.913568
7588,4301,28689,3026,2113,44296,82425,2022-03-20 21:07:17.744657
7590,7137,74206,4328,6126,37828,129625,2022-03-20 21:07:17.923456
7592,14266,142151,9386,9450,71893,247146,2022-03-20 21:07:20.437844
7619,183,1201,214,302,1330,3230,2022-03-20 21:07:38.160259
7593,18636,395440,10500,24639,71349,520564,2022-03-20 21:07:23.512239
7596,837,17348,499,659,9474,28817,2022-03-20 21:07:25.801395
7597,63,2865,32,99,1063,4122,2022-03-20 21:07:28.665271
7601,35,231,26,45,383,720,2022-03-20 21:07:31.713823
7610,50,870,28,82,767,1797,2022-03-20 21:07:34.084309
7616,26,341,15,41,469,892,2022-03-20 21:07:34.320015
7617,10,496,3,38,79,626,2022-03-20 21:07:35.658106
39405,2,12,3,27,33,77,2022-03-21 10:52:17.622455
7621,25,491,20,72,406,1014,2022-03-20 21:07:38.361996
7625,22,167,11,74,236,510,2022-03-20 21:07:41.280729
7627,5143,50085,3116,4866,35294,98504,2022-03-20 21:07:42.928052
7629,18,59,6,61,93,237,2022-03-20 21:07:46.773798
7633,12,75,5,62,122,276,2022-03-20 21:07:47.883735
7643,303,705,172,289,884,2353,2022-03-20 21:07:51.910107
7645,2248,12091,2062,1580,9483,27464,2022-03-20 21:07:52.211999
7646,23,110,12,96,276,517,2022-03-20 21:07:53.605117
7647,18004,168274,16067,17819,103790,323954,2022-03-20 21:07:54.529448
7651,315,2674,210,162,6376,9737,2022-03-20 21:07:55.081874
7654,172,4196,145,185,3442,8140,2022-03-20 21:07:55.607254
7655,1876,44359,854,646,9121,56856,2022-03-20 21:07:56.53788
7662,6576,65613,4613,5452,41753,124007,2022-03-20 21:08:00.013811
7664,29,657,8,65,283,1042,2022-03-20 21:08:02.393856
7666,47,1186,34,66,620,1953,2022-03-20 21:08:02.844177
7667,35,671,29,61,515,1311,2022-03-20 21:08:03.038209
7669,299,13272,202,128,4539,18440,2022-03-20 21:08:08.170275
7674,29179,325121,22719,18783,165488,561290,2022-03-20 21:08:10.906667
7683,15,180,7,39,145,386,2022-03-20 21:08:13.516849
7691,77,956,53,67,863,2016,2022-03-20 21:08:15.179007
7695,328,58566,232,225,4425,63776,2022-03-20 21:08:17.970094
7697,32,229,13,37,278,589,2022-03-20 21:08:20.628884
7698,19,194,14,37,231,495,2022-03-20 21:08:22.150826
7705,4255,17774,3874,8081,16210,50194,2022-03-20 21:08:25.361113
7711,2980,241760,1234,412,42395,288781,2022-03-20 21:08:29.794751
7713,10,209,8,48,95,370,2022-03-20 21:08:30.00607
7718,58,1180,42,62,1423,2765,2022-03-20 21:08:30.698856
7723,124,1688,64,151,1022,3049,2022-03-20 21:08:32.809262
7724,26433,284882,17830,18144,186186,533475,2022-03-20 21:08:33.777187
7728,633,16821,357,278,11264,29353,2022-03-20 21:08:33.957068
7745,184,3864,113,99,2343,6603,2022-03-20 21:08:34.884176
7779,33,308,34,129,371,875,2022-03-20 21:08:38.101282
7782,281,10311,228,283,2917,14020,2022-03-20 21:08:42.337311
7785,23500,138166,14018,8637,197296,381617,2022-03-20 21:08:42.536528
7786,47,770,33,87,538,1475,2022-03-20 21:08:45.375005
7791,35765,410175,25505,17862,119694,609001,2022-03-20 21:08:48.762121
7793,83,527,65,100,772,1547,2022-03-20 21:08:51.046831
7803,15,91,11,49,167,333,2022-03-20 21:08:51.23305
7807,39,422,12,58,320,851,2022-03-20 21:08:55.714094
39628,9,37,11,50,88,195,2022-03-21 10:55:31.709213
7808,26,226,22,105,257,636,2022-03-20 21:08:57.169763
7810,32,774,13,39,389,1247,2022-03-20 21:08:58.256216
7811,25,1189,11,42,346,1613,2022-03-20 21:08:58.515717
7817,12279,260982,7853,14248,62380,357742,2022-03-20 21:09:05.784131
7818,62,506,28,64,777,1437,2022-03-20 21:09:07.676157
7843,31,623,13,35,375,1077,2022-03-20 21:09:09.789471
7844,14,139,9,44,275,481,2022-03-20 21:09:11.322491
7845,42,219,26,81,226,594,2022-03-20 21:09:13.306191
7856,12,95,9,48,205,369,2022-03-20 21:09:14.579534
7857,143,3008,136,151,1673,5111,2022-03-20 21:09:14.797052
7858,1618,83093,681,485,15992,101869,2022-03-20 21:09:17.890249
7861,116,1846,71,112,1316,3461,2022-03-20 21:09:18.101107
7862,40,625,21,63,322,1071,2022-03-20 21:09:18.366109
7867,132,661,121,350,608,1872,2022-03-20 21:09:21.44016
7870,855,34009,799,488,10450,46601,2022-03-20 21:09:21.633544
7877,99,1487,54,71,1914,3625,2022-03-20 21:09:26.285335
7897,475,12941,231,371,4532,18550,2022-03-20 21:09:28.637827
7900,47,631,16,64,407,1165,2022-03-20 21:09:28.834774
7914,63,271,36,75,308,753,2022-03-20 21:09:31.534408
7915,48,405,22,46,479,1000,2022-03-20 21:09:31.750831
7939,28,242,43,66,321,700,2022-03-20 21:09:32.220109
7985,53,409,18,59,348,887,2022-03-20 21:09:39.212064
8017,89,1477,66,85,896,2613,2022-03-20 21:09:40.851868
8022,389,3928,520,346,4544,9727,2022-03-20 21:09:42.95147
8023,1041,30934,702,437,10770,43884,2022-03-20 21:09:43.125311
8025,25,117,20,86,233,481,2022-03-20 21:09:45.03105
8026,130,4796,59,67,1509,6561,2022-03-20 21:09:45.204846
8063,1834,54032,695,586,8665,65812,2022-03-20 21:09:49.381729
8064,83,1178,28,70,1099,2458,2022-03-20 21:09:49.880374
8068,398,11949,345,335,7865,20892,2022-03-20 21:09:50.83871
8078,482,8504,327,269,3154,12736,2022-03-20 21:09:51.189134
8101,1490,13844,783,996,9724,26837,2022-03-20 21:09:53.256579
8109,36,983,26,70,611,1726,2022-03-20 21:09:53.61072
8133,120,3885,67,116,1619,5807,2022-03-20 21:09:54.800912
8150,31,410,29,62,321,853,2022-03-20 21:09:58.620058
8152,36,357,34,67,432,926,2022-03-20 21:10:01.036472
8153,25,286,25,65,364,765,2022-03-20 21:10:03.053963
8155,27,239,23,66,342,697,2022-03-20 21:10:05.439222
8157,36,357,30,56,357,836,2022-03-20 21:10:07.942483
8162,55,537,27,42,565,1226,2022-03-20 21:10:10.976579
8171,382,13490,243,332,4644,19091,2022-03-20 21:10:11.424871
8176,22,323,12,66,190,613,2022-03-20 21:10:12.857174
8178,26,431,19,44,412,932,2022-03-20 21:10:14.50616
8179,20,115,17,100,152,404,2022-03-20 21:10:15.697895
8180,22,286,21,55,341,725,2022-03-20 21:10:16.990923
8181,42,758,21,62,552,1435,2022-03-20 21:10:18.541836
8183,19,213,12,88,139,471,2022-03-20 21:10:21.129497
8184,23,144,18,84,188,457,2022-03-20 21:10:22.267777
8191,21,70,18,49,195,353,2022-03-20 21:10:30.86338
8192,17,60,8,37,116,238,2022-03-20 21:10:31.080859
8194,48,299,41,128,493,1009,2022-03-20 21:10:32.566065
8195,16,130,13,64,146,369,2022-03-20 21:10:33.858458
8196,18,200,13,80,245,556,2022-03-20 21:10:34.037146
8197,428,19793,377,203,4466,25267,2022-03-20 21:10:34.554831
8215,81,263,41,85,809,1279,2022-03-20 21:10:37.312597
8216,105,589,64,150,619,1527,2022-03-20 21:10:39.236398
8217,564,5851,464,552,2828,10259,2022-03-20 21:10:39.416877
8218,14,263,9,31,287,604,2022-03-20 21:10:41.054037
8227,18,277,13,74,222,604,2022-03-20 21:10:44.506668
8228,72,1030,38,43,793,1976,2022-03-20 21:10:44.769356
8234,253,2757,246,385,1896,5537,2022-03-20 21:10:45.643265
8245,104,3986,76,128,1431,5725,2022-03-20 21:10:49.330183
8246,1966,195039,800,560,18269,216634,2022-03-20 21:10:49.517231
8247,1999,159389,884,508,20805,183585,2022-03-20 21:10:52.281721
8249,92,1682,40,62,1064,2940,2022-03-20 21:10:57.011964
8250,83,1634,50,57,977,2801,2022-03-20 21:10:57.235336
8258,13,74,9,65,138,299,2022-03-20 21:10:59.062337
8277,9379,97356,5475,8068,45665,165943,2022-03-20 21:11:01.848754
8278,189,4448,103,134,2568,7442,2022-03-20 21:11:02.025081
8285,51,344,37,132,442,1006,2022-03-20 21:11:03.941357
8287,280,1867,227,494,1425,4293,2022-03-20 21:11:07.341371
8297,89,2555,47,105,1015,3811,2022-03-20 21:11:07.787854
8302,937,23662,517,520,5832,31468,2022-03-20 21:11:07.965294
8304,33,368,17,32,461,911,2022-03-20 21:11:08.222382
8312,38,1523,24,36,775,2396,2022-03-20 21:11:10.953489
8314,29,415,21,63,321,849,2022-03-20 21:11:12.497375
8316,20,247,14,68,267,616,2022-03-20 21:11:14.058431
8317,234,4897,212,163,4496,10002,2022-03-20 21:11:14.251674
8324,25,228,8,44,262,567,2022-03-20 21:11:17.090868
8331,140,8046,117,145,2190,10638,2022-03-20 21:11:19.881984
8333,17,773,9,42,206,1047,2022-03-20 21:11:22.341378
8337,123,2816,55,65,1925,4984,2022-03-20 21:11:23.170258
8345,18,99,9,79,135,340,2022-03-20 21:11:25.445712
8346,11,71,6,61,87,236,2022-03-20 21:11:26.630272
8348,352,14727,310,266,5872,21527,2022-03-20 21:11:26.790254
8356,17,142,12,81,161,413,2022-03-20 21:11:27.361114
8364,60,2519,43,95,602,3319,2022-03-20 21:11:28.602811
8373,47,2382,54,173,302,2958,2022-03-20 21:11:31.748939
8375,57,289,72,135,391,944,2022-03-20 21:11:33.195492
8403,14,153,9,75,155,406,2022-03-20 21:11:34.848713
8407,7117,217966,3645,4033,36487,269248,2022-03-20 21:11:35.058121
8415,26,135,14,63,270,508,2022-03-20 21:11:37.645398
8416,22,211,12,67,181,493,2022-03-20 21:11:40.028677
8422,697,26170,366,386,10900,38519,2022-03-20 21:11:45.135929
8425,28676,246076,23234,21656,166536,486178,2022-03-20 21:11:51.936808
40054,0,0,0,0,16712,16712,2022-03-21 10:59:26.029087
49891,0,0,0,0,5479,5479,2022-03-21 12:20:28.150966
8426,6465,44406,5224,5010,56772,117877,2022-03-20 21:11:52.142434
8436,61,235,46,107,723,1172,2022-03-20 21:11:54.323768
8438,114,6177,125,147,2292,8855,2022-03-20 21:11:55.047445
8440,964,42024,641,685,13412,57726,2022-03-20 21:11:57.705308
8442,36,197,22,60,478,793,2022-03-20 21:11:59.453637
8443,34,328,17,51,378,808,2022-03-20 21:12:00.717935
8449,4511,43436,3073,6383,25001,82404,2022-03-20 21:12:01.937925
8450,44,259,33,53,917,1306,2022-03-20 21:12:03.54635
8451,21,265,15,44,375,720,2022-03-20 21:12:05.056775
8457,1588,20328,840,464,13345,36565,2022-03-20 21:12:10.561014
8460,3888,174247,1564,1923,30285,211907,2022-03-20 21:12:11.035441
8465,1211,37195,624,582,7623,47235,2022-03-20 21:12:14.955355
8475,620,17495,334,374,11505,30328,2022-03-20 21:12:18.103727
8476,5840,60465,3779,4243,38528,112855,2022-03-20 21:12:18.456861
8478,20,96,17,68,167,368,2022-03-20 21:12:20.009671
8479,6756,70303,5122,4465,18268,104914,2022-03-20 21:12:20.214024
8481,961,16530,623,414,8906,27434,2022-03-20 21:12:23.862677
8486,21,456,8,40,496,1021,2022-03-20 21:12:24.035169
8490,99,5486,95,211,1918,7809,2022-03-20 21:12:31.907772
8491,110,3647,120,158,1987,6022,2022-03-20 21:12:32.117804
8492,15,76,7,52,82,232,2022-03-20 21:12:34.742654
8495,20,116,15,45,328,524,2022-03-20 21:12:38.671509
8496,31,520,11,33,332,927,2022-03-20 21:12:40.015671
8500,68,700,31,51,976,1826,2022-03-20 21:12:40.456524
8501,14,112,10,90,148,374,2022-03-20 21:12:41.563368
8503,217,572,156,140,1561,2646,2022-03-20 21:12:41.754125
8524,28,170,21,57,308,584,2022-03-20 21:12:46.767652
8525,21911,394759,14345,16908,123926,571849,2022-03-20 21:12:49.715091
8532,410,21293,201,184,5381,27469,2022-03-20 21:12:51.43979
8533,53,701,35,43,1138,1970,2022-03-20 21:12:53.527741
8536,4373,78232,2597,3974,20891,110067,2022-03-20 21:12:57.299534
8538,162,991,105,178,1178,2614,2022-03-20 21:13:00.817628
8539,61,269,24,76,705,1135,2022-03-20 21:13:01.000814
8547,36,632,26,59,497,1250,2022-03-20 21:13:06.020339
8548,30,575,25,53,466,1149,2022-03-20 21:13:07.601196
8550,35,559,28,58,495,1175,2022-03-20 21:13:09.408242
8551,41,664,24,61,485,1275,2022-03-20 21:13:10.804075
8553,48,412,31,122,354,967,2022-03-20 21:13:12.069242
8557,8569,102143,7557,7985,53627,179881,2022-03-20 21:13:16.546478
8560,1392,21810,675,775,6976,31628,2022-03-20 21:13:19.5154
8561,22,118,6,42,220,408,2022-03-20 21:13:21.01169
8563,30,150,19,58,489,746,2022-03-20 21:13:21.187595
8577,1602,59914,766,991,8449,71722,2022-03-20 21:13:25.294422
8584,75,748,37,63,1075,1998,2022-03-20 21:13:27.006321
8595,23,90,10,58,154,335,2022-03-20 21:13:28.317558
8598,46,357,29,61,811,1304,2022-03-20 21:13:29.771553
8599,470,11943,276,177,5094,17960,2022-03-20 21:13:31.937658
8603,18,590,10,31,316,965,2022-03-20 21:13:32.117645
8604,16,560,5,48,105,734,2022-03-20 21:13:32.380217
8609,291,13363,142,192,2744,16732,2022-03-20 21:13:32.636987
8628,18,922,3,34,160,1137,2022-03-20 21:13:33.368521
8644,17,122,7,53,120,319,2022-03-20 21:13:36.06818
8645,7,331,3,31,72,444,2022-03-20 21:13:36.270157
8659,11,397,5,31,118,562,2022-03-20 21:13:37.001336
8668,616,8442,471,511,5738,15778,2022-03-20 21:13:38.173962
8680,7,178,4,57,67,313,2022-03-20 21:13:45.414324
8681,9,375,4,40,73,501,2022-03-20 21:13:46.536587
8682,14,450,5,23,131,623,2022-03-20 21:13:46.972604
8685,20,100,14,97,118,349,2022-03-20 21:13:47.16701
8687,6568,3,2653,3332,3428,15984,2022-03-20 21:13:47.431838
8701,24,910,10,54,311,1309,2022-03-20 21:13:49.964712
8704,13,419,2,39,86,559,2022-03-20 21:13:50.173689
8705,242,2823,184,226,3786,7261,2022-03-20 21:13:52.663334
8706,56,342,42,75,483,998,2022-03-20 21:13:54.021382
8707,31,288,19,58,246,642,2022-03-20 21:13:54.235985
8709,84,3959,98,130,1773,6044,2022-03-20 21:13:54.697091
8717,7,369,3,30,125,534,2022-03-20 21:13:58.383353
8718,11,300,5,29,95,440,2022-03-20 21:13:58.597331
8719,9,264,4,39,90,406,2022-03-20 21:13:59.789107
8723,34,143,18,66,465,726,2022-03-20 21:14:01.48728
8724,8,191,4,32,77,312,2022-03-20 21:14:01.686856
8754,110,1984,94,86,2042,4316,2022-03-20 21:14:06.856078
8756,351,10143,280,229,5246,16249,2022-03-20 21:14:07.33723
8763,30,269,24,95,231,649,2022-03-20 21:14:09.790756
8764,25,371,16,76,136,624,2022-03-20 21:14:11.356762
8767,114,2049,84,80,1437,3764,2022-03-20 21:14:14.965066
8768,1850,67325,635,452,19128,89390,2022-03-20 21:14:15.163296
8769,21063,453599,11885,22701,121767,631015,2022-03-20 21:14:18.303286
8772,7,211,8,31,53,310,2022-03-20 21:14:18.479386
8773,7,249,4,30,56,346,2022-03-20 21:14:18.754437
8774,18,404,8,96,246,772,2022-03-20 21:14:21.01461
8777,31,179,29,78,315,632,2022-03-20 21:14:21.574511
8778,9,334,6,49,90,488,2022-03-20 21:14:25.10755
8783,27,437,16,64,316,860,2022-03-20 21:14:27.788502
8786,34,219,27,120,190,590,2022-03-20 21:14:28.930113
8792,85,8154,39,40,852,9170,2022-03-20 21:14:31.091651
8795,19131,204858,16048,15794,80896,336727,2022-03-20 21:14:34.472243
8799,29,144,22,66,283,544,2022-03-20 21:14:36.298051
8812,75,350,49,117,1096,1687,2022-03-20 21:14:38.733401
8815,43,874,37,117,342,1413,2022-03-20 21:14:40.882708
8829,45,156,27,107,212,547,2022-03-20 21:14:41.078995
8832,18,128,16,83,141,386,2022-03-20 21:14:41.544107
8839,88,1052,87,134,1846,3207,2022-03-20 21:14:41.807787
8842,24,277,12,39,298,650,2022-03-20 21:14:43.612409
8848,24,259,9,40,288,620,2022-03-20 21:14:46.097447
8853,50,143,47,84,341,665,2022-03-20 21:14:47.282713
8855,58,498,37,61,674,1328,2022-03-20 21:14:49.962178
8857,1102,57776,604,310,16855,76647,2022-03-20 21:14:50.136023
8861,17651,291537,8896,22101,96809,436994,2022-03-20 21:14:53.081316
40209,7,164,1,11,46,229,2022-03-21 11:01:41.64991
8876,4731,52120,2352,1730,24462,85395,2022-03-20 21:14:56.609498
8879,12,106,13,89,172,392,2022-03-20 21:14:58.149989
8883,26,117,15,40,276,474,2022-03-20 21:14:59.388135
8888,2990,116436,1642,1201,44503,166772,2022-03-20 21:14:59.567486
8889,49,722,25,51,528,1375,2022-03-20 21:14:59.82408
8890,68,225,40,73,810,1216,2022-03-20 21:15:01.851614
8894,110,7927,70,92,2092,10291,2022-03-20 21:15:03.960297
8896,32,376,14,44,477,943,2022-03-20 21:15:05.933348
8897,19,165,16,83,187,470,2022-03-20 21:15:07.091844
8898,48,596,18,49,484,1195,2022-03-20 21:15:08.889345
8900,22,186,26,75,254,563,2022-03-20 21:15:12.245666
8908,115,3293,90,78,1990,5566,2022-03-20 21:15:14.263759
8909,243,4319,175,104,2493,7334,2022-03-20 21:15:14.602902
8915,7018,66488,6047,6943,51154,137650,2022-03-20 21:15:15.134921
8917,5187,27953,4862,7863,23973,69838,2022-03-20 21:15:15.577939
8921,19,666,20,62,301,1068,2022-03-20 21:15:21.531974
8925,24,1060,5,37,188,1314,2022-03-20 21:15:22.923792
8934,7069,50629,5496,7945,34628,105767,2022-03-20 21:15:24.733405
8935,17,1108,9,37,275,1446,2022-03-20 21:15:28.639721
8936,21,943,15,37,481,1497,2022-03-20 21:15:30.659023
8949,40,811,26,62,502,1441,2022-03-20 21:15:33.946721
8950,81,1105,54,99,1414,2753,2022-03-20 21:15:36.767997
8952,37,1130,10,38,322,1537,2022-03-20 21:15:39.32556
8953,27,243,18,62,371,721,2022-03-20 21:15:40.6712
8956,32,289,22,85,203,631,2022-03-20 21:15:42.473309
8957,12,174,8,39,88,321,2022-03-20 21:15:43.989973
8959,16,95,7,42,114,274,2022-03-20 21:15:45.557866
8960,52,361,67,111,630,1221,2022-03-20 21:15:45.761942
8961,100,1850,64,211,971,3196,2022-03-20 21:15:46.026422
8968,24,623,6,38,164,855,2022-03-20 21:15:47.022361
9000,2149,34495,754,344,28609,66351,2022-03-20 21:15:51.532109
9002,109,4808,105,115,2207,7344,2022-03-20 21:15:52.157336
9007,15,162,10,70,111,368,2022-03-20 21:15:56.067275
9013,69,514,42,87,613,1325,2022-03-20 21:15:56.54519
9014,1592,25838,776,751,9992,38949,2022-03-20 21:15:56.812701
9047,974,48124,551,239,12788,62676,2022-03-20 21:15:58.959245
9070,30,122,17,76,106,351,2022-03-20 21:16:01.420917
9074,5992,101404,5208,4255,34620,151479,2022-03-20 21:16:04.389234
9077,90,628,40,64,1086,1908,2022-03-20 21:16:07.394557
9078,54,282,24,65,609,1034,2022-03-20 21:16:07.931446
9087,48,703,43,109,809,1712,2022-03-20 21:16:09.928558
9088,627,5864,317,262,5412,12482,2022-03-20 21:16:10.964135
9095,27,471,9,46,239,792,2022-03-20 21:16:12.533313
9098,49,722,47,105,899,1822,2022-03-20 21:16:14.919134
9106,32,366,25,73,318,814,2022-03-20 21:16:17.166094
9107,3255,66326,3328,6450,8606,87965,2022-03-20 21:16:19.938643
9117,1103,40019,739,475,11261,53597,2022-03-20 21:16:22.591785
9119,28,448,17,109,170,772,2022-03-20 21:16:24.084853
9120,735,26037,405,346,8145,35668,2022-03-20 21:16:26.673515
9124,106,5558,79,97,1932,7772,2022-03-20 21:16:29.019102
9127,96,1217,67,94,1298,2772,2022-03-20 21:16:29.286359
9130,2418,51930,1167,930,11247,67692,2022-03-20 21:16:31.739893
9136,3579,86856,2567,1630,19984,114616,2022-03-20 21:16:35.389611
9159,725,6988,399,277,3889,12278,2022-03-20 21:16:36.038377
9164,33,310,18,85,298,744,2022-03-20 21:16:38.221741
9165,27,323,21,87,304,762,2022-03-20 21:16:39.253175
9166,31,316,18,88,295,748,2022-03-20 21:16:41.232018
9167,139,2241,107,138,1309,3934,2022-03-20 21:16:44.165613
9170,123,3574,128,141,2141,6107,2022-03-20 21:16:45.502548
9172,24,351,14,61,254,704,2022-03-20 21:16:48.082689
9175,17,211,9,90,140,467,2022-03-20 21:16:49.24023
9181,7946,237924,3816,4138,45342,299166,2022-03-20 21:16:53.163552
9201,2312,45185,1239,898,12401,62035,2022-03-20 21:16:59.130499
9202,753,16565,377,321,7579,25595,2022-03-20 21:17:02.337971
9203,863,27374,726,687,10458,40108,2022-03-20 21:17:05.156712
9204,428,8928,169,209,7015,16749,2022-03-20 21:17:07.649596
9205,1200,4568,629,669,2162,9228,2022-03-20 21:17:07.839132
9212,18,105,17,46,290,476,2022-03-20 21:17:10.054758
9213,761,21065,337,218,11266,33647,2022-03-20 21:17:12.891599
9220,243,6350,175,139,2956,9863,2022-03-20 21:17:15.146831
9221,31,417,13,37,199,697,2022-03-20 21:17:17.078326
9228,32,450,15,78,406,981,2022-03-20 21:17:17.507453
9232,362,6348,151,231,1751,8843,2022-03-20 21:17:17.753255
9243,27,354,19,53,260,713,2022-03-20 21:17:19.939236
9264,39,544,23,50,362,1018,2022-03-20 21:17:24.028419
9284,32,160,29,117,300,638,2022-03-20 21:17:25.083233
9303,20,180,5,52,119,376,2022-03-20 21:17:27.968687
9314,3368,40279,2904,4123,27604,78278,2022-03-20 21:17:28.178557
9333,162,5050,84,82,2275,7653,2022-03-20 21:17:33.412202
9334,15,66,6,47,215,349,2022-03-20 21:17:33.875381
9335,413,8531,245,265,4320,13774,2022-03-20 21:17:34.412133
9337,66,365,26,49,935,1441,2022-03-20 21:17:34.588269
9340,31,751,19,65,450,1316,2022-03-20 21:17:35.186194
9348,38,777,31,75,573,1494,2022-03-20 21:17:36.345474
9365,47,392,24,57,430,950,2022-03-20 21:17:37.627745
9385,40,331,14,54,314,753,2022-03-20 21:17:38.745098
9404,16,73,3,53,123,268,2022-03-20 21:17:43.334429
9409,51,264,37,59,485,896,2022-03-20 21:17:45.554852
9416,12,158,5,55,126,356,2022-03-20 21:17:45.789875
9417,10,129,3,48,109,299,2022-03-20 21:17:47.033623
9423,13,478,4,21,231,747,2022-03-20 21:17:51.634335
9424,35,300,16,79,169,599,2022-03-20 21:17:51.842264
9426,20,95,17,64,169,365,2022-03-20 21:17:53.39497
9433,34,246,21,120,219,640,2022-03-20 21:17:54.942464
9441,960,31052,643,748,4513,37916,2022-03-20 21:17:56.422999
9445,45,275,27,43,409,799,2022-03-20 21:17:58.48392
9446,15,150,8,68,110,351,2022-03-20 21:17:59.714648
9447,11,98,5,55,108,277,2022-03-20 21:18:00.952904
9451,11,144,7,68,107,337,2022-03-20 21:18:02.248936
9465,564,46986,336,223,7479,55588,2022-03-20 21:18:06.818994
9471,1677,98648,843,608,16286,118062,2022-03-20 21:18:07.449716
9488,612,7230,259,126,26124,34351,2022-03-20 21:18:10.579002
9491,67,1054,28,39,793,1981,2022-03-20 21:18:13.529882
9493,1060,6158,958,2080,6395,16651,2022-03-20 21:18:15.833208
9495,38,334,18,50,608,1048,2022-03-20 21:18:19.951803
9496,24,141,8,43,256,472,2022-03-20 21:18:21.245184
9499,110,536,63,104,758,1571,2022-03-20 21:18:24.228075
9500,33,119,16,41,231,440,2022-03-20 21:18:25.520529
9501,22,163,10,45,196,436,2022-03-20 21:18:25.966434
9506,98,1660,53,74,962,2847,2022-03-20 21:18:26.760677
9519,47,209,19,56,513,844,2022-03-20 21:18:31.441656
9520,42,178,36,106,346,708,2022-03-20 21:18:33.384974
9521,44,463,16,81,344,948,2022-03-20 21:18:34.720543
9523,77,1977,46,70,1064,3234,2022-03-20 21:18:35.530239
9525,36,239,18,46,391,730,2022-03-20 21:18:35.78319
9540,18,107,9,70,146,350,2022-03-20 21:18:38.376572
9562,21,60,8,86,127,302,2022-03-20 21:18:44.62882
9563,203,9878,161,158,3272,13672,2022-03-20 21:18:46.992243
9566,40,1019,12,43,356,1470,2022-03-20 21:18:47.461841
9568,103,1185,56,57,1239,2640,2022-03-20 21:18:47.88982
9575,22,273,6,48,146,495,2022-03-20 21:18:48.073003
9587,4191,48854,2371,6075,21956,83447,2022-03-20 21:18:52.956495
9591,341,8497,327,453,5878,15496,2022-03-20 21:18:53.174868
9595,69,682,57,45,1464,2317,2022-03-20 21:18:55.186725
9598,815,15922,587,999,8745,27068,2022-03-20 21:18:57.53561
9606,10,61,3,51,60,185,2022-03-20 21:18:59.394087
9608,313,10438,124,100,4545,15520,2022-03-20 21:18:59.607408
9611,2019,11958,702,388,5498,20565,2022-03-20 21:18:59.784076
9618,911,32993,438,347,8517,43206,2022-03-20 21:19:00.609337
9646,153,1210,41,79,1408,2891,2022-03-20 21:19:04.593368
9650,27,343,15,37,257,679,2022-03-20 21:19:04.789791
9656,10771,310147,6686,4751,65338,397693,2022-03-20 21:19:05.049779
9665,31,119,17,62,377,606,2022-03-20 21:19:08.949909
9667,24,812,7,24,220,1087,2022-03-20 21:19:09.165469
9673,203,1553,192,141,3109,5198,2022-03-20 21:19:11.996227
9675,910,46108,469,302,12176,59965,2022-03-20 21:19:14.34101
9689,115,344,102,230,728,1519,2022-03-20 21:19:16.938415
9690,364,13920,203,208,3921,18616,2022-03-20 21:19:20.528495
9691,55,331,32,55,528,1001,2022-03-20 21:19:21.521957
9693,919,10225,872,1529,7193,20738,2022-03-20 21:19:21.705547
9706,189,3424,194,147,3885,7839,2022-03-20 21:19:24.127962
9708,109,2551,72,115,1635,4482,2022-03-20 21:19:24.317307
9712,3389,35201,3078,3352,16168,61188,2022-03-20 21:19:27.141544
9716,131,2950,134,165,2294,5674,2022-03-20 21:19:29.123502
9723,320,8154,185,181,4344,13184,2022-03-20 21:19:29.580868
9731,269,10406,148,226,2226,13275,2022-03-20 21:19:32.850716
9732,21,1338,4,32,189,1584,2022-03-20 21:19:34.456009
9733,35,3071,10,31,396,3543,2022-03-20 21:19:34.655293
9734,1407,91060,775,368,18488,112098,2022-03-20 21:19:37.184629
9735,856,25879,430,383,10373,37921,2022-03-20 21:19:38.106205
9736,5898,84897,3634,6694,32554,133677,2022-03-20 21:19:38.298345
9737,858,4579,780,1310,5837,13364,2022-03-20 21:19:38.567708
9741,1227,14612,510,649,5845,22843,2022-03-20 21:19:44.064356
9744,282,6848,140,165,2615,10050,2022-03-20 21:19:46.339614
9745,551,18170,292,229,8318,27560,2022-03-20 21:19:47.345466
9748,24,204,15,52,301,596,2022-03-20 21:19:48.693695
9750,7135,72525,5101,8557,30805,124123,2022-03-20 21:19:50.04711
9751,836,24681,463,342,12633,38955,2022-03-20 21:19:50.518323
9754,263,8773,192,133,5279,14640,2022-03-20 21:19:50.688781
9761,653,13574,191,324,4254,18996,2022-03-20 21:19:51.403197
9781,38,165,22,83,321,629,2022-03-20 21:19:53.677239
9790,2327,96012,1067,829,24211,124446,2022-03-20 21:19:57.227359
9792,39,378,15,52,477,961,2022-03-20 21:19:58.692597
9793,633,8004,362,213,5276,14488,2022-03-20 21:19:58.868233
9794,19,322,18,55,278,692,2022-03-20 21:19:59.112468
9798,103,2427,70,79,2153,4832,2022-03-20 21:20:02.114256
9799,73,564,34,133,686,1490,2022-03-20 21:20:04.094866
9806,301,674,102,200,1889,3166,2022-03-20 21:20:07.959446
9807,11,103,9,67,75,265,2022-03-20 21:20:11.120803
9811,23,110,10,62,134,339,2022-03-20 21:20:12.24247
9812,17,96,7,65,132,317,2022-03-20 21:20:14.35895
9817,17,186,7,51,118,379,2022-03-20 21:20:16.330521
9818,11,139,5,48,78,281,2022-03-20 21:20:17.425086
9819,11,110,4,47,88,260,2022-03-20 21:20:19.705843
9821,15,106,5,54,75,255,2022-03-20 21:20:21.839141
9825,15,104,4,50,109,282,2022-03-20 21:20:26.946574
9826,29,371,7,44,337,788,2022-03-20 21:20:27.206911
9837,77,613,30,48,737,1505,2022-03-20 21:20:31.419554
9839,142,3116,99,141,1901,5399,2022-03-20 21:20:31.626561
9846,48,1227,33,58,703,2069,2022-03-20 21:20:31.914378
9857,30,551,14,88,255,938,2022-03-20 21:20:39.463501
9858,35,509,16,79,302,941,2022-03-20 21:20:39.672801
9861,68,1109,64,76,1118,2435,2022-03-20 21:20:40.220695
9862,33,240,19,49,231,572,2022-03-20 21:20:40.650583
9865,247,7836,185,185,4463,12916,2022-03-20 21:20:45.063416
9866,28,174,15,56,478,751,2022-03-20 21:20:47.393355
9868,17,137,9,63,100,326,2022-03-20 21:20:49.636751
9869,8,99,3,42,87,239,2022-03-20 21:20:52.369399
9874,10218,996,5079,1570,17152,35015,2022-03-20 21:20:52.55501
9878,24,207,12,54,212,509,2022-03-20 21:20:55.123402
9879,12,152,3,40,96,303,2022-03-20 21:20:56.328497
9881,28,251,18,92,214,603,2022-03-20 21:20:58.582378
9882,60,193,37,72,685,1047,2022-03-20 21:21:00.40343
9883,549,1279,552,520,2569,5469,2022-03-20 21:21:02.976053
9884,250,717,308,364,1601,3240,2022-03-20 21:21:05.342907
9886,9,91,7,47,105,259,2022-03-20 21:21:07.930544
9888,303,16756,215,129,4573,21976,2022-03-20 21:21:10.360948
9890,452,22144,196,257,4766,27815,2022-03-20 21:21:10.80025
9893,1008,6540,837,878,4497,13760,2022-03-20 21:21:13.267789
9903,13,83,3,60,62,221,2022-03-20 21:21:18.399125
9905,27,240,18,93,304,682,2022-03-20 21:21:19.65094
9907,364,13965,154,231,4108,18822,2022-03-20 21:21:20.455554
9922,4744,39004,3281,5996,28839,81864,2022-03-20 21:21:25.467045
9924,173,3793,116,103,1568,5753,2022-03-20 21:21:25.92391
9925,564,41176,364,219,8044,50367,2022-03-20 21:21:28.696127
9926,6949,155278,3326,5071,29118,199742,2022-03-20 21:21:29.034013
9931,97,1468,53,67,1717,3402,2022-03-20 21:21:29.831336
9934,1226,7885,940,1816,7275,19142,2022-03-20 21:21:32.35348
9935,666,1906,561,486,3936,7555,2022-03-20 21:21:32.523967
9936,13072,164521,5771,11184,61745,256293,2022-03-20 21:21:35.109536
9938,2890,26976,2704,3039,19431,55040,2022-03-20 21:21:35.561642
9940,50,901,24,54,652,1681,2022-03-20 21:21:36.020313
9941,12086,98033,9859,10314,75396,205688,2022-03-20 21:21:38.666337
9943,334,715,315,227,1622,3213,2022-03-20 21:21:39.100324
40425,3,40,6,34,198,281,2022-03-21 11:04:14.144721
9944,102,215,101,101,654,1173,2022-03-20 21:21:39.285568
9955,9,74,6,63,74,226,2022-03-20 21:21:43.153659
9956,11,41,4,44,52,152,2022-03-20 21:21:44.824926
9958,628,24054,425,317,9555,34979,2022-03-20 21:21:47.482784
9959,48,285,25,55,1013,1426,2022-03-20 21:21:47.681186
9963,545,36716,243,275,4216,41995,2022-03-20 21:21:50.437771
9965,17,125,4,43,124,313,2022-03-20 21:21:52.326387
9967,66,742,42,51,578,1479,2022-03-20 21:21:54.137615
9969,32412,233354,13005,8577,167562,454910,2022-03-20 21:21:54.583728
9972,34,332,22,62,352,802,2022-03-20 21:21:54.755333
9973,9,234,7,76,115,441,2022-03-20 21:21:56.526548
9976,19,638,9,34,171,871,2022-03-20 21:21:57.883363
9978,51,249,31,98,411,840,2022-03-20 21:21:58.058861
9988,708,8527,334,317,6241,16127,2022-03-20 21:21:59.241405
9999,682,41239,427,419,7918,50685,2022-03-20 21:22:00.403663
10015,4000,42984,3204,7524,8992,66704,2022-03-20 21:22:06.544536
10016,109,4296,52,58,1421,5936,2022-03-20 21:22:07.019637
10017,398,32159,272,242,4228,37299,2022-03-20 21:22:09.594232
10020,2738,153016,1276,1051,19194,177275,2022-03-20 21:22:10.042828
10029,2144,121832,1017,403,37424,162820,2022-03-20 21:22:10.222592
10030,10643,245519,7027,4189,55914,323292,2022-03-20 21:22:11.920235
10033,14474,42541,10265,12881,34664,114825,2022-03-20 21:22:12.117064
10036,53,556,30,50,824,1513,2022-03-20 21:22:12.291947
50228,0,0,0,0,0,0,2022-03-21 12:23:39.336896
50229,0,0,0,0,0,0,2022-03-21 12:23:40.158269
10050,79,2735,66,91,1439,4410,2022-03-20 21:22:17.034872
10056,10,139,5,66,93,313,2022-03-20 21:22:20.17646
10057,10,140,5,64,96,315,2022-03-20 21:22:22.047425
10058,15,164,5,66,98,348,2022-03-20 21:22:23.080221
10059,10,165,10,69,141,395,2022-03-20 21:22:24.404596
10060,13,139,5,66,94,317,2022-03-20 21:22:25.880603
10061,13,155,5,70,98,341,2022-03-20 21:22:27.992274
10073,4878,80687,3264,5673,30731,125233,2022-03-20 21:22:28.606952
10075,795,37180,406,372,8776,47529,2022-03-20 21:22:31.802101
10077,25,222,12,47,209,515,2022-03-20 21:22:34.852594
10079,6711,112466,3282,4711,34044,161214,2022-03-20 21:22:35.081886
10080,8625,296039,5341,4007,44977,358989,2022-03-20 21:22:35.339
10083,966,51284,562,291,12065,65168,2022-03-20 21:22:35.605643
10112,20,182,17,52,305,576,2022-03-20 21:22:40.392913
10114,38,332,15,61,219,665,2022-03-20 21:22:46.057976
10115,34,595,12,71,423,1135,2022-03-20 21:22:46.266283
10118,24,222,37,71,397,751,2022-03-20 21:22:48.134971
10119,10754,77993,5333,1849,22432,118361,2022-03-20 21:22:50.800194
10122,131,7663,88,57,1840,9779,2022-03-20 21:22:50.981848
10132,15,523,5,29,133,705,2022-03-20 21:22:51.502018
10135,30,222,22,93,165,532,2022-03-20 21:22:53.366856
10136,18,150,11,71,106,356,2022-03-20 21:22:55.765243
10138,15,168,15,78,117,393,2022-03-20 21:22:58.783406
10139,27,201,10,96,185,519,2022-03-20 21:23:00.080495
10149,17,137,3,38,93,288,2022-03-20 21:23:01.334816
10152,912,50372,626,325,13544,65779,2022-03-20 21:23:04.116904
10153,564,13764,297,258,7138,22021,2022-03-20 21:23:06.793327
10155,7916,107112,5468,11466,44564,176526,2022-03-20 21:23:06.967469
10156,4350,41359,2799,5661,19893,74062,2022-03-20 21:23:07.226259
10163,11111,174173,7831,10272,73194,276581,2022-03-20 21:23:14.347013
10165,77393,338411,57909,29377,266644,769734,2022-03-20 21:23:14.87857
50275,0,0,0,0,32102,32102,2022-03-21 12:24:04.747268
50276,0,0,0,0,0,0,2022-03-21 12:24:05.743248
10172,966,34443,541,552,6197,42699,2022-03-20 21:23:17.280137
10178,1479,7095,859,472,9983,19888,2022-03-20 21:23:20.878535
10180,195,2517,97,125,2459,5393,2022-03-20 21:23:27.36911
10187,2255,20384,1641,3149,14958,42387,2022-03-20 21:23:29.749503
10189,403,16858,303,266,7163,24993,2022-03-20 21:23:30.316774
10194,48,253,18,74,408,801,2022-03-20 21:23:36.57131
10196,814,19510,299,276,6762,27661,2022-03-20 21:23:36.773125
10197,1214,17545,782,1900,4899,26340,2022-03-20 21:23:39.83335
10199,38,261,22,52,304,677,2022-03-20 21:23:41.112572
10201,70,1297,55,61,944,2427,2022-03-20 21:23:43.256779
10202,30,411,11,48,232,732,2022-03-20 21:23:44.888916
10203,11,104,4,62,91,272,2022-03-20 21:23:46.57289
10207,34,639,23,36,507,1239,2022-03-20 21:23:48.012949
10209,3658,100907,1950,902,17469,124886,2022-03-20 21:23:48.192574
10210,17,141,25,78,213,474,2022-03-20 21:23:50.294236
10213,15481,157021,7593,11422,78996,270513,2022-03-20 21:23:52.549558
10216,3079,39672,1750,2443,23822,70766,2022-03-20 21:23:52.724711
10217,503,2616,340,900,3568,7927,2022-03-20 21:23:56.161057
10218,2581,165551,880,828,24683,194523,2022-03-20 21:23:56.59846
10219,260,10670,138,140,3154,14362,2022-03-20 21:23:59.74753
10224,51,277,40,110,452,930,2022-03-20 21:24:01.286537
10232,2423,14363,2056,2233,21717,42792,2022-03-20 21:24:04.052109
10236,13,94,8,68,141,324,2022-03-20 21:24:04.236352
10238,17,104,13,62,131,327,2022-03-20 21:24:05.853447
10239,10,74,6,48,79,217,2022-03-20 21:24:08.143914
10241,21,345,11,109,140,626,2022-03-20 21:24:09.553451
10242,13,62,4,63,62,204,2022-03-20 21:24:10.562358
10246,9,85,4,56,66,220,2022-03-20 21:24:14.15614
10247,12,84,7,53,75,231,2022-03-20 21:24:15.244724
10249,839,23865,543,344,10583,36174,2022-03-20 21:24:15.676666
10250,44,757,35,178,141,1155,2022-03-20 21:24:17.925154
10258,710,7399,473,513,3167,12262,2022-03-20 21:24:23.35006
10260,812,6426,381,316,7417,15352,2022-03-20 21:24:26.65288
10261,19,151,14,61,283,528,2022-03-20 21:24:28.109418
10262,19,602,12,30,244,907,2022-03-20 21:24:29.733567
10263,58,2898,39,56,754,3805,2022-03-20 21:24:29.905892
10276,63,2852,67,93,1095,4170,2022-03-20 21:24:34.388508
10278,9629,58124,7943,8656,57735,142087,2022-03-20 21:24:35.350271
10282,34,222,18,88,259,621,2022-03-20 21:24:37.016636
10285,18,163,5,63,133,382,2022-03-20 21:24:38.122396
10294,2466,33667,940,514,33650,71237,2022-03-20 21:24:38.607359
10297,139,3169,120,63,1845,5336,2022-03-20 21:24:38.800598
10298,1255,69710,654,408,15953,87980,2022-03-20 21:24:40.553805
10301,155,2873,93,96,1772,4989,2022-03-20 21:24:40.719656
10302,129,8369,132,153,2095,10878,2022-03-20 21:24:40.991071
10323,26,102,24,55,158,365,2022-03-20 21:24:43.97057
10324,135,1285,98,167,1225,2910,2022-03-20 21:24:44.223853
10330,923,34195,514,1508,3699,40839,2022-03-20 21:24:47.348776
10335,24,133,8,35,226,426,2022-03-20 21:24:49.513089
10336,2435,19040,2203,2481,16123,42282,2022-03-20 21:24:49.730726
10338,512,2789,356,637,3092,7386,2022-03-20 21:24:50.272747
10342,51,716,31,114,607,1519,2022-03-20 21:24:51.857395
10346,49,465,33,98,620,1265,2022-03-20 21:24:53.357154
10349,53,249,32,114,162,610,2022-03-20 21:24:55.198694
10350,1077,16418,681,477,7294,25947,2022-03-20 21:24:55.412716
10359,297,1342,250,346,2278,4513,2022-03-20 21:24:58.963672
10360,40,227,12,62,244,585,2022-03-20 21:25:00.726501
10361,79,1412,62,92,1502,3147,2022-03-20 21:25:03.011104
10369,11,82,3,47,88,231,2022-03-20 21:25:04.190722
10370,648,33700,397,732,2895,38372,2022-03-20 21:25:04.36294
10372,3147,36820,2432,4070,22088,68557,2022-03-20 21:25:04.816991
10373,45,426,36,47,456,1010,2022-03-20 21:25:06.500896
10375,9,283,4,30,128,454,2022-03-20 21:25:07.89502
10378,3545,58413,2838,2093,21690,88579,2022-03-20 21:25:08.704375
10379,8465,139839,4238,2230,71707,226479,2022-03-20 21:25:09.642831
10384,702,3596,333,326,6199,11156,2022-03-20 21:25:09.812828
10396,12993,198614,8563,11880,67962,300012,2022-03-20 21:25:13.539923
10406,46,2032,21,66,550,2715,2022-03-20 21:25:20.998134
10408,14220,513096,3882,998,181815,714011,2022-03-20 21:25:27.883214
10417,1024,36456,420,580,16137,54617,2022-03-20 21:25:31.488878
10431,365,19597,289,262,6172,26685,2022-03-20 21:25:34.647485
40576,3,79,3,15,22,122,2022-03-21 11:06:11.316721
10436,15,713,10,51,198,987,2022-03-20 21:25:38.212021
10445,147,9092,54,64,1680,11037,2022-03-20 21:25:40.874281
10447,5726,54525,4081,5665,30044,100041,2022-03-20 21:25:43.531365
10448,301,16877,95,75,5898,23246,2022-03-20 21:25:47.158808
10456,10247,78270,6503,11127,61233,167380,2022-03-20 21:25:49.70895
10459,50,163,41,84,619,957,2022-03-20 21:25:49.887599
10460,8578,71861,6218,7740,74961,169358,2022-03-20 21:25:50.154042
10463,46,761,33,45,661,1546,2022-03-20 21:25:50.32845
10490,15384,173780,9128,16794,101594,316680,2022-03-20 21:25:52.374342
10504,348,8679,309,263,5634,15233,2022-03-20 21:25:53.603809
10519,274,14433,149,196,4857,19909,2022-03-20 21:25:54.781588
10531,145,6700,116,136,2004,9101,2022-03-20 21:25:55.946421
10541,35,102,18,65,353,573,2022-03-20 21:25:59.214577
10545,93,2583,53,84,1058,3871,2022-03-20 21:26:01.514341
10549,84,2187,47,91,1138,3547,2022-03-20 21:26:07.142238
10554,64,261,45,120,582,1072,2022-03-20 21:26:08.977507
10562,60,308,33,108,320,829,2022-03-20 21:26:09.158979
10563,17,139,12,80,161,409,2022-03-20 21:26:10.8673
10564,24,121,12,48,147,352,2022-03-20 21:26:12.649533
10568,11412,110612,8563,9641,83433,223661,2022-03-20 21:26:17.258266
10572,3591,42741,2164,4361,23689,76546,2022-03-20 21:26:17.440281
10573,226,6983,150,144,2374,9877,2022-03-20 21:26:20.885565
10578,8287,100618,6579,11374,39667,166525,2022-03-20 21:26:23.467479
10581,97,4233,71,83,1638,6122,2022-03-20 21:26:26.412233
10582,789,26704,356,293,6600,34742,2022-03-20 21:26:27.309203
10584,21,824,12,41,214,1112,2022-03-20 21:26:27.488318
10588,14281,142003,11475,12516,62870,243145,2022-03-20 21:26:31.2155
10589,1815,184824,812,519,17598,205568,2022-03-20 21:26:31.475947
10595,75,242,58,88,1610,2073,2022-03-20 21:26:34.397271
10603,13,82,3,36,165,299,2022-03-20 21:26:37.858162
10607,29,234,23,99,217,602,2022-03-20 21:26:42.118957
10611,4493,48650,2827,5430,24011,85411,2022-03-20 21:26:42.31918
10620,77704,1335921,45618,66707,273244,1799194,2022-03-20 21:26:42.762796
10622,523,22713,377,215,8714,32542,2022-03-20 21:26:45.475382
10624,682,25994,397,218,10423,37714,2022-03-20 21:26:51.754306
10628,284,5214,188,139,3342,9167,2022-03-20 21:26:53.245388
10633,18,93,11,67,99,288,2022-03-20 21:26:55.631892
10638,849,44329,439,206,11328,57151,2022-03-20 21:26:58.06732
40817,4,138,2,7,35,186,2022-03-21 11:08:58.965346
10643,793,21746,432,364,10376,33711,2022-03-20 21:27:01.386639
10647,2186,55164,1588,985,22210,82133,2022-03-20 21:27:01.607809
10648,22,157,12,45,288,524,2022-03-20 21:27:02.9598
10659,527,39347,392,281,7287,47834,2022-03-20 21:27:03.574823
10674,11,496,3,27,122,659,2022-03-20 21:27:05.862041
10679,68,2566,54,97,1215,4000,2022-03-20 21:27:06.080012
10681,1771,59960,877,592,24790,87990,2022-03-20 21:27:08.576456
10684,12,105,7,64,99,287,2022-03-20 21:27:10.624213
10686,662,59565,385,271,7981,68864,2022-03-20 21:27:11.982613
10687,305,20156,140,212,4449,25262,2022-03-20 21:27:12.209288
10688,48,910,14,38,549,1559,2022-03-20 21:27:12.453536
10703,158,9329,121,136,2109,11853,2022-03-20 21:27:13.63269
10715,573,24650,295,175,7856,33549,2022-03-20 21:27:14.940349
10723,77,517,35,60,1196,1885,2022-03-20 21:27:19.211155
10732,66,1755,60,62,1104,3047,2022-03-20 21:27:23.366415
10736,46,1083,29,83,782,2023,2022-03-20 21:27:27.227993
10737,636,13135,577,407,3819,18574,2022-03-20 21:27:31.307715
10739,408,27345,241,206,6934,35134,2022-03-20 21:27:35.130286
10740,231,36669,230,227,4105,41462,2022-03-20 21:27:38.162979
10742,26,489,23,102,197,837,2022-03-20 21:27:40.345948
10743,17,608,5,46,113,789,2022-03-20 21:27:41.956001
10751,41,417,14,48,374,894,2022-03-20 21:27:44.155049
10755,25,290,19,71,443,848,2022-03-20 21:27:45.816645
10756,19,125,27,113,127,411,2022-03-20 21:27:47.124884
10757,32,275,30,121,176,634,2022-03-20 21:27:47.321881
10758,21,210,27,110,174,542,2022-03-20 21:27:48.920281
10760,20,210,21,105,132,488,2022-03-20 21:27:51.918627
10763,22,289,10,58,176,555,2022-03-20 21:27:53.184836
10765,126,4619,79,82,1535,6441,2022-03-20 21:27:53.357835
10766,114,3418,86,132,1457,5207,2022-03-20 21:27:53.61784
10775,151,2278,125,124,2504,5182,2022-03-20 21:27:56.703034
10780,39,699,22,56,385,1201,2022-03-20 21:27:58.288742
10793,52967,710880,36624,57553,244163,1102187,2022-03-20 21:28:01.413144
10794,1812,94549,694,619,14695,112369,2022-03-20 21:28:01.62781
10796,169,2701,132,117,1070,4189,2022-03-20 21:28:01.889997
10799,39,3930,25,36,526,4556,2022-03-20 21:28:05.292736
10800,24778,194403,18976,15098,154565,407820,2022-03-20 21:28:06.283924
10801,457,4297,318,669,2218,7959,2022-03-20 21:28:06.448921
10802,32,239,18,77,242,608,2022-03-20 21:28:06.702924
50338,3,0,0,1,10427,10431,2022-03-21 12:24:52.948408
10807,754,6884,1051,616,9187,18492,2022-03-20 21:28:09.737526
10808,2206,15449,1726,3010,6697,29088,2022-03-20 21:28:09.952251
10810,160,5993,75,168,722,7118,2022-03-20 21:28:12.635659
10812,11,201,8,47,138,405,2022-03-20 21:28:12.829372
10813,16,657,19,74,281,1047,2022-03-20 21:28:15.030546
10819,90,2290,82,82,1519,4063,2022-03-20 21:28:17.600846
10820,25,256,11,57,307,656,2022-03-20 21:28:19.044064
10821,96,2952,89,130,1861,5128,2022-03-20 21:28:22.918303
10823,78,1736,75,95,1260,3244,2022-03-20 21:28:25.440513
10824,78,1923,74,97,1322,3494,2022-03-20 21:28:26.807816
10825,100,2442,90,107,1600,4339,2022-03-20 21:28:28.753631
10832,155,2349,175,151,1728,4558,2022-03-20 21:28:30.755189
10834,753,22634,550,422,9893,34252,2022-03-20 21:28:32.982849
10838,511,5964,394,1179,3358,11406,2022-03-20 21:28:33.15385
10842,463,10929,541,410,9486,21829,2022-03-20 21:28:33.433069
10845,653,8088,330,271,4385,13727,2022-03-20 21:28:37.721257
10847,34,215,20,63,365,697,2022-03-20 21:28:39.448353
10849,115,4168,76,94,1817,6270,2022-03-20 21:28:39.62649
10852,20,155,9,40,180,404,2022-03-20 21:28:42.478236
10855,16,85,10,58,95,264,2022-03-20 21:28:45.113745
10856,16,77,7,57,96,253,2022-03-20 21:28:46.233965
10862,130,3153,112,137,1712,5244,2022-03-20 21:28:50.734928
10863,4589,333420,1655,814,52112,392590,2022-03-20 21:28:51.201333
10869,115,1688,107,228,621,2759,2022-03-20 21:28:53.694724
10870,215,5578,227,242,5355,11617,2022-03-20 21:28:56.122008
10882,118,174,56,71,1540,1959,2022-03-20 21:28:56.312359
10884,1879,19051,1159,1281,10505,33875,2022-03-20 21:28:59.428107
10886,174,4089,113,149,2219,6744,2022-03-20 21:29:01.912724
10887,20,96,12,89,144,361,2022-03-20 21:29:02.947489
10889,26,116,18,87,181,428,2022-03-20 21:29:04.304996
10893,1099,25665,506,367,15853,43490,2022-03-20 21:29:06.933988
10897,1462,96677,727,474,16279,115619,2022-03-20 21:29:07.38053
10904,37,413,26,95,462,1033,2022-03-20 21:29:09.557575
10909,17,219,13,81,188,518,2022-03-20 21:29:13.169915
10916,103,6795,102,132,1687,8819,2022-03-20 21:29:14.114234
10917,127,6675,123,151,1757,8833,2022-03-20 21:29:14.375384
10918,362,8130,189,116,5990,14787,2022-03-20 21:29:14.65658
10934,369,14291,209,163,4474,19506,2022-03-20 21:29:15.659573
10948,138,2927,130,132,2700,6027,2022-03-20 21:29:16.815863
10979,25,1371,13,68,394,1871,2022-03-20 21:29:22.947025
10987,18,144,14,70,142,388,2022-03-20 21:29:24.321366
10989,14,110,8,53,148,333,2022-03-20 21:29:25.933492
10995,21,52,11,79,127,290,2022-03-20 21:29:26.996912
10997,28,110,11,59,147,355,2022-03-20 21:29:28.091751
10999,229,11838,115,161,1989,14332,2022-03-20 21:29:28.267041
11001,715,10367,326,262,10391,22061,2022-03-20 21:29:28.81777
11005,1843,24283,623,769,12539,40057,2022-03-20 21:29:31.525541
11009,114,6427,131,217,2249,9138,2022-03-20 21:29:31.891543
11013,21865,287386,15268,18400,117611,460530,2022-03-20 21:29:35.071434
11019,106,7206,148,211,2308,9979,2022-03-20 21:29:37.710453
11021,5696,46833,3428,5431,26828,88216,2022-03-20 21:29:38.255223
11033,142,10874,71,121,1653,12861,2022-03-20 21:29:40.828429
11043,27,305,14,37,333,716,2022-03-20 21:29:42.862898
11049,20,224,5,54,186,489,2022-03-20 21:29:43.059888
11061,299913,1516979,113462,46213,313348,2289915,2022-03-20 21:29:47.12163
41159,2,29,7,22,34,94,2022-03-21 11:12:20.974372
11069,81,3770,97,132,1671,5751,2022-03-20 21:29:49.890711
11073,124,8298,92,172,1748,10434,2022-03-20 21:29:50.082195
11077,2923,52638,1413,577,27864,85415,2022-03-20 21:29:53.040823
11083,289,8070,159,207,2703,11428,2022-03-20 21:29:54.404415
11093,30,331,15,51,299,726,2022-03-20 21:29:58.9747
11095,13,103,3,57,99,275,2022-03-20 21:30:00.127831
11097,12,121,6,65,110,314,2022-03-20 21:30:01.225268
11099,149,5709,83,96,2914,8951,2022-03-20 21:30:01.667839
11101,35,296,16,60,311,718,2022-03-20 21:30:01.840324
11111,48431,1102776,27865,35507,252150,1466729,2022-03-20 21:30:06.424521
11113,1194,52754,807,389,10125,65269,2022-03-20 21:30:08.95083
11123,3948,122716,1651,1881,13970,144166,2022-03-20 21:30:13.703698
11135,2436,49811,1147,1341,17223,71958,2022-03-20 21:30:18.436559
11161,494,22189,265,171,5050,28169,2022-03-20 21:30:21.011067
11179,7344,122455,3873,5211,40091,178974,2022-03-20 21:30:27.650806
50607,1,0,0,0,1764,1765,2022-03-21 12:26:16.078173
11189,18,819,10,32,212,1091,2022-03-20 21:30:27.851935
11209,2743,38283,998,694,11486,54204,2022-03-20 21:30:34.041717
11213,28,153,14,94,187,476,2022-03-20 21:30:35.234842
11221,53,474,31,45,971,1574,2022-03-20 21:30:37.825665
11227,3639,28165,2525,3767,28017,66113,2022-03-20 21:30:40.888703
11235,5307,106881,3261,3133,33049,151631,2022-03-20 21:30:41.115377
11237,275,9180,175,157,3636,13423,2022-03-20 21:30:41.28338
11239,857,12319,584,477,7103,21340,2022-03-20 21:30:41.542022
11269,28,354,13,53,261,709,2022-03-20 21:30:46.491242
11275,32,217,22,115,309,695,2022-03-20 21:30:48.348026
11285,11002,212570,9185,14610,79976,327343,2022-03-20 21:30:49.015781
11299,64,947,32,65,591,1699,2022-03-20 21:30:49.284568
11319,9645,307560,5407,5917,49206,377735,2022-03-20 21:30:49.861295
11357,32,502,10,56,294,894,2022-03-20 21:30:52.604667
41190,15,49,19,44,294,421,2022-03-21 11:12:57.493252
11359,499,36296,269,294,5082,42440,2022-03-20 21:30:52.872369
11385,704,16276,574,905,5221,23680,2022-03-20 21:30:53.4963
11445,58,724,35,67,519,1403,2022-03-20 21:30:54.644181
11497,15,71,11,61,110,268,2022-03-20 21:30:57.032339
11499,23939,366477,13707,15072,126048,545243,2022-03-20 21:31:00.018589
11505,52,464,29,30,432,1007,2022-03-20 21:31:00.203583
11507,255,7848,147,167,2869,11286,2022-03-20 21:31:03.264466
11521,30,387,20,76,244,757,2022-03-20 21:31:04.086614
11525,22,86,11,66,158,343,2022-03-20 21:31:04.360156
11533,30,153,19,72,236,510,2022-03-20 21:31:05.562824
11541,88,173,130,194,418,1003,2022-03-20 21:31:06.710481
11545,25,142,18,72,288,545,2022-03-20 21:31:07.917808
11553,1998,135450,987,651,23219,162305,2022-03-20 21:31:08.405087
11593,14,82,6,73,129,304,2022-03-20 21:31:10.221316
11609,30,98,12,56,191,387,2022-03-20 21:31:10.735176
11659,39,737,36,73,588,1473,2022-03-20 21:31:12.667197
11665,8143,128286,3870,2093,76828,219220,2022-03-20 21:31:13.188613
11691,26,3298,8,55,408,3795,2022-03-20 21:31:14.359048
11705,172,5605,106,174,3171,9228,2022-03-20 21:31:15.544006
11733,20,80,10,75,125,310,2022-03-20 21:31:18.092582
11735,50,1298,32,41,599,2020,2022-03-20 21:31:20.951011
11737,3299,191061,1648,787,48932,245727,2022-03-20 21:31:21.170564
11739,2842,51790,1893,1281,23601,81407,2022-03-20 21:31:21.450349
11741,26287,789898,9993,5714,149594,981486,2022-03-20 21:31:22.455672
11751,6033,49883,3451,5315,41634,106316,2022-03-20 21:31:25.44379
11755,523,8465,248,327,7826,17389,2022-03-20 21:31:28.309184
11757,96522,2309576,31883,112012,144520,2694513,2022-03-20 21:31:28.585536
11759,29658,444556,22255,43401,119656,659526,2022-03-20 21:31:31.530475
11761,11339,131148,7351,10846,66285,226969,2022-03-20 21:31:36.5122
11763,3373,18416,1926,5785,20508,50008,2022-03-20 21:31:36.990002
11769,1434,14875,777,1571,10645,29302,2022-03-20 21:31:40.313039
41467,1,0,0,0,102995,102996,2022-03-21 11:15:07.138207
50672,1,0,0,0,9769,9770,2022-03-21 12:26:43.990692
11771,57851,771240,30648,27768,143660,1031167,2022-03-20 21:31:40.81351
11773,217,1879,151,118,1836,4201,2022-03-20 21:31:41.288899
11783,3625,70914,2727,3285,16223,96774,2022-03-20 21:31:41.632905
11799,31,850,11,51,392,1335,2022-03-20 21:31:42.791557
11837,6415,72416,3594,6952,34296,123673,2022-03-20 21:31:44.020751
11869,31,2372,12,62,366,2843,2022-03-20 21:31:45.212151
11917,633,26155,263,349,5867,33267,2022-03-20 21:31:49.218011
41965,0,0,0,0,0,0,2022-03-21 11:18:45.226854
41966,0,0,0,0,0,0,2022-03-21 11:18:46.10242
41970,0,0,0,0,0,0,2022-03-21 11:18:47.89499
41972,0,0,0,0,0,0,2022-03-21 11:18:49.709587
11919,36,544,20,113,323,1036,2022-03-20 21:31:52.207298
11959,23,145,9,45,170,392,2022-03-20 21:31:56.722799
11977,2570,130425,1444,994,44252,179685,2022-03-20 21:31:56.909939
11979,2601,130528,1335,979,46842,182285,2022-03-20 21:31:58.441856
11981,5112,252195,2319,1218,70249,331093,2022-03-20 21:31:59.407444
12001,385,12977,353,370,6600,20685,2022-03-20 21:32:01.294024
12005,39,469,14,66,453,1041,2022-03-20 21:32:03.126933
41982,0,0,0,0,0,0,2022-03-21 11:18:52.184509
41996,0,0,0,0,0,0,2022-03-21 11:18:55.756751
12015,336,13769,184,151,8025,22465,2022-03-20 21:32:03.318305
12027,28,277,24,89,474,892,2022-03-20 21:32:07.741984
12029,6590,39923,3769,2062,50983,103327,2022-03-20 21:32:07.956006
12031,10629,67183,5248,7888,77384,168332,2022-03-20 21:32:08.23231
12035,181,2626,83,91,3138,6119,2022-03-20 21:32:11.749705
12037,22,277,9,50,203,561,2022-03-20 21:32:14.605726
12039,36,155,24,91,439,745,2022-03-20 21:32:16.073444
12137,233,9303,98,148,4072,13854,2022-03-20 21:32:26.800528
12049,2492,163102,1040,709,25453,192796,2022-03-20 21:32:18.913514
12053,575,21741,335,180,10281,33112,2022-03-20 21:32:19.092125
12065,426,5179,212,185,3469,9471,2022-03-20 21:32:21.602062
12067,381,12852,229,138,4514,18114,2022-03-20 21:32:21.793019
12069,719,37906,243,270,5848,44986,2022-03-20 21:32:22.322124
12079,1234,49361,680,892,11907,64074,2022-03-20 21:32:22.486439
12115,3042,157110,905,731,26602,188390,2022-03-20 21:32:23.061146
12135,22,599,13,35,282,951,2022-03-20 21:32:26.589108
12139,33,124,38,96,380,671,2022-03-20 21:32:28.377447
12141,28,572,18,47,462,1127,2022-03-20 21:32:31.099234
12145,60,1251,42,205,245,1803,2022-03-20 21:32:33.585893
12149,2217,33821,1869,3286,16804,57997,2022-03-20 21:32:33.770904
12157,557,2832,472,410,1976,6247,2022-03-20 21:32:37.828389
12163,25,248,40,59,515,887,2022-03-20 21:32:39.533609
12165,22,203,3,49,210,487,2022-03-20 21:32:39.984236
12181,24,82,6,66,148,326,2022-03-20 21:32:44.841682
12185,12,61,7,52,81,213,2022-03-20 21:32:46.020925
12187,634,35630,379,193,7429,44265,2022-03-20 21:32:48.982599
12189,89095,639911,63622,48499,342592,1183719,2022-03-20 21:32:49.419779
12191,2888,20453,2137,2958,7658,36094,2022-03-20 21:32:52.146417
12221,105,3351,68,106,1399,5029,2022-03-20 21:32:52.325776
12223,103,1449,88,79,2118,3837,2022-03-20 21:32:52.627976
12225,66,1326,46,47,715,2200,2022-03-20 21:32:52.897594
12255,346,27763,234,189,4443,32975,2022-03-20 21:32:56.552081
12259,18,263,11,44,226,562,2022-03-20 21:32:58.192811
12279,41,545,19,70,443,1118,2022-03-20 21:32:59.018704
12281,1101,15902,1022,980,7965,26970,2022-03-20 21:33:01.412258
12291,14086,171484,10044,12000,81396,289010,2022-03-20 21:33:01.582846
12295,19,756,11,58,238,1082,2022-03-20 21:33:07.272422
12337,38,329,15,77,393,852,2022-03-20 21:33:15.238322
12343,99,1974,82,66,1288,3509,2022-03-20 21:33:15.935404
12355,13240,521988,4052,1511,180461,721252,2022-03-20 21:33:20.078125
12359,16,189,19,79,119,422,2022-03-20 21:33:23.466126
12361,45,593,26,129,337,1130,2022-03-20 21:33:26.219264
12365,9472,223235,5234,3087,60619,301647,2022-03-20 21:33:26.401091
12367,2595,19465,1739,3520,13389,40708,2022-03-20 21:33:29.12013
12371,7,133,3,45,95,283,2022-03-20 21:33:31.623404
12391,18,95,15,68,153,349,2022-03-20 21:33:33.186391
12399,23,217,9,39,266,554,2022-03-20 21:33:33.997104
12401,35,301,10,39,391,776,2022-03-20 21:33:36.25388
12403,5825,121441,3497,2708,33884,167355,2022-03-20 21:33:36.431026
12411,122,4196,105,160,2167,6750,2022-03-20 21:33:39.083853
12413,15531,171169,9162,8836,106085,310783,2022-03-20 21:33:39.270622
12419,741,24672,484,459,10076,36432,2022-03-20 21:33:40.083161
12429,150,3946,109,147,1872,6224,2022-03-20 21:33:40.334092
12431,17941,41923,14150,7590,90557,172161,2022-03-20 21:33:40.598316
12451,15,124,11,50,150,350,2022-03-20 21:33:43.28842
13819,17,113,12,66,120,328,2022-03-20 21:39:15.129634
12455,174,5129,159,129,3065,8656,2022-03-20 21:33:46.721796
12467,13418,150444,8020,14510,73181,259573,2022-03-20 21:33:47.636526
12471,5130,48727,4264,5467,26553,90141,2022-03-20 21:33:47.901688
12477,6398,152864,2295,787,93551,255895,2022-03-20 21:33:51.161394
12481,63,1035,37,64,425,1624,2022-03-20 21:33:53.009446
12483,44,866,25,71,415,1421,2022-03-20 21:33:53.192941
12485,28,656,15,51,303,1053,2022-03-20 21:33:55.267057
42000,0,0,0,0,0,0,2022-03-21 11:18:58.294484
50923,0,0,0,0,1420,1420,2022-03-21 12:28:28.566648
12487,3520,47612,2398,1988,21694,77212,2022-03-20 21:33:55.441828
12497,20,237,7,36,120,420,2022-03-20 21:33:58.484255
12499,59,3338,35,89,559,4080,2022-03-20 21:34:01.507805
12501,165,4760,75,112,1816,6928,2022-03-20 21:34:04.836985
12503,699,42026,660,692,11369,55446,2022-03-20 21:34:07.725442
12521,16,439,1,22,106,584,2022-03-20 21:34:10.214415
12529,16,93,7,56,120,292,2022-03-20 21:34:11.44005
12531,14063,181742,8882,6115,125576,336378,2022-03-20 21:34:11.929633
12561,30,873,15,59,196,1173,2022-03-20 21:34:13.94168
12565,1939,72361,838,468,26959,102565,2022-03-20 21:34:16.546892
12579,299,3105,185,171,2801,6561,2022-03-20 21:34:20.411429
12581,1508,36122,537,531,10159,48857,2022-03-20 21:34:20.899448
12585,150,4089,76,134,1313,5762,2022-03-20 21:34:23.858656
12589,32,303,14,99,247,695,2022-03-20 21:34:25.307162
12591,41,891,39,75,806,1852,2022-03-20 21:34:28.798363
12599,39,1237,19,45,300,1640,2022-03-20 21:34:29.230171
12603,39,775,5,59,208,1086,2022-03-20 21:34:29.670425
12611,1983,6406,1754,3637,9326,23106,2022-03-20 21:34:32.345991
12623,28,2167,13,29,298,2535,2022-03-20 21:34:33.991433
12637,151,10621,72,122,1858,12824,2022-03-20 21:34:36.206394
12651,313,3319,245,292,1360,5529,2022-03-20 21:34:37.931682
12657,24,222,9,57,241,553,2022-03-20 21:34:39.494676
12663,48,473,36,101,650,1308,2022-03-20 21:34:45.082539
12669,738,24500,457,283,7324,33302,2022-03-20 21:34:50.051488
12671,278,38744,204,217,4011,43454,2022-03-20 21:34:52.595943
12673,513,30910,271,138,5888,37720,2022-03-20 21:34:52.770636
12677,719,7733,642,1345,4072,14511,2022-03-20 21:34:53.031558
12679,11602,46313,7079,6199,79838,151031,2022-03-20 21:34:53.563786
12689,51,524,27,37,522,1161,2022-03-20 21:34:54.049898
12727,80,2140,72,72,972,3336,2022-03-20 21:34:55.221497
12765,20,112,19,88,195,434,2022-03-20 21:34:58.043142
12767,29,153,30,109,167,488,2022-03-20 21:34:59.300332
12769,55,324,43,59,708,1189,2022-03-20 21:35:02.031678
12781,13,101,3,71,99,287,2022-03-20 21:35:06.099386
12783,1637,55125,862,638,28946,87208,2022-03-20 21:35:06.315459
12789,23,444,9,65,166,707,2022-03-20 21:35:06.576459
12795,54,350,23,68,629,1124,2022-03-20 21:35:12.015974
12799,24,90,13,64,326,517,2022-03-20 21:35:13.221224
12807,14,137,8,69,126,354,2022-03-20 21:35:15.065542
12809,18,71,11,68,132,300,2022-03-20 21:35:16.209704
12815,10386,16243,10002,8210,39928,84769,2022-03-20 21:35:18.950333
12823,357,11456,314,270,6372,18769,2022-03-20 21:35:19.120301
12833,22,68,6,51,151,298,2022-03-20 21:35:20.534275
12851,47,517,25,75,451,1115,2022-03-20 21:35:24.31289
12857,312,5077,197,179,6208,11973,2022-03-20 21:35:26.837965
12859,3442,199170,800,560,20050,224022,2022-03-20 21:35:27.028069
12863,472,4274,411,564,2324,8045,2022-03-20 21:35:28.826478
12865,55,1536,35,91,698,2415,2022-03-20 21:35:31.246027
12867,169,2305,77,52,2357,4960,2022-03-20 21:35:31.446511
12875,1799,12370,1245,1479,7045,23938,2022-03-20 21:35:31.916978
12877,70,1627,70,113,1295,3175,2022-03-20 21:35:34.868762
12879,292,14945,201,116,4986,20540,2022-03-20 21:35:38.239177
12881,51,559,36,51,492,1189,2022-03-20 21:35:40.996141
12883,8479,67725,7162,7206,66942,157514,2022-03-20 21:35:44.732938
12885,40,685,26,58,373,1182,2022-03-20 21:35:46.342202
12893,2944,95144,1659,857,22020,122624,2022-03-20 21:35:51.224317
12897,29,125,26,118,232,530,2022-03-20 21:35:52.886367
12899,22,99,7,59,212,399,2022-03-20 21:35:55.422472
12901,18,105,2,51,146,322,2022-03-20 21:35:57.029506
12907,128,2385,52,103,853,3521,2022-03-20 21:35:59.99626
12917,103,1908,29,107,1491,3638,2022-03-20 21:36:00.257631
12919,24,1045,8,33,287,1397,2022-03-20 21:36:00.513137
12963,217,1438,169,280,1520,3624,2022-03-20 21:36:02.974091
12979,6787,46992,6524,8994,14398,83695,2022-03-20 21:36:06.237935
12981,31,95,22,40,535,723,2022-03-20 21:36:06.455499
12991,83,1146,67,79,1454,2829,2022-03-20 21:36:08.93163
12993,16,333,2,20,102,473,2022-03-20 21:36:10.898167
13029,168,819,135,343,980,2445,2022-03-20 21:36:11.345915
13041,19,166,8,51,154,398,2022-03-20 21:36:12.67502
13053,21,2606,21,44,265,2957,2022-03-20 21:36:16.696814
13073,89,3038,66,101,1178,4472,2022-03-20 21:36:17.53703
13085,11,306,6,36,98,457,2022-03-20 21:36:20.354916
13087,10,289,8,39,100,446,2022-03-20 21:36:21.78074
13091,8,204,10,39,67,328,2022-03-20 21:36:24.780946
13093,617,29532,337,215,6960,37661,2022-03-20 21:36:27.350417
13103,18,45,8,52,237,360,2022-03-20 21:36:28.600312
13119,550,10012,310,228,9023,20123,2022-03-20 21:36:35.666115
13125,48583,280860,33503,30505,310510,703961,2022-03-20 21:36:36.147137
13141,448,3893,319,888,3573,9121,2022-03-20 21:36:39.901282
13153,16,957,7,22,117,1119,2022-03-20 21:36:48.55346
13159,1001,1709,883,1369,3630,8592,2022-03-20 21:36:48.752064
13163,2138,646,1786,1653,3988,10211,2022-03-20 21:36:49.636247
13169,169,6011,85,73,2002,8340,2022-03-20 21:36:53.87534
13171,819,20850,318,109,11489,33585,2022-03-20 21:36:54.080975
13175,83,3041,47,65,1288,4524,2022-03-20 21:36:56.358838
13177,39,146,20,78,209,492,2022-03-20 21:36:57.921836
13179,25,110,14,71,149,369,2022-03-20 21:36:59.116523
13183,667,11640,459,446,9855,23067,2022-03-20 21:37:02.08417
13185,539,3440,400,690,2010,7079,2022-03-20 21:37:02.270442
13201,414,11486,388,526,2436,15250,2022-03-20 21:37:06.606431
13203,3656,24677,2526,1825,22858,55542,2022-03-20 21:37:09.819704
13215,163,2452,99,103,2780,5597,2022-03-20 21:37:11.560845
13231,381,9091,311,847,2173,12803,2022-03-20 21:37:14.662831
13233,26,435,22,47,380,910,2022-03-20 21:37:14.852192
13239,135,5570,67,116,2436,8324,2022-03-20 21:37:15.331406
13245,570,6939,370,204,2506,10589,2022-03-20 21:37:15.597399
13251,97,2504,89,76,1167,3933,2022-03-20 21:37:18.458167
13253,54,3879,29,46,726,4734,2022-03-20 21:37:18.66562
13259,67,3967,37,62,699,4832,2022-03-20 21:37:20.683857
13261,1789,39607,1003,1598,5119,49116,2022-03-20 21:37:23.237834
13263,1334,21089,1210,979,10182,34794,2022-03-20 21:37:23.409443
13271,2180,133528,1044,650,29505,166907,2022-03-20 21:37:26.621246
13281,29,1994,15,29,333,2400,2022-03-20 21:37:28.632521
13283,764,6853,423,394,6646,15080,2022-03-20 21:37:29.06283
13287,42,1415,35,46,573,2111,2022-03-20 21:37:31.791736
13299,42,329,18,51,349,789,2022-03-20 21:37:33.220331
13303,78,280,44,91,1292,1785,2022-03-20 21:37:33.407004
13307,46,194,44,119,449,852,2022-03-20 21:37:34.125778
13309,50,3575,30,55,515,4225,2022-03-20 21:37:34.311266
13331,6191,123056,3696,2241,34651,169835,2022-03-20 21:37:34.73029
13367,9399,123652,4384,7179,48545,193159,2022-03-20 21:37:35.896909
13403,1140,70356,548,371,13123,85538,2022-03-20 21:37:37.314331
13421,12,486,4,26,112,640,2022-03-20 21:37:40.590906
13423,8,197,4,31,71,311,2022-03-20 21:37:43.310558
13429,733,15622,442,279,9897,26973,2022-03-20 21:37:46.154601
13431,31,152,19,100,190,492,2022-03-20 21:37:48.790552
13435,12,178,13,66,117,386,2022-03-20 21:37:50.378329
13439,67,676,40,81,950,1814,2022-03-20 21:37:50.580841
13441,23,850,15,40,313,1241,2022-03-20 21:37:52.165993
13455,20,97,8,85,129,339,2022-03-20 21:37:54.490605
13457,43,41,10,112,100,306,2022-03-20 21:37:55.73462
13463,45,51,14,85,133,328,2022-03-20 21:37:58.836315
13465,12,73,7,65,125,282,2022-03-20 21:38:00.055283
13469,1621,142259,839,357,21816,166892,2022-03-20 21:38:00.231914
13479,94,1865,56,125,1626,3766,2022-03-20 21:38:02.498227
13495,23,1150,10,32,235,1450,2022-03-20 21:38:04.585138
13499,16,100,8,80,120,324,2022-03-20 21:38:06.102086
13501,9,82,10,52,82,235,2022-03-20 21:38:07.307416
13503,14,95,8,63,115,295,2022-03-20 21:38:09.172095
13507,11,81,10,54,82,238,2022-03-20 21:38:11.080799
13511,11,75,11,73,89,259,2022-03-20 21:38:13.187986
13519,10,222,4,29,95,360,2022-03-20 21:38:21.042352
13535,9427,129320,6130,6685,62312,213874,2022-03-20 21:38:21.516909
13541,22,278,6,36,136,478,2022-03-20 21:38:23.748086
13543,15,326,5,32,96,474,2022-03-20 21:38:25.008802
13551,32,115,27,63,332,569,2022-03-20 21:38:27.346039
13561,673,12564,609,504,10367,24717,2022-03-20 21:38:29.82206
13563,113,1054,45,65,833,2110,2022-03-20 21:38:31.814489
13585,3956,36978,2891,3174,28880,75879,2022-03-20 21:38:32.375859
13599,8974,85836,6994,7218,59105,168127,2022-03-20 21:38:37.188068
13601,95005,833039,63876,44634,398404,1434958,2022-03-20 21:38:41.429784
13629,146,15424,62,91,2755,18478,2022-03-20 21:38:44.766211
13639,145,4650,66,51,2453,7365,2022-03-20 21:38:44.962204
13659,11756,318909,5673,9573,54984,400895,2022-03-20 21:38:45.679106
13667,3417,264362,999,700,21919,291397,2022-03-20 21:38:48.421815
13669,137,1615,64,102,1371,3289,2022-03-20 21:38:51.536904
13673,118,3404,45,57,1267,4891,2022-03-20 21:38:54.502036
13675,72,4263,30,40,828,5233,2022-03-20 21:38:56.293738
13677,573,21710,544,569,12197,35593,2022-03-20 21:39:00.479226
13681,71,674,53,56,742,1596,2022-03-20 21:39:05.013231
51189,0,0,0,0,0,0,2022-03-21 12:29:44.460483
13691,43,2979,26,30,423,3501,2022-03-20 21:39:05.271748
13693,33,352,9,46,261,701,2022-03-20 21:39:05.527441
13709,1040,44688,441,477,12287,58933,2022-03-20 21:39:05.793672
13755,36,924,20,32,672,1684,2022-03-20 21:39:06.53672
13793,13,684,6,40,95,838,2022-03-20 21:39:10.792007
13795,19,527,3,30,120,699,2022-03-20 21:39:12.264797
13807,1955,100074,805,739,25772,129345,2022-03-20 21:39:13.058391
13817,24,121,14,68,225,452,2022-03-20 21:39:14.955894
13821,16,102,14,72,149,353,2022-03-20 21:39:16.938628
13823,14,144,10,54,115,337,2022-03-20 21:39:19.480564
13825,40,95,14,60,115,324,2022-03-20 21:39:20.470712
13827,15,130,15,62,120,342,2022-03-20 21:39:20.642639
13831,15,117,10,60,109,311,2022-03-20 21:39:22.7373
13833,492,16852,158,152,5202,22856,2022-03-20 21:39:25.288839
13835,64,3550,33,59,528,4234,2022-03-20 21:39:25.465748
13837,135,6175,110,154,2030,8604,2022-03-20 21:39:25.929791
13839,121,7853,96,131,1960,10161,2022-03-20 21:39:28.773474
13843,599,2505,446,354,3707,7611,2022-03-20 21:39:28.948616
13851,10522,85864,3750,1662,18700,120498,2022-03-20 21:39:29.470214
13859,1000,27996,796,1030,8815,39637,2022-03-20 21:39:32.756459
13863,464,14857,272,276,9317,25186,2022-03-20 21:39:37.294256
13931,190,4983,171,162,3544,9050,2022-03-20 21:39:41.974132
13935,44,646,27,70,511,1298,2022-03-20 21:39:44.542101
13939,2943,83867,1537,1016,17697,107060,2022-03-20 21:39:47.21246
13947,12,176,8,74,173,443,2022-03-20 21:39:48.50239
13969,25,1501,14,44,371,1955,2022-03-20 21:39:54.253919
13971,33,2769,22,79,707,3610,2022-03-20 21:39:57.974193
13983,31,789,16,51,465,1352,2022-03-20 21:39:58.159655
13993,112,804,77,88,1850,2931,2022-03-20 21:40:01.185628
14007,53,640,47,115,939,1794,2022-03-20 21:40:02.114425
14023,15,305,3,24,94,441,2022-03-20 21:40:03.838019
14027,1359,88010,704,441,16155,106669,2022-03-20 21:40:04.020923
14039,31,95,24,43,639,832,2022-03-20 21:40:04.285915
14045,1333,16451,877,2035,9787,30483,2022-03-20 21:40:04.565255
14073,1484,10050,1167,2280,8992,23973,2022-03-20 21:40:06.689935
14175,2757,42222,1086,492,34479,81036,2022-03-20 21:40:12.875134
14183,24,211,17,72,277,601,2022-03-20 21:40:17.219382
14199,15243,162948,7796,13283,73214,272484,2022-03-20 21:40:20.728977
42144,5,34,5,32,39,115,2022-03-21 11:19:56.668975
14211,24,184,22,127,355,712,2022-03-20 21:40:20.926561
14213,26,188,24,121,217,576,2022-03-20 21:40:22.822645
14227,40690,695137,22598,21334,157780,937539,2022-03-20 21:40:23.267537
14231,24,813,15,50,350,1252,2022-03-20 21:40:25.234859
14237,2325,15880,1650,4174,11470,35499,2022-03-20 21:40:28.155839
14247,32,742,14,45,343,1176,2022-03-20 21:40:32.141833
14249,16,211,12,51,244,534,2022-03-20 21:40:32.307823
14253,24,184,6,48,193,455,2022-03-20 21:40:32.838694
14267,407,7016,255,230,9709,17617,2022-03-20 21:40:35.408457
14277,1095,10874,815,1947,4616,19347,2022-03-20 21:40:37.606882
14283,3320,31281,2304,5771,20434,63110,2022-03-20 21:40:40.303528
14289,21809,418621,10922,16093,113467,580912,2022-03-20 21:40:40.664475
14293,2639,47025,1170,866,35169,86869,2022-03-20 21:40:40.834398
14333,651,1041,678,1222,2340,5932,2022-03-20 21:40:46.278442
14345,23714,576552,12957,21285,141651,776159,2022-03-20 21:40:49.770129
14347,237,7798,144,142,3956,12277,2022-03-20 21:40:52.950947
14353,3034,170005,1143,572,42885,217639,2022-03-20 21:40:57.20801
14355,3244,31719,1610,1912,32277,70762,2022-03-20 21:41:00.230904
14359,119,1222,40,91,1185,2657,2022-03-20 21:41:00.443837
14381,11,119,10,69,109,318,2022-03-20 21:41:05.751108
14397,8154,146021,5058,3098,48167,210498,2022-03-20 21:41:06.797783
14407,1952,71627,759,537,29856,104731,2022-03-20 21:41:06.988455
42147,15,0,8,36,54,113,2022-03-21 11:20:00.652163
14467,32413,456917,20060,25995,155527,690912,2022-03-20 21:41:07.337561
14479,159,4062,72,74,1773,6140,2022-03-20 21:41:10.478596
14511,2354,31679,1444,1081,16623,53181,2022-03-20 21:41:10.655757
14513,51964,626821,33175,27257,179802,919019,2022-03-20 21:41:11.091553
14515,5004,29778,4187,7832,31175,77976,2022-03-20 21:41:14.541521
14519,13,201,17,36,228,495,2022-03-20 21:41:17.626873
14529,21,196,4,60,147,428,2022-03-20 21:41:22.233384
42166,0,0,0,0,0,0,2022-03-21 11:20:13.27211
14563,387,1734,332,579,2195,5227,2022-03-20 21:41:25.853585
14575,1056,15691,382,184,6240,23553,2022-03-20 21:41:26.122551
14583,211,2652,162,101,2100,5226,2022-03-20 21:41:28.396216
14623,13,88,13,60,105,279,2022-03-20 21:41:30.360405
14627,201,9950,125,111,2248,12635,2022-03-20 21:41:30.570556
14629,113,3740,54,70,1305,5282,2022-03-20 21:41:31.086808
14669,3161,39830,1125,593,38398,83107,2022-03-20 21:41:32.266402
14719,104070,1019681,50195,37769,145829,1357544,2022-03-20 21:41:33.339873
14753,31583,17081,7416,3681,38952,98713,2022-03-20 21:41:34.282442
14827,1445,14598,832,1221,10144,28240,2022-03-20 21:41:38.78291
14829,11666,139019,7107,9728,79232,246752,2022-03-20 21:41:39.238153
14833,27423,249308,16398,18862,112121,424112,2022-03-20 21:41:40.252983
14835,423,10845,298,181,5241,16988,2022-03-20 21:41:43.279242
14837,1424,177258,387,344,7780,187193,2022-03-20 21:41:43.449893
14853,117,4766,57,54,1963,6957,2022-03-20 21:41:46.97696
14889,204,3046,96,93,1904,5343,2022-03-20 21:41:51.748369
14893,925,48819,435,333,9499,60011,2022-03-20 21:41:54.439681
14913,145,910,70,174,1012,2311,2022-03-20 21:41:54.609302
14921,5825,55858,4487,8938,29018,104126,2022-03-20 21:41:58.58079
14941,1078,25192,786,891,6431,34378,2022-03-20 21:42:00.216514
14947,37,312,23,66,582,1020,2022-03-20 21:42:02.295694
14951,141,10977,77,106,1701,13002,2022-03-20 21:42:06.974823
14957,156,3868,169,198,3020,7411,2022-03-20 21:42:08.846555
14967,13164,394105,6604,6401,64384,484658,2022-03-20 21:42:09.026837
14989,559,1204,478,907,1913,5061,2022-03-20 21:42:11.970259
15005,2785,19240,1392,1361,16552,41330,2022-03-20 21:42:12.938009
15021,47,2049,18,51,623,2788,2022-03-20 21:42:18.741999
15037,8349,258464,4278,6267,60134,337492,2022-03-20 21:42:22.350102
15043,506,4202,321,488,4529,10046,2022-03-20 21:42:26.771174
15045,406,6356,260,1135,3118,11275,2022-03-20 21:42:29.06517
15051,19104,259102,10508,14234,105892,408840,2022-03-20 21:42:32.552171
15059,5239,84213,2172,1109,24674,117407,2022-03-20 21:42:32.727164
15061,5417,10162,3387,4143,14949,38058,2022-03-20 21:42:32.984663
15067,19,170,10,54,199,452,2022-03-20 21:42:33.247785
15069,11,58,5,59,73,206,2022-03-20 21:42:36.428918
15077,64,3226,34,66,1060,4450,2022-03-20 21:42:38.376156
15085,10487,176272,6962,22801,55929,272451,2022-03-20 21:42:41.959671
15093,57,876,41,62,749,1785,2022-03-20 21:42:44.637374
15095,55,760,39,59,842,1755,2022-03-20 21:42:46.106164
15117,1889,106492,858,473,16970,126682,2022-03-20 21:42:53.022148
15119,9016,46787,5055,9039,53146,123043,2022-03-20 21:42:53.199155
15129,21,62,8,46,92,229,2022-03-20 21:43:01.078589
15133,2782,27807,1190,2763,12696,47238,2022-03-20 21:43:03.520422
15137,15,272,11,57,127,482,2022-03-20 21:43:04.852832
15139,15,232,5,59,106,417,2022-03-20 21:43:06.364188
15159,41,998,25,47,711,1822,2022-03-20 21:43:07.173696
15177,125,2245,101,98,2189,4758,2022-03-20 21:43:09.005524
15195,2803,45233,1977,1722,15250,66985,2022-03-20 21:43:09.189941
15197,1847,91455,1056,604,29405,124367,2022-03-20 21:43:09.450099
15219,136,3853,126,164,2611,6890,2022-03-20 21:43:13.067125
15225,18554,283059,10550,13615,88864,414642,2022-03-20 21:43:13.373839
42292,2,9,1,12,22,46,2022-03-21 11:21:46.341471
15279,92,1051,36,47,943,2169,2022-03-20 21:43:15.0637
15307,101,3131,66,114,1229,4641,2022-03-20 21:43:21.437551
15313,475,6643,374,783,2980,11255,2022-03-20 21:43:23.841889
15315,19803,376480,10091,12289,108115,526778,2022-03-20 21:43:25.25371
15323,1106,51245,371,403,6969,60094,2022-03-20 21:43:25.4346
15325,562,18479,270,363,5173,24847,2022-03-20 21:43:26.536308
15335,4464,146660,1507,1419,51039,205089,2022-03-20 21:43:26.703272
15347,53,704,23,60,563,1403,2022-03-20 21:43:29.955614
15359,963,15115,633,417,8797,25925,2022-03-20 21:43:33.291995
15377,4631,55382,2794,3621,24597,91025,2022-03-20 21:43:33.471913
15379,14263,204186,8090,10920,68960,306419,2022-03-20 21:43:33.734436
15389,39,585,24,60,314,1022,2022-03-20 21:43:34.239371
15407,457,0,230,172,8154,9013,2022-03-20 21:43:36.677403
15423,17,1114,7,34,129,1301,2022-03-20 21:43:37.47543
15453,82,2766,53,72,1255,4228,2022-03-20 21:43:38.343161
15527,32,494,28,60,178,792,2022-03-20 21:43:43.333553
15529,15,355,8,28,76,482,2022-03-20 21:43:43.55048
15533,46,491,18,49,299,903,2022-03-20 21:43:47.142419
15535,211,4713,82,79,1899,6984,2022-03-20 21:43:49.225461
15545,66,569,56,285,349,1325,2022-03-20 21:43:49.672
15547,114,1971,86,171,609,2951,2022-03-20 21:43:52.472836
15565,6482,89792,2845,4838,31751,135708,2022-03-20 21:43:55.466203
15577,18,445,10,52,197,722,2022-03-20 21:43:55.902878
15699,6502,116050,3865,3927,35868,166212,2022-03-20 21:44:15.170488
15583,33054,656255,15899,26856,155876,887940,2022-03-20 21:43:57.929025
15591,299,13847,209,128,5383,19866,2022-03-20 21:43:58.182655
15605,6552,118570,3570,12574,25082,166348,2022-03-20 21:43:58.427488
15617,541,13590,501,179,3902,18713,2022-03-20 21:43:59.665898
15663,19,201,7,46,119,392,2022-03-20 21:44:04.550616
15673,68,4466,29,37,661,5261,2022-03-20 21:44:06.854938
15689,10309,392829,4052,2162,86222,495574,2022-03-20 21:44:10.590742
42371,0,0,0,0,0,0,2022-03-21 11:22:12.611753
15711,430,7521,354,336,7345,15986,2022-03-20 21:44:17.661794
15717,88,1679,52,57,1221,3097,2022-03-20 21:44:20.581898
15719,290,5333,211,201,3374,9409,2022-03-20 21:44:22.993796
15729,1324,30652,653,577,8307,41513,2022-03-20 21:44:23.417092
15731,915,8424,676,598,8067,18680,2022-03-20 21:44:23.595208
15735,334,7056,178,243,4031,11842,2022-03-20 21:44:23.868337
15769,103,885,67,70,965,2090,2022-03-20 21:44:24.499655
15793,2639,34101,1483,1361,14404,53988,2022-03-20 21:44:25.677213
15863,4007,26617,2523,4318,14616,52081,2022-03-20 21:44:36.200996
15865,26,152,20,90,259,547,2022-03-20 21:44:38.164625
15873,25,94,10,96,146,371,2022-03-20 21:44:39.492282
15875,27,181,15,101,275,599,2022-03-20 21:44:40.748175
15879,1780,58206,1367,1119,15259,77731,2022-03-20 21:44:43.035972
15881,1293,23377,648,596,9360,35274,2022-03-20 21:44:45.603795
15883,1588,11380,1356,3414,7933,25671,2022-03-20 21:44:45.789668
15893,79,879,68,69,638,1733,2022-03-20 21:44:49.137532
15897,21,69,10,61,123,284,2022-03-20 21:44:53.522146
15911,5552,45266,3439,3795,39369,97421,2022-03-20 21:44:54.146971
15913,17,167,21,71,155,431,2022-03-20 21:44:55.81546
15915,29,123,11,68,226,457,2022-03-20 21:44:57.815323
15925,59,4772,36,113,531,5511,2022-03-20 21:44:57.995152
15927,469,24476,280,160,5562,30947,2022-03-20 21:45:00.40915
15933,573,22723,194,267,7754,31511,2022-03-20 21:45:00.595083
15937,31,323,23,61,344,782,2022-03-20 21:45:00.767081
15951,391,12237,277,206,4733,17844,2022-03-20 21:45:01.036507
15989,437,9858,223,133,2707,13358,2022-03-20 21:45:05.36884
15993,32,801,19,69,422,1343,2022-03-20 21:45:07.524123
16001,4007,201237,2046,1350,31745,240385,2022-03-20 21:45:07.702136
16005,7616,72821,4116,3925,45849,134327,2022-03-20 21:45:10.651073
16007,17,205,10,62,197,491,2022-03-20 21:45:11.807341
16199,389,13861,252,250,3717,18469,2022-03-20 21:45:42.411886
16011,26385,261237,15328,18752,117362,439064,2022-03-20 21:45:18.84529
16021,20,83,5,47,137,292,2022-03-20 21:45:21.231165
16027,77,224,46,70,622,1039,2022-03-20 21:45:26.767467
16033,519,8184,362,363,7914,17342,2022-03-20 21:45:26.959524
16035,11782,108720,9110,12952,57791,200355,2022-03-20 21:45:27.224473
16041,14,116,8,49,123,310,2022-03-20 21:45:28.805851
16049,15914,236062,8672,5423,79774,345845,2022-03-20 21:45:28.973018
42372,3,53,4,26,46,132,2022-03-21 11:22:13.760837
16067,33057,271163,24026,28001,189232,545479,2022-03-20 21:45:29.415957
16149,290,13000,123,99,5159,18671,2022-03-20 21:45:34.30186
16157,8304,70002,6058,8745,49557,142666,2022-03-20 21:45:34.813045
16159,23,139,18,90,197,467,2022-03-20 21:45:37.555638
16163,12,197,4,60,114,387,2022-03-20 21:45:39.529987
16169,1118,15931,731,1819,8775,28374,2022-03-20 21:45:41.758538
16183,52,548,50,77,960,1687,2022-03-20 21:45:41.935109
42373,2,50,5,30,39,126,2022-03-21 11:22:14.802669
16201,9823,77186,7307,16591,80337,191244,2022-03-20 21:45:45.445481
16211,556,4470,534,1774,3109,10443,2022-03-20 21:45:47.850767
16233,16,1820,10,43,282,2171,2022-03-20 21:45:48.02953
16239,703,36286,367,263,6694,44313,2022-03-20 21:45:50.575335
16245,19,111,9,46,138,323,2022-03-20 21:45:55.556203
16247,34,449,13,49,348,893,2022-03-20 21:45:57.95292
16251,47,323,18,42,340,770,2022-03-20 21:45:58.501573
16255,28,329,14,40,317,728,2022-03-20 21:46:01.190666
16259,36,207,23,46,295,607,2022-03-20 21:46:02.823658
16261,24,147,7,45,228,451,2022-03-20 21:46:04.351028
16263,14,83,8,51,221,377,2022-03-20 21:46:05.889905
16303,29,133,27,83,238,510,2022-03-20 21:46:10.163002
16317,458,9532,244,1036,2251,13521,2022-03-20 21:46:10.955586
16319,67,2843,46,75,861,3892,2022-03-20 21:46:13.306188
16331,146,6025,48,60,1652,7931,2022-03-20 21:46:13.762826
16335,203,5460,90,131,2014,7898,2022-03-20 21:46:13.957073
16345,37,342,14,44,287,724,2022-03-20 21:46:14.451376
16353,11347,86476,6877,7792,70310,182802,2022-03-20 21:46:15.054821
16381,103,2648,61,74,1718,4604,2022-03-20 21:46:18.705417
16389,32,298,20,61,223,634,2022-03-20 21:46:23.456774
16393,31,115,27,78,253,504,2022-03-20 21:46:25.30516
16395,361,15052,226,184,4406,20229,2022-03-20 21:46:27.963235
16397,7337,50484,3906,9383,39333,110443,2022-03-20 21:46:28.872777
16399,18,90,5,63,107,283,2022-03-20 21:46:30.439675
16415,52,838,50,88,958,1986,2022-03-20 21:46:32.981295
16417,19216,188215,12640,12174,136729,368974,2022-03-20 21:46:35.219673
16419,1498,12001,1108,1493,5746,21846,2022-03-20 21:46:35.664368
16436,212,11971,77,179,2423,14862,2022-03-20 21:46:36.48432
16442,93,2690,66,100,1227,4176,2022-03-20 21:46:36.752746
16482,8,85,6,63,86,248,2022-03-20 21:46:39.269322
16486,17,161,13,88,221,500,2022-03-20 21:46:41.028183
16490,17,96,7,58,113,291,2022-03-20 21:46:42.231244
16498,175364,2901948,44738,51830,151950,3325830,2022-03-20 21:46:42.625628
16506,15,259,3,39,135,451,2022-03-20 21:46:45.315333
16508,162,2660,98,125,1375,4420,2022-03-20 21:46:45.493606
16510,32,102,9,44,314,501,2022-03-20 21:46:47.205633
16512,9252,92361,7096,13259,36229,158197,2022-03-20 21:46:47.639399
16514,28,197,12,62,311,610,2022-03-20 21:46:49.677265
16518,3782,39464,2407,5060,15600,66313,2022-03-20 21:46:50.666376
16524,14011,210759,7798,8873,67631,309072,2022-03-20 21:46:54.002031
16528,2663,84315,1152,640,41571,130341,2022-03-20 21:46:58.559549
16530,39,208,16,102,299,664,2022-03-20 21:46:59.994221
16552,13,70,5,52,112,252,2022-03-20 21:47:02.604005
16556,15,123,12,72,130,352,2022-03-20 21:47:03.971529
16560,17,166,10,54,132,379,2022-03-20 21:47:05.861015
16564,19,237,9,78,147,490,2022-03-20 21:47:08.573944
16568,17,118,3,62,103,303,2022-03-20 21:47:10.039993
16592,30201,620081,14306,22557,144185,831330,2022-03-20 21:47:12.753407
16614,134,3935,103,89,1843,6104,2022-03-20 21:47:16.055212
16620,12,113,5,43,96,269,2022-03-20 21:47:17.43112
16646,94,1620,68,94,1140,3016,2022-03-20 21:47:20.705606
16656,764,9800,229,224,4257,15274,2022-03-20 21:47:27.793422
16662,4170,195931,1846,825,64890,267662,2022-03-20 21:47:28.006332
42799,1,62,2,17,28,110,2022-03-21 11:25:58.511293
16664,3119,123273,1518,750,59177,187837,2022-03-20 21:47:29.067058
16678,106,6545,106,139,1860,8756,2022-03-20 21:47:31.998649
16680,262,35396,210,233,4028,40129,2022-03-20 21:47:34.953317
16690,96,2566,47,38,1127,3874,2022-03-20 21:47:37.245076
16692,67,879,37,138,550,1671,2022-03-20 21:47:38.769407
16694,1104,64205,557,292,12226,78384,2022-03-20 21:47:41.586349
16696,17,164,18,87,154,440,2022-03-20 21:47:42.804487
16700,1117,43707,668,351,18188,64031,2022-03-20 21:47:45.979819
16702,21,593,22,77,257,970,2022-03-20 21:47:46.158317
16706,9941,236582,5376,4792,53866,310557,2022-03-20 21:47:48.181629
16718,101,1476,80,112,1660,3429,2022-03-20 21:47:50.747759
16726,99,1510,74,171,471,2325,2022-03-20 21:47:52.862499
16728,22,224,15,54,238,553,2022-03-20 21:47:54.406175
16732,10659,76691,7777,8320,66617,170064,2022-03-20 21:47:58.208217
16738,54,2053,35,82,809,3033,2022-03-20 21:47:59.181328
16788,17,94,10,52,151,324,2022-03-20 21:48:19.934014
16742,32474,360756,24034,43118,122712,583094,2022-03-20 21:48:00.161112
16748,11,87,5,56,108,267,2022-03-20 21:48:02.965878
16774,2851,63959,1780,2815,23074,94479,2022-03-20 21:48:08.782806
16778,13,112,5,49,101,280,2022-03-20 21:48:12.650389
16782,12897,558201,3747,1237,161169,737251,2022-03-20 21:48:13.751073
16784,9,62,4,40,81,196,2022-03-20 21:48:16.081051
16786,15,266,7,42,147,477,2022-03-20 21:48:18.722331
16790,8,55,4,48,68,183,2022-03-20 21:48:20.946657
16794,12,222,5,39,157,435,2022-03-20 21:48:22.570337
16800,8,66,6,43,82,205,2022-03-20 21:48:28.977122
16802,33,483,16,57,565,1154,2022-03-20 21:48:30.815615
16804,22,110,2,64,127,325,2022-03-20 21:48:31.945717
16814,14,90,2,56,111,273,2022-03-20 21:48:36.42841
16818,13,88,4,59,87,251,2022-03-20 21:48:38.97946
16820,11,59,4,56,73,203,2022-03-20 21:48:40.022529
16822,28,485,13,60,296,882,2022-03-20 21:48:41.334922
16828,19,110,3,51,100,283,2022-03-20 21:48:43.813908
16830,10,65,3,58,62,198,2022-03-20 21:48:44.860817
16834,14,73,4,43,74,208,2022-03-20 21:48:47.582831
16866,1405,72824,677,488,21004,96398,2022-03-20 21:48:48.972225
16868,926,43595,443,220,12748,57932,2022-03-20 21:48:51.488377
16870,6209,457429,1106,848,32608,498200,2022-03-20 21:48:51.748429
16904,5118,163875,2113,1760,61295,234161,2022-03-20 21:48:56.37288
16906,215,569,181,312,590,1867,2022-03-20 21:48:59.928829
16908,20,75,9,81,111,296,2022-03-20 21:49:02.564397
16910,2088,21706,1150,1945,12054,38943,2022-03-20 21:49:05.474955
16916,1231,79376,415,344,11822,93188,2022-03-20 21:49:06.2894
16918,12079,145377,8455,7679,88988,262578,2022-03-20 21:49:07.384468
16928,173,4213,128,119,3140,7773,2022-03-20 21:49:10.623738
16934,2704,167013,1124,807,30249,201897,2022-03-20 21:49:14.593976
16954,34,395,12,52,385,878,2022-03-20 21:49:19.412714
16970,32,123,17,51,259,482,2022-03-20 21:49:21.173371
16988,13,125,5,64,79,286,2022-03-20 21:49:25.411065
17002,14,146,8,39,212,419,2022-03-20 21:49:27.702788
17004,12,94,5,65,84,260,2022-03-20 21:49:28.820553
17006,11,101,5,68,83,268,2022-03-20 21:49:30.109547
17010,21,1532,9,33,245,1840,2022-03-20 21:49:30.281331
17020,150,2608,111,100,1972,4941,2022-03-20 21:49:32.304791
17068,28,1473,12,23,255,1791,2022-03-20 21:49:35.16316
17074,38476,392743,18442,6537,142319,598517,2022-03-20 21:49:35.671744
17076,27,778,6,60,143,1014,2022-03-20 21:49:35.925716
17080,1234,9048,715,919,8429,20345,2022-03-20 21:49:36.179796
17090,12,150,11,98,102,373,2022-03-20 21:49:39.246229
17092,33,285,21,84,306,729,2022-03-20 21:49:41.916353
17100,13,81,1,66,86,247,2022-03-20 21:49:43.590935
17102,10,67,5,57,116,255,2022-03-20 21:49:44.597834
17106,17,101,12,66,109,305,2022-03-20 21:49:46.354378
17113,60,3123,39,94,556,3872,2022-03-20 21:49:46.554854
17115,593,31752,570,642,5848,39405,2022-03-20 21:49:49.150686
17117,25,135,12,53,266,491,2022-03-20 21:49:50.456507
17121,1103,44728,459,174,17994,64458,2022-03-20 21:49:53.202883
17127,147,777,104,418,882,2328,2022-03-20 21:49:55.104277
17131,35,151,10,49,303,548,2022-03-20 21:49:56.660631
17137,113,1278,60,70,1491,3012,2022-03-20 21:49:59.565157
17141,55,219,37,100,674,1085,2022-03-20 21:50:01.076585
17147,128,648,171,143,740,1830,2022-03-20 21:50:02.067508
17151,11,354,3,20,50,438,2022-03-20 21:50:03.318581
17159,16,295,14,56,144,525,2022-03-20 21:50:05.850104
17165,29,281,16,49,227,602,2022-03-20 21:50:08.120024
17167,32,244,23,61,313,673,2022-03-20 21:50:10.087287
17201,19,106,6,45,180,356,2022-03-20 21:50:12.845433
17205,387,16378,246,220,7828,25059,2022-03-20 21:50:13.062449
17219,13,163,7,63,97,343,2022-03-20 21:50:21.284467
17221,44,305,13,57,500,919,2022-03-20 21:50:22.797765
17223,30,321,8,52,309,720,2022-03-20 21:50:25.105189
17237,58,240,48,124,276,746,2022-03-20 21:50:28.118667
17245,15,683,6,24,132,860,2022-03-20 21:50:28.324989
17247,15284,193894,8083,10808,68717,296786,2022-03-20 21:50:28.587118
17293,36,891,14,34,285,1260,2022-03-20 21:50:31.057397
17321,8,67,2,58,82,217,2022-03-20 21:50:32.945609
17325,71,369,39,112,1044,1635,2022-03-20 21:50:36.355163
17339,27,205,11,41,267,551,2022-03-20 21:50:36.545229
17341,341,14056,171,135,4242,18945,2022-03-20 21:50:38.850296
17345,655,9670,307,225,5871,16728,2022-03-20 21:50:39.039819
17351,105,5020,65,52,1413,6655,2022-03-20 21:50:41.339253
17357,85,2429,60,98,1256,3928,2022-03-20 21:50:45.33175
17387,35,459,28,105,215,842,2022-03-20 21:50:49.241845
17389,4943,58516,1713,1541,30594,97307,2022-03-20 21:50:49.714231
17391,742,12186,777,288,3147,17140,2022-03-20 21:50:54.605061
17397,1904,24036,712,1300,12261,40213,2022-03-20 21:50:56.937475
17403,27,239,17,74,472,829,2022-03-20 21:50:57.196774
17405,27,112,20,50,460,669,2022-03-20 21:50:58.672298
17409,1503,34116,807,839,13865,51130,2022-03-20 21:50:59.111345
17423,29,87,11,73,252,452,2022-03-20 21:51:03.509537
17427,17,104,5,43,103,272,2022-03-20 21:51:04.757462
17437,480,13837,262,181,7471,22231,2022-03-20 21:51:04.951747
17439,12,129,12,69,164,386,2022-03-20 21:51:06.52023
17445,16,122,12,78,169,397,2022-03-20 21:51:10.345684
17457,19,87,9,81,123,319,2022-03-20 21:51:12.583027
17481,22,259,5,49,148,483,2022-03-20 21:51:18.544945
17487,24,56,11,57,124,272,2022-03-20 21:51:22.10747
17489,13,117,4,46,104,284,2022-03-20 21:51:23.268429
17493,33,234,15,58,470,810,2022-03-20 21:51:24.633658
17497,197,1118,133,223,1441,3112,2022-03-20 21:51:25.074524
17535,1158,67027,591,409,13379,82564,2022-03-20 21:51:28.272856
17549,24115,185024,14204,9973,144498,377814,2022-03-20 21:51:28.732706
17551,123,3067,139,173,2435,5937,2022-03-20 21:51:28.905151
17585,193,4822,116,95,2023,7249,2022-03-20 21:51:29.497426
17619,22,101,14,64,227,428,2022-03-20 21:51:33.363761
17621,24,208,14,77,269,592,2022-03-20 21:51:33.567269
17623,13,107,10,79,100,309,2022-03-20 21:51:36.007608
17635,739,7873,429,271,6726,16038,2022-03-20 21:51:39.969735
17641,2381,146482,955,712,25346,175876,2022-03-20 21:51:44.890746
17649,26,74,11,49,226,386,2022-03-20 21:51:47.056075
17655,136,2574,89,115,1710,4624,2022-03-20 21:51:50.488591
17657,9,60,12,39,148,268,2022-03-20 21:51:51.729504
17659,71,1962,50,64,864,3011,2022-03-20 21:51:53.647153
17667,21,117,25,89,223,475,2022-03-20 21:51:56.141092
17669,28,113,13,87,171,412,2022-03-20 21:51:57.365997
17671,26,148,23,103,247,547,2022-03-20 21:51:57.542862
17677,383,5345,138,82,5173,11121,2022-03-20 21:52:00.922236
17679,170,4915,78,65,2819,8047,2022-03-20 21:52:03.060083
17687,17,128,12,75,170,402,2022-03-20 21:52:05.752841
17689,33,354,18,51,514,970,2022-03-20 21:52:07.404703
17699,154,3928,98,112,1946,6238,2022-03-20 21:52:09.255257
17719,23,368,9,55,249,704,2022-03-20 21:52:11.95461
17731,583,6107,552,750,2457,10449,2022-03-20 21:52:13.03611
17777,8431,91966,4264,8947,41191,154799,2022-03-20 21:52:14.206979
17819,143,11101,90,124,1889,13347,2022-03-20 21:52:18.064752
17821,3242,24235,2231,4472,17434,51614,2022-03-20 21:52:20.246529
17823,42,261,31,90,300,724,2022-03-20 21:52:22.145969
17827,8026,67461,3957,5522,38726,123692,2022-03-20 21:52:22.57954
17831,7768,80260,4396,10155,31198,133777,2022-03-20 21:52:25.72193
17835,23,106,5,60,206,400,2022-03-20 21:52:26.862695
17843,162,8083,112,187,1958,10502,2022-03-20 21:52:29.076453
17849,426,6061,223,875,1986,9571,2022-03-20 21:52:31.544663
17855,144,6033,67,68,1839,8151,2022-03-20 21:52:34.536713
17871,236,2825,112,86,2087,5346,2022-03-20 21:52:37.173714
17873,572,29809,528,729,5475,37113,2022-03-20 21:52:39.31819
17875,3059,25987,1048,494,5282,35870,2022-03-20 21:52:39.502186
17879,916,17251,749,519,10050,29485,2022-03-20 21:52:40.710744
17887,68,962,28,36,540,1634,2022-03-20 21:52:43.084945
17891,6,158,2,31,77,274,2022-03-20 21:52:43.260214
17893,12,173,13,63,113,374,2022-03-20 21:52:44.863608
17895,49728,560583,31775,38702,200967,881755,2022-03-20 21:52:45.03764
17897,43,1246,16,43,475,1823,2022-03-20 21:52:48.293133
17901,234,13734,119,164,2675,16926,2022-03-20 21:52:48.453155
17909,8648,59310,5911,5736,72815,152420,2022-03-20 21:52:49.870677
17913,44,2611,14,30,322,3021,2022-03-20 21:52:50.067967
17949,853,25031,307,415,6273,32879,2022-03-20 21:52:53.022159
17951,23,370,7,45,154,599,2022-03-20 21:52:53.676187
17953,11,156,8,42,116,333,2022-03-20 21:52:53.937668
17963,34,426,23,77,438,998,2022-03-20 21:52:58.754254
17965,29,330,15,72,369,815,2022-03-20 21:52:59.89985
17977,13,169,7,37,121,347,2022-03-20 21:53:02.661196
17981,14,117,8,42,118,299,2022-03-20 21:53:06.327268
17991,33,196,12,55,343,639,2022-03-20 21:53:13.220107
18001,6049,113844,4024,5445,22900,152262,2022-03-20 21:53:16.231903
18005,19,137,18,72,140,386,2022-03-20 21:53:17.896342
18029,14,215,7,44,120,400,2022-03-20 21:53:18.57245
18031,12,160,7,43,115,337,2022-03-20 21:53:18.838445
18061,26,345,15,95,363,844,2022-03-20 21:53:25.429436
18063,22,337,18,95,354,826,2022-03-20 21:53:25.647696
18071,20,82,9,44,176,331,2022-03-20 21:53:27.415098
18083,17,224,4,45,117,407,2022-03-20 21:53:28.962384
18087,12,168,9,45,117,351,2022-03-20 21:53:30.384941
18095,10766,91023,5682,8773,54619,170863,2022-03-20 21:53:30.827214
18119,10649,108531,5938,6230,65748,197096,2022-03-20 21:53:31.956497
18153,54162,625911,31673,30166,288433,1030345,2022-03-20 21:53:33.205564
18197,68,241,26,78,292,705,2022-03-20 21:53:35.764962
18199,57,216,24,73,210,580,2022-03-20 21:53:38.396034
18205,126,948,96,316,540,2026,2022-03-20 21:53:38.575139
18227,44,110,22,110,210,496,2022-03-20 21:53:40.338754
18229,9239,81625,7616,10851,64759,174090,2022-03-20 21:53:40.514365
18319,13,85,3,56,88,245,2022-03-20 21:54:16.60703
18241,23,142,15,94,167,441,2022-03-20 21:53:45.66701
18245,9546,121295,5145,5780,80420,222186,2022-03-20 21:53:48.500833
18247,11674,283899,6134,10920,40918,353545,2022-03-20 21:53:51.195928
18269,10,44,1,52,53,160,2022-03-20 21:53:53.450542
18271,16,127,5,62,115,325,2022-03-20 21:53:55.980705
18273,17,179,8,38,116,358,2022-03-20 21:53:57.695884
18275,14,71,5,47,79,216,2022-03-20 21:53:59.291248
18283,9,69,2,53,74,207,2022-03-20 21:54:02.560952
18295,3159,66097,1914,1918,14462,87550,2022-03-20 21:54:05.38897
18303,12,63,2,49,66,192,2022-03-20 21:54:08.21592
18305,21,176,13,79,195,484,2022-03-20 21:54:09.517587
18307,21,111,4,61,117,314,2022-03-20 21:54:10.864121
18309,11,113,6,73,89,292,2022-03-20 21:54:11.997947
18311,9,72,3,41,74,199,2022-03-20 21:54:13.099191
18313,14,89,3,62,91,259,2022-03-20 21:54:14.478278
18317,7,60,1,40,61,169,2022-03-20 21:54:15.076902
18321,8,61,1,41,56,167,2022-03-20 21:54:17.565649
18325,14,98,2,51,86,251,2022-03-20 21:54:19.825884
18327,12,87,2,67,78,246,2022-03-20 21:54:20.957155
18331,11,84,4,48,70,217,2022-03-20 21:54:23.869841
18339,13,80,2,59,91,245,2022-03-20 21:54:26.933996
18343,520,7054,459,277,3600,11910,2022-03-20 21:54:28.119691
18353,7,134,6,37,63,247,2022-03-20 21:54:29.304134
18355,11,94,8,65,97,275,2022-03-20 21:54:30.346532
18365,34,333,38,115,380,900,2022-03-20 21:54:31.586369
18375,15,598,11,30,121,775,2022-03-20 21:54:33.270728
18377,13,131,4,66,99,313,2022-03-20 21:54:34.336984
18389,23,132,10,46,136,347,2022-03-20 21:54:34.516254
18419,86,2565,47,60,890,3648,2022-03-20 21:54:37.258659
18425,18,387,4,35,92,536,2022-03-20 21:54:38.422622
18429,462,20732,232,228,5869,27523,2022-03-20 21:54:38.594524
18447,42,145,22,59,342,610,2022-03-20 21:54:41.515453
18449,71,1484,52,88,976,2671,2022-03-20 21:54:43.54997
18451,22,105,6,51,214,398,2022-03-20 21:54:47.314765
18457,31,663,25,84,170,973,2022-03-20 21:54:47.496105
18475,19,61,6,51,108,245,2022-03-20 21:54:50.968296
18489,9,215,7,76,86,393,2022-03-20 21:54:52.37101
18495,3202,18165,2200,4995,18219,46781,2022-03-20 21:54:53.824799
18499,1345,13775,717,298,10786,26921,2022-03-20 21:54:56.836562
18507,37758,511178,21518,33708,112351,716513,2022-03-20 21:55:02.08843
18523,1495,42500,835,696,8575,54101,2022-03-20 21:55:08.565975
18527,16,105,5,52,122,300,2022-03-20 21:55:11.504261
18533,16,366,11,47,237,677,2022-03-20 21:55:12.931564
18549,90,1607,61,102,1242,3102,2022-03-20 21:55:16.095136
18561,9,357,3,28,55,452,2022-03-20 21:55:19.311303
18573,16,81,5,55,108,265,2022-03-20 21:55:23.009255
18577,14,100,8,41,78,241,2022-03-20 21:55:25.251574
18583,25,79,7,48,159,318,2022-03-20 21:55:25.728653
18589,12,157,8,49,111,337,2022-03-20 21:55:26.439049
18603,34,720,30,66,390,1240,2022-03-20 21:55:27.013254
18713,571,21952,313,149,6477,29462,2022-03-20 21:55:33.942733
18723,32,389,9,32,212,674,2022-03-20 21:55:36.055046
18729,79,718,39,116,1110,2062,2022-03-20 21:55:38.471506
18731,14,90,10,49,88,251,2022-03-20 21:55:40.188095
18753,2679,207745,992,531,25500,237447,2022-03-20 21:55:42.803447
18755,197,2747,189,221,1224,4578,2022-03-20 21:55:43.237561
18781,135,1797,183,127,1093,3335,2022-03-20 21:55:44.255909
18823,10,163,4,39,92,308,2022-03-20 21:55:47.629316
18825,14,173,8,44,111,350,2022-03-20 21:55:48.998028
18827,14,260,6,47,155,482,2022-03-20 21:55:49.168452
18849,475,22200,281,165,7929,31050,2022-03-20 21:55:54.711348
18851,872,33672,495,334,12067,47440,2022-03-20 21:55:54.922957
18857,1459,113356,748,1031,14662,131256,2022-03-20 21:55:57.598156
18881,201,5333,241,314,3733,9822,2022-03-20 21:56:00.843732
18893,6132,82004,4098,6528,41920,140682,2022-03-20 21:56:01.020388
18897,47552,737134,26039,34300,190097,1035122,2022-03-20 21:56:01.372134
18919,26,40,9,66,231,372,2022-03-20 21:56:05.392274
18937,15,133,13,71,103,335,2022-03-20 21:56:06.671881
18943,13,87,10,69,100,279,2022-03-20 21:56:10.291462
18953,53,1826,19,41,522,2461,2022-03-20 21:56:12.108828
18967,12,96,5,63,112,288,2022-03-20 21:56:13.302643
18989,241,5599,142,146,4608,10736,2022-03-20 21:56:16.560607
19009,13,270,8,34,220,545,2022-03-20 21:56:16.736752
19021,1703,66164,1055,634,24761,94317,2022-03-20 21:56:16.985203
19049,14,65,3,55,95,232,2022-03-20 21:56:21.334535
19053,13,114,4,40,89,260,2022-03-20 21:56:22.587344
19059,11,98,3,40,78,230,2022-03-20 21:56:23.663153
19067,744,5094,522,922,2232,9514,2022-03-20 21:56:27.380542
19069,9,86,5,33,105,238,2022-03-20 21:56:28.528426
19071,12,75,3,30,58,178,2022-03-20 21:56:30.090658
19081,31,2146,5,29,197,2408,2022-03-20 21:56:31.929269
19087,20,131,8,80,109,348,2022-03-20 21:56:33.726802
19099,87,6087,83,114,1504,7875,2022-03-20 21:56:35.829071
19109,868,28123,534,377,9920,39822,2022-03-20 21:56:36.039468
19111,8627,176884,4911,4225,39249,233896,2022-03-20 21:56:36.297019
19115,741,11420,403,216,15425,28205,2022-03-20 21:56:36.560505
19125,11,430,9,46,108,604,2022-03-20 21:56:38.761203
19133,340,4566,240,489,2041,7676,2022-03-20 21:56:39.814594
19135,30,282,14,50,356,732,2022-03-20 21:56:39.991702
19217,10,813,5,34,142,1004,2022-03-20 21:56:47.706607
19219,13,745,4,27,135,924,2022-03-20 21:56:49.209789
19221,14420,261196,6523,9054,82993,374186,2022-03-20 21:56:49.645179
19231,15,710,5,28,106,864,2022-03-20 21:56:51.119105
19233,18,852,12,42,214,1138,2022-03-20 21:56:52.499789
19239,13,508,7,23,69,620,2022-03-20 21:56:56.115499
19251,452,16450,244,284,7573,25003,2022-03-20 21:56:56.628015
19261,279,7218,189,293,4618,12597,2022-03-20 21:56:57.660922
19297,78,2472,47,75,722,3394,2022-03-20 21:57:00.872945
19305,23,168,27,115,303,636,2022-03-20 21:57:02.803258
19311,18,58,6,57,79,218,2022-03-20 21:57:03.8753
19315,5316,107038,2860,19070,37080,171364,2022-03-20 21:57:04.061911
19319,3791,43935,2219,2772,14341,67058,2022-03-20 21:57:04.57598
19337,18,243,12,67,194,534,2022-03-20 21:57:07.906378
19363,3891,103036,2424,1222,22502,133075,2022-03-20 21:57:11.075237
19365,8488,47733,7782,13082,45878,122963,2022-03-20 21:57:11.27575
19367,2540,26865,2380,5621,13980,51386,2022-03-20 21:57:11.811024
21963,12,104,5,62,82,265,2022-03-20 22:06:49.155543
19369,16009,211984,8047,10053,75128,321221,2022-03-20 21:57:12.240164
19429,11821,152029,7141,13429,62518,246938,2022-03-20 21:57:13.293635
19457,17,69,8,55,79,228,2022-03-20 21:57:15.925853
19467,40,84,21,61,425,631,2022-03-20 21:57:19.678703
19479,28,216,23,56,287,610,2022-03-20 21:57:24.343568
19495,44,111,21,45,297,518,2022-03-20 21:57:28.278527
19497,11,70,3,47,80,211,2022-03-20 21:57:29.477666
19501,29,81,12,60,168,350,2022-03-20 21:57:31.132925
19505,23,121,20,94,245,503,2022-03-20 21:57:32.339638
19511,773,50637,377,283,8138,60208,2022-03-20 21:57:32.658012
19513,24,89,9,52,235,409,2022-03-20 21:57:34.381356
19515,23,92,12,50,188,365,2022-03-20 21:57:34.558837
19517,9,78,3,62,73,225,2022-03-20 21:57:35.700883
19521,33,2167,13,31,302,2546,2022-03-20 21:57:40.135756
19533,15,214,8,45,199,481,2022-03-20 21:57:40.354499
19535,22,105,17,97,171,412,2022-03-20 21:57:42.6887
19547,27,113,9,65,88,302,2022-03-20 21:57:43.776761
19555,12,61,3,49,64,189,2022-03-20 21:57:45.115654
19557,18,174,13,69,98,372,2022-03-20 21:57:46.264047
19559,13,69,8,44,112,246,2022-03-20 21:57:47.277893
19575,338,5962,156,167,2785,9408,2022-03-20 21:57:50.086164
19585,34,187,38,84,131,474,2022-03-20 21:57:53.108817
19613,566,21385,225,233,7895,30304,2022-03-20 21:57:55.844092
19619,55,809,34,77,488,1463,2022-03-20 21:57:57.594788
19627,16,146,11,49,228,450,2022-03-20 21:57:57.788647
19669,624,38827,304,257,7976,47988,2022-03-20 21:57:58.522288
19705,10,92,4,39,66,211,2022-03-20 21:58:00.900376
19727,103,3117,74,93,1033,4420,2022-03-20 21:58:03.670358
19731,13,197,5,38,145,398,2022-03-20 21:58:07.585947
19745,12,74,4,40,87,217,2022-03-20 21:58:09.612338
19749,13,68,4,41,76,202,2022-03-20 21:58:10.760451
19751,15,104,4,57,113,293,2022-03-20 21:58:12.367301
19759,2231,51939,1045,878,16562,72655,2022-03-20 21:58:13.934731
19769,13485,140223,6809,15599,54131,230247,2022-03-20 21:58:14.477112
19781,22,178,11,43,250,504,2022-03-20 21:58:16.756445
19783,19,63,4,37,124,247,2022-03-20 21:58:18.571714
19797,15,61,4,34,90,204,2022-03-20 21:58:19.593659
19799,1054,9209,492,776,8353,19884,2022-03-20 21:58:20.597525
19815,77742,1714467,33389,48628,235525,2109751,2022-03-20 21:58:22.619532
19817,12,75,6,44,101,238,2022-03-20 21:58:22.823338
19839,19,77,10,50,132,288,2022-03-20 21:58:25.349532
19841,1311,18784,858,1448,8285,30686,2022-03-20 21:58:27.49468
19843,24,152,15,83,253,527,2022-03-20 21:58:29.176057
19845,340,5070,330,357,4309,10406,2022-03-20 21:58:32.158692
19855,3553,35209,2646,7634,13348,62390,2022-03-20 21:58:36.509955
19871,242,386,162,346,1102,2238,2022-03-20 21:58:36.720125
19873,15,91,14,62,155,337,2022-03-20 21:58:37.867492
19875,16,219,13,107,123,478,2022-03-20 21:58:39.195649
19877,79,707,48,112,702,1648,2022-03-20 21:58:42.048989
19889,227,3593,229,119,2851,7019,2022-03-20 21:58:47.305295
19901,14,86,13,77,123,313,2022-03-20 21:58:50.945058
19905,17,75,8,48,176,324,2022-03-20 21:58:51.142877
19907,19,68,8,49,196,340,2022-03-20 21:58:52.312653
19909,16,73,6,47,107,249,2022-03-20 21:58:53.420728
19919,680,2893,511,772,6413,11269,2022-03-20 21:58:57.384182
19925,31,427,22,57,208,745,2022-03-20 21:58:59.605249
19943,14,66,12,65,145,302,2022-03-20 21:59:02.126129
19945,171,4221,135,214,3100,7841,2022-03-20 21:59:04.081865
19947,31,160,25,93,253,562,2022-03-20 21:59:05.462634
19951,2251,111523,1163,657,33196,148790,2022-03-20 21:59:06.375367
19953,723,4982,538,518,3937,10698,2022-03-20 21:59:08.94887
19957,15,157,6,51,126,355,2022-03-20 21:59:10.105887
19961,26,231,27,105,247,636,2022-03-20 21:59:11.984018
19965,14,88,11,59,115,287,2022-03-20 21:59:13.128344
19973,106,2473,54,123,1477,4233,2022-03-20 21:59:16.909264
19977,53,662,49,98,763,1625,2022-03-20 21:59:17.120098
19983,14,103,11,89,151,368,2022-03-20 21:59:19.617238
19989,17,90,13,94,159,373,2022-03-20 21:59:23.212922
19991,12,85,13,88,90,288,2022-03-20 21:59:24.828906
19993,11,78,13,77,89,268,2022-03-20 21:59:25.814473
19997,26,110,18,79,176,409,2022-03-20 21:59:27.936467
19999,13,92,9,94,79,287,2022-03-20 21:59:28.141515
20001,23,89,10,87,147,356,2022-03-20 21:59:29.409059
20023,16,83,5,79,103,286,2022-03-20 21:59:33.52369
20025,12,119,8,81,84,304,2022-03-20 21:59:33.805367
20027,22,123,12,85,213,455,2022-03-20 21:59:35.43207
20031,15357,234275,8632,9808,87741,355813,2022-03-20 21:59:38.133272
20033,1924,27352,1248,2987,12830,46341,2022-03-20 21:59:38.323556
20035,541,15385,331,182,6499,22938,2022-03-20 21:59:38.584143
20039,231,9577,135,106,3194,13243,2022-03-20 21:59:41.220394
20045,922,42794,476,367,10130,54689,2022-03-20 21:59:41.400959
20047,13326,133320,8773,15532,67825,238776,2022-03-20 21:59:44.281717
20053,3369,26027,2524,7365,15335,54620,2022-03-20 21:59:44.718335
20057,20525,155714,15999,12830,106320,311388,2022-03-20 21:59:44.896529
20075,37,268,26,108,157,596,2022-03-20 21:59:46.332498
20077,20,135,9,80,96,340,2022-03-20 21:59:47.451937
20079,24,99,13,82,154,372,2022-03-20 21:59:49.863916
20083,25,108,12,68,176,389,2022-03-20 21:59:54.101977
20085,17,64,12,53,152,298,2022-03-20 21:59:54.302955
20093,21,125,8,57,107,318,2022-03-20 21:59:56.720684
20095,15,89,8,44,105,261,2022-03-20 21:59:57.834838
20109,18,116,9,54,167,364,2022-03-20 21:59:58.888907
20113,13,143,8,61,88,313,2022-03-20 22:00:01.22321
20115,24,135,11,84,215,469,2022-03-20 22:00:02.439929
20117,22,228,12,80,118,460,2022-03-20 22:00:03.572376
20123,15,85,7,53,108,268,2022-03-20 22:00:03.758533
20127,24,110,16,70,161,381,2022-03-20 22:00:06.05837
20143,20,90,7,47,157,321,2022-03-20 22:00:10.13432
20153,11,502,4,29,133,679,2022-03-20 22:00:14.175963
20155,126,2186,89,136,1462,3999,2022-03-20 22:00:14.393264
20173,12,58,8,46,99,223,2022-03-20 22:00:19.982864
20175,13,145,5,56,144,363,2022-03-20 22:00:21.197423
20183,19,112,17,74,177,399,2022-03-20 22:00:22.336492
20185,19,369,11,63,154,616,2022-03-20 22:00:23.860214
20187,143,4366,88,73,2005,6675,2022-03-20 22:00:24.312828
20189,30,234,16,52,245,577,2022-03-20 22:00:24.496417
20199,12,68,6,71,83,240,2022-03-20 22:00:26.099476
20201,11,88,8,78,144,329,2022-03-20 22:00:27.694111
20205,9,77,7,60,81,234,2022-03-20 22:00:28.77573
20207,26,243,24,49,336,678,2022-03-20 22:00:29.209014
20221,379,11816,208,115,4517,17035,2022-03-20 22:00:31.438274
20223,25,105,7,74,230,441,2022-03-20 22:00:32.569907
20227,9,59,5,47,72,192,2022-03-20 22:00:34.029519
20229,17,73,13,43,229,375,2022-03-20 22:00:35.190827
20231,18,70,14,74,139,315,2022-03-20 22:00:36.262991
20235,36,181,21,49,395,682,2022-03-20 22:00:39.419467
20237,18,95,11,96,183,403,2022-03-20 22:00:40.582527
20241,15,69,5,61,87,237,2022-03-20 22:00:42.057903
20243,13,147,7,66,119,352,2022-03-20 22:00:43.289738
20267,240,4182,141,311,1206,6080,2022-03-20 22:00:45.175481
20329,338,3186,184,580,2597,6885,2022-03-20 22:00:47.365088
20353,64,190,28,52,665,999,2022-03-20 22:00:48.992921
20355,40,2159,22,71,438,2730,2022-03-20 22:00:50.905983
20365,282,18026,265,306,4365,23244,2022-03-20 22:00:53.77856
20371,1068,44872,370,477,12972,59759,2022-03-20 22:00:57.57297
20381,30,427,15,81,420,973,2022-03-20 22:01:00.444711
20383,13,87,10,56,119,285,2022-03-20 22:01:00.634758
20385,49,649,36,72,627,1433,2022-03-20 22:01:02.623804
20391,50,1933,47,63,963,3056,2022-03-20 22:01:04.861907
20431,7841,50407,5291,6392,48792,118723,2022-03-20 22:01:05.51508
20441,34,353,11,63,365,826,2022-03-20 22:01:07.727277
20453,10,51,6,50,73,190,2022-03-20 22:01:09.865415
20457,8079,76757,4347,4547,54846,148576,2022-03-20 22:01:10.071323
20463,19,512,8,38,225,802,2022-03-20 22:01:12.524691
20469,44,326,14,44,537,965,2022-03-20 22:01:13.081637
20471,0,0,0,0,6181,6181,2022-03-20 22:01:15.906115
20473,588,19333,268,252,4088,24529,2022-03-20 22:01:16.862795
20479,577,22672,284,216,7347,31096,2022-03-20 22:01:19.430664
20499,22,86,11,48,210,377,2022-03-20 22:01:19.60642
20505,87,914,52,69,1498,2620,2022-03-20 22:01:21.796793
20507,77262,1440767,38850,30483,302748,1890110,2022-03-20 22:01:22.24222
20509,4460,100790,2375,2317,34838,144780,2022-03-20 22:01:22.954832
20517,2510,30628,1771,846,15016,50771,2022-03-20 22:01:23.109614
20529,9,176,7,25,73,290,2022-03-20 22:01:23.361348
20603,14,100,6,47,79,246,2022-03-20 22:01:28.708319
20613,42,4154,23,68,543,4830,2022-03-20 22:01:30.928837
20649,533,11816,321,233,4974,17877,2022-03-20 22:01:31.392387
20667,64,947,49,88,827,1975,2022-03-20 22:01:34.890359
20671,155,3515,72,57,2838,6637,2022-03-20 22:01:35.406378
20689,15462,157320,10314,12949,83084,279129,2022-03-20 22:01:37.874954
20703,8,83,4,36,71,202,2022-03-20 22:01:40.051892
20705,15,226,6,47,133,427,2022-03-20 22:01:42.99314
20707,45,3016,26,52,492,3631,2022-03-20 22:01:46.31577
20709,8632,64402,4823,6243,57241,141341,2022-03-20 22:01:46.493635
20723,479,7144,452,371,2071,10517,2022-03-20 22:01:51.839488
20743,95,5676,92,130,1489,7482,2022-03-20 22:01:55.193478
20745,606,37994,296,219,7469,46584,2022-03-20 22:01:55.393564
20755,13,90,10,78,171,362,2022-03-20 22:01:55.659754
20767,12713,245362,3985,1192,33903,297155,2022-03-20 22:01:58.484815
20785,54852,634852,28761,55615,149999,924079,2022-03-20 22:01:58.749765
20787,34056,579063,18390,27830,170263,829602,2022-03-20 22:02:03.491666
20799,13,113,6,49,135,316,2022-03-20 22:02:05.546626
20811,29,3541,6,43,328,3947,2022-03-20 22:02:05.737925
20815,692,27570,247,357,8227,37093,2022-03-20 22:02:05.997197
20835,93,179,57,69,769,1167,2022-03-20 22:02:09.40408
20843,280,5915,188,138,3095,9616,2022-03-20 22:02:09.570557
20847,11780,150944,6810,5173,54913,229620,2022-03-20 22:02:12.992993
20857,28,1653,14,25,201,1921,2022-03-20 22:02:22.765093
20871,210,6630,149,191,2471,9651,2022-03-20 22:02:23.602831
20873,23,169,6,51,118,367,2022-03-20 22:02:27.423135
20877,131,10004,73,107,1588,11903,2022-03-20 22:02:29.217295
20889,328,11509,158,89,5973,18057,2022-03-20 22:02:29.389645
20899,45988,845178,15260,9064,66858,982348,2022-03-20 22:02:29.717198
20903,1105,34238,471,207,17581,53602,2022-03-20 22:02:34.160088
20909,1229,21739,911,659,14291,38829,2022-03-20 22:02:41.04827
20913,64,3028,27,83,873,4075,2022-03-20 22:02:41.246906
42842,3,85,3,9,21,121,2022-03-21 11:26:13.24103
20929,18,1350,5,27,161,1561,2022-03-20 22:02:43.751699
20931,4133,74520,1752,3056,22343,105804,2022-03-20 22:02:46.448955
20939,1293,53037,483,293,13034,68140,2022-03-20 22:02:48.893598
20945,131,3227,88,181,516,4143,2022-03-20 22:02:51.808975
20951,26,839,9,29,312,1215,2022-03-20 22:02:51.993065
20955,24,337,12,79,231,683,2022-03-20 22:02:52.27075
20965,85,5530,45,44,1277,6981,2022-03-20 22:02:58.021909
20969,122,1533,60,56,1722,3493,2022-03-20 22:03:00.244275
20973,7985,65453,4633,6292,48882,133245,2022-03-20 22:03:01.217508
20975,27,168,14,59,313,581,2022-03-20 22:03:05.460277
20977,387,30925,241,111,4555,36219,2022-03-20 22:03:05.637285
21009,360,4185,189,199,2448,7381,2022-03-20 22:03:09.764134
21013,795,1988,535,1541,3015,7874,2022-03-20 22:03:10.030627
21019,12,58,4,56,66,196,2022-03-20 22:03:11.570068
21021,14,66,11,50,185,326,2022-03-20 22:03:12.854856
21025,26,157,16,59,439,697,2022-03-20 22:03:14.223878
21027,122,1293,73,72,2608,4168,2022-03-20 22:03:14.401539
21031,97,2427,56,101,1115,3796,2022-03-20 22:03:16.662789
21033,9974,134612,4227,8973,38564,196350,2022-03-20 22:03:16.859419
21037,41,133,15,62,434,685,2022-03-20 22:03:18.965313
21039,4044,33435,3319,3585,24845,69228,2022-03-20 22:03:19.149895
21041,19,2054,11,38,279,2401,2022-03-20 22:03:21.628176
21055,20,508,5,29,99,661,2022-03-20 22:03:22.535538
21073,522,4366,349,279,2599,8115,2022-03-20 22:03:23.349918
21103,212,3889,92,88,2594,6875,2022-03-20 22:03:26.919161
21163,26,191,3,31,154,405,2022-03-20 22:03:27.880587
21201,109,7996,64,92,1398,9659,2022-03-20 22:03:33.059739
21215,82,422,51,83,689,1327,2022-03-20 22:03:33.288823
21235,480,12663,295,370,5716,19524,2022-03-20 22:03:35.907357
21241,2104,21896,1738,1228,7836,34802,2022-03-20 22:03:39.908348
21255,25,338,15,66,331,775,2022-03-20 22:03:40.084627
21267,337,7735,170,401,2369,11012,2022-03-20 22:03:40.562588
21273,13843,99845,8467,8553,81403,212111,2022-03-20 22:03:41.603338
21275,19,121,10,57,100,307,2022-03-20 22:03:43.276633
21293,14,124,6,69,77,290,2022-03-20 22:03:47.915542
21297,12,126,6,70,93,307,2022-03-20 22:03:50.554805
21305,323,299,115,163,6522,7422,2022-03-20 22:03:52.683357
21325,987,11809,638,1001,5370,19805,2022-03-20 22:03:52.863206
21327,15008,167043,10975,9999,82694,285719,2022-03-20 22:03:56.076331
42979,5,35,9,35,84,168,2022-03-21 11:27:15.146914
21329,2790,79048,1099,582,38791,122310,2022-03-20 22:03:59.114847
21333,20,613,4,34,163,834,2022-03-20 22:03:59.283511
21335,443,1789,415,812,2018,5477,2022-03-20 22:04:01.91851
21353,9774,88335,6758,13838,41672,160377,2022-03-20 22:04:03.30643
21373,742,17248,419,387,5374,24170,2022-03-20 22:04:03.56106
21395,74,3672,46,100,648,4540,2022-03-20 22:04:06.761739
21405,14954,227251,7829,9115,89665,348814,2022-03-20 22:04:06.939816
21407,851,4601,718,779,3288,10237,2022-03-20 22:04:10.279605
21409,111,2318,45,96,1502,4072,2022-03-20 22:04:12.908955
21415,1594,23474,1052,593,7578,34291,2022-03-20 22:04:13.362932
21421,1410,5888,1026,2512,5280,16116,2022-03-20 22:04:17.58644
21427,288,2478,183,397,1787,5133,2022-03-20 22:04:17.78372
21433,14,152,12,86,194,458,2022-03-20 22:04:22.168837
21435,1959,15043,1351,956,9968,29277,2022-03-20 22:04:22.608852
21437,3914,49625,2161,4118,20465,80283,2022-03-20 22:04:26.143876
21439,3221,34136,2032,2426,13359,55174,2022-03-20 22:04:27.094345
21441,64,3444,25,34,484,4051,2022-03-20 22:04:27.269747
21447,27,111,11,82,203,434,2022-03-20 22:04:28.962989
21451,66,2906,18,32,579,3601,2022-03-20 22:04:30.855605
21467,16,122,8,62,113,321,2022-03-20 22:04:31.038286
21469,703,37219,197,297,4767,43183,2022-03-20 22:04:31.212888
21471,48,938,20,34,287,1327,2022-03-20 22:04:35.246041
21473,1286,53098,554,334,19344,74616,2022-03-20 22:04:37.461801
21475,19,120,7,52,95,293,2022-03-20 22:04:37.64285
21479,85,1974,57,137,1077,3330,2022-03-20 22:04:37.814546
21483,24,77,8,62,157,328,2022-03-20 22:04:41.250873
21485,12,76,6,54,92,240,2022-03-20 22:04:42.300913
21487,20,134,16,80,147,397,2022-03-20 22:04:43.42537
21491,24,121,8,70,114,337,2022-03-20 22:04:46.169399
21495,477,4833,251,378,3719,9658,2022-03-20 22:04:50.508891
21497,203,3270,83,117,1884,5557,2022-03-20 22:04:53.309316
21507,8429,115589,6252,20315,37857,188442,2022-03-20 22:04:53.49385
21511,11855,103840,7294,13522,66723,203234,2022-03-20 22:04:54.222933
21541,944,20476,515,404,9001,31340,2022-03-20 22:04:59.286028
21547,19,73,7,51,123,273,2022-03-20 22:05:03.010426
21553,10,81,4,70,72,237,2022-03-20 22:05:06.104357
21557,4189,170452,1712,749,67509,244611,2022-03-20 22:05:06.261027
21569,258,33297,179,202,4032,37968,2022-03-20 22:05:12.98842
21573,2120,25586,1018,861,12602,42187,2022-03-20 22:05:17.335977
21587,514,5412,328,275,2911,9440,2022-03-20 22:05:18.170764
21591,23,602,15,41,236,917,2022-03-20 22:05:18.440752
21603,23073,240462,16756,22558,110494,413343,2022-03-20 22:05:19.263039
21649,139,2764,66,61,1517,4547,2022-03-20 22:05:20.473414
21677,5469,25940,4529,11128,16667,63733,2022-03-20 22:05:25.6056
21679,565,20070,244,171,5984,27034,2022-03-20 22:05:30.003296
21681,6331,44457,4365,5867,41721,102741,2022-03-20 22:05:30.181322
21695,113,5373,101,132,1733,7452,2022-03-20 22:05:32.461286
21701,45,657,31,43,572,1348,2022-03-20 22:05:32.630445
21711,9,185,3,34,46,277,2022-03-20 22:05:37.3557
21717,7,249,3,27,50,336,2022-03-20 22:05:40.035495
21749,29,127,12,46,277,491,2022-03-20 22:05:44.445089
21755,675,10285,304,213,3836,15313,2022-03-20 22:05:47.549166
21761,11,85,22,108,87,313,2022-03-20 22:05:48.70519
21765,11,177,8,67,96,359,2022-03-20 22:05:51.592771
21771,298,9424,110,161,2794,12787,2022-03-20 22:05:53.772769
21773,260,7743,107,134,2514,10758,2022-03-20 22:05:54.226144
21775,200,1215,60,78,1345,2898,2022-03-20 22:05:56.662354
21781,593,8746,151,103,4270,13863,2022-03-20 22:05:56.843077
21809,4667,27716,2609,7482,21015,63489,2022-03-20 22:06:00.253765
21821,1858,10183,1027,3227,8638,24933,2022-03-20 22:06:00.484512
21831,11,535,5,46,100,697,2022-03-20 22:06:03.129559
21833,8,257,2,39,51,357,2022-03-20 22:06:03.574757
21835,1135,2762,799,2352,2104,9152,2022-03-20 22:06:03.740574
21843,20792,211808,11474,11637,115667,371378,2022-03-20 22:06:07.079618
21845,5643,38109,3581,7390,31023,85746,2022-03-20 22:06:10.629945
21851,207,1966,124,139,1977,4413,2022-03-20 22:06:10.803389
21853,185,4987,153,190,3246,8761,2022-03-20 22:06:13.433896
21855,9234,275348,4422,1794,94342,385140,2022-03-20 22:06:16.173904
43239,0,11,2,9,10,32,2022-03-21 11:28:08.746087
21861,55,3350,23,55,848,4331,2022-03-20 22:06:17.927698
21863,12289,156330,5954,8867,68342,251782,2022-03-20 22:06:18.133997
21867,227,8673,80,158,2318,11456,2022-03-20 22:06:18.394062
21869,17,120,4,51,131,323,2022-03-20 22:06:18.654988
21881,71764,1465925,27473,78332,93889,1737383,2022-03-20 22:06:20.067206
21913,10,67,5,43,52,177,2022-03-20 22:06:28.966971
21933,12,114,3,64,78,271,2022-03-20 22:06:30.187313
21935,14,109,3,62,76,264,2022-03-20 22:06:31.20791
21937,17,184,8,59,89,357,2022-03-20 22:06:33.083107
21941,12,110,5,60,78,265,2022-03-20 22:06:34.880272
21943,13,118,3,62,74,270,2022-03-20 22:06:37.052487
21945,13,97,5,60,76,251,2022-03-20 22:06:38.134111
21953,16,94,7,64,83,264,2022-03-20 22:06:42.92027
21955,12,91,5,58,66,232,2022-03-20 22:06:44.054304
21961,11,119,5,65,84,284,2022-03-20 22:06:48.006824
21967,12,106,7,67,87,279,2022-03-20 22:06:50.40889
21975,12,100,4,62,78,256,2022-03-20 22:06:55.905986
21981,14,39,3,65,62,183,2022-03-20 22:06:57.012077
21995,31869,553905,15229,16125,167095,784223,2022-03-20 22:06:57.264733
21997,46,385,20,114,407,972,2022-03-20 22:06:58.801376
21999,53,381,21,124,426,1005,2022-03-20 22:07:00.28865
22031,48,433,22,32,310,845,2022-03-20 22:07:01.310028
22053,39,317,35,57,628,1076,2022-03-20 22:07:02.389895
22099,290,609,198,744,904,2745,2022-03-20 22:07:10.195533
22101,14232,163934,8175,11057,75082,272480,2022-03-20 22:07:13.50906
22117,553,23204,297,138,6756,30948,2022-03-20 22:07:15.810569
22123,2908,45132,1323,2477,19749,71589,2022-03-20 22:07:16.061447
22125,533,34582,290,234,7773,43412,2022-03-20 22:07:16.330376
22131,12,46,4,55,75,192,2022-03-20 22:07:21.250862
22135,14198,177590,8601,6724,126201,333314,2022-03-20 22:07:21.42977
22137,41,541,13,30,408,1033,2022-03-20 22:07:24.243753
22145,11953,264414,5979,4887,67634,354867,2022-03-20 22:07:25.271785
22157,12,862,9,45,140,1068,2022-03-20 22:07:26.069021
22163,15,316,7,27,98,463,2022-03-20 22:07:27.754863
22165,14,433,4,33,113,597,2022-03-20 22:07:27.971862
22179,17,1672,12,74,214,1989,2022-03-20 22:07:29.131561
22219,12,63,7,86,88,256,2022-03-20 22:07:31.360955
22221,19,308,19,113,140,599,2022-03-20 22:07:31.563309
22293,16,303,8,30,127,484,2022-03-20 22:07:35.661307
22295,142,1939,73,84,2159,4397,2022-03-20 22:07:37.669641
22297,30820,739461,12010,7993,132644,922928,2022-03-20 22:07:38.108642
22313,38,89,14,56,312,509,2022-03-20 22:07:40.530184
22319,92501,2046350,31447,49775,207477,2427550,2022-03-20 22:07:40.810573
22325,11,44,6,40,131,232,2022-03-20 22:07:42.577749
22329,15,142,8,49,164,378,2022-03-20 22:07:45.188468
22359,1549,6324,1419,2546,15248,27086,2022-03-20 22:07:49.964806
43241,0,8,0,10,11,29,2022-03-21 11:28:09.66489
22377,241,3654,135,629,1639,6298,2022-03-20 22:07:52.585465
22381,57,539,43,138,409,1186,2022-03-20 22:07:52.798147
22391,11,56,11,75,70,223,2022-03-20 22:07:57.525874
22393,10,158,4,31,71,274,2022-03-20 22:07:57.737969
22411,9,329,6,35,77,456,2022-03-20 22:08:00.079414
22413,10,114,6,56,82,268,2022-03-20 22:08:01.538896
22415,10,523,4,36,88,661,2022-03-20 22:08:03.29281
22419,263,3287,182,320,3736,7788,2022-03-20 22:08:08.47739
22433,4293,47626,2512,3004,29364,86799,2022-03-20 22:08:12.325579
22439,23,238,16,63,193,533,2022-03-20 22:08:14.671126
22443,33,584,10,51,228,906,2022-03-20 22:08:18.455031
22445,12,197,5,44,115,373,2022-03-20 22:08:18.694406
22447,19,270,5,51,131,476,2022-03-20 22:08:18.956023
22457,9,137,7,44,95,292,2022-03-20 22:08:19.973338
22467,11,243,5,41,77,377,2022-03-20 22:08:21.178873
22483,15,191,3,45,111,365,2022-03-20 22:08:22.326624
22499,9,130,5,44,90,278,2022-03-20 22:08:23.61822
22535,81925,1203169,38526,28305,236197,1588122,2022-03-20 22:08:25.032371
22565,13,204,3,50,106,376,2022-03-20 22:08:26.26782
22577,15,141,3,44,97,300,2022-03-20 22:08:28.799644
22583,180,2184,141,107,3927,6539,2022-03-20 22:08:29.012257
22593,12,168,6,41,93,320,2022-03-20 22:08:29.597227
22623,10,103,5,42,82,242,2022-03-20 22:08:32.791242
22627,9,114,5,44,97,269,2022-03-20 22:08:34.001952
22649,12,80,5,55,87,239,2022-03-20 22:08:37.750332
22651,17,100,7,47,102,273,2022-03-20 22:08:39.608948
22657,14,103,7,43,76,243,2022-03-20 22:08:42.365653
22661,172,4782,175,214,2536,7879,2022-03-20 22:08:42.717161
22663,12966,199898,4838,10437,46446,274585,2022-03-20 22:08:42.905857
22777,7786,124918,3455,4178,18117,158454,2022-03-20 22:09:08.405721
22687,10319,133112,5784,14642,45870,209727,2022-03-20 22:08:48.648044
22689,1207,25096,931,1005,6012,34251,2022-03-20 22:08:48.874893
22693,762,3731,542,697,3885,9617,2022-03-20 22:08:49.553739
22695,198,8527,169,194,2727,11815,2022-03-20 22:08:49.98288
22699,266,10950,175,225,3269,14885,2022-03-20 22:08:53.984414
22709,15,109,6,70,87,287,2022-03-20 22:08:55.29858
22711,10,62,4,59,76,211,2022-03-20 22:08:56.278592
26215,7,28,3,46,46,130,2022-03-20 22:21:13.527393
22729,18396,332918,10227,16486,96483,474510,2022-03-20 22:08:56.713378
22733,595,1392,422,1049,1297,4755,2022-03-20 22:08:57.685089
22745,299,16108,176,161,3984,20728,2022-03-20 22:09:03.699214
22755,19,95,7,88,119,328,2022-03-20 22:09:03.907967
22757,67,167,27,71,558,890,2022-03-20 22:09:05.310762
22759,619,20911,368,189,7956,30043,2022-03-20 22:09:07.861253
22763,892,30101,479,183,10500,42155,2022-03-20 22:09:08.036482
26217,15,55,4,45,75,194,2022-03-20 22:21:14.61504
22785,460,1774,181,246,4205,6866,2022-03-20 22:09:08.565693
22819,180,4552,81,160,2070,7043,2022-03-20 22:09:09.291207
22839,1518,47262,399,219,18836,68234,2022-03-20 22:09:14.462768
22841,16,944,8,24,202,1194,2022-03-20 22:09:16.766216
22845,13,45,4,49,48,159,2022-03-20 22:09:17.771104
22849,78,188,27,76,795,1164,2022-03-20 22:09:20.685177
22851,10,73,2,62,92,239,2022-03-20 22:09:21.997976
22859,558,24796,392,225,8004,33975,2022-03-20 22:09:22.172212
22865,9985,101590,4966,6456,42695,165692,2022-03-20 22:09:25.480673
22877,14724,234251,5856,10029,62870,327730,2022-03-20 22:09:28.608189
22887,12,61,6,69,90,238,2022-03-20 22:09:29.743262
22893,52,118,34,80,533,817,2022-03-20 22:09:31.533156
22943,15,499,8,28,155,705,2022-03-20 22:09:33.064275
22953,16,155,4,40,66,281,2022-03-20 22:09:34.92857
22955,813,1566,813,1843,4286,9321,2022-03-20 22:09:35.107067
22961,2196,133800,811,464,19976,157247,2022-03-20 22:09:39.99168
22977,14,131,7,64,98,314,2022-03-20 22:09:45.964557
22979,20,120,9,51,172,372,2022-03-20 22:09:47.623034
22983,21,549,12,52,202,836,2022-03-20 22:09:50.634382
22993,8,88,5,65,71,237,2022-03-20 22:09:56.189615
22997,25,117,14,79,146,381,2022-03-20 22:09:58.517249
23001,19,118,9,85,93,324,2022-03-20 22:09:59.995351
23003,13,68,8,99,114,302,2022-03-20 22:10:01.711139
23007,9,77,10,78,110,284,2022-03-20 22:10:03.94107
23009,12,87,8,82,152,341,2022-03-20 22:10:05.12099
23013,22,116,14,91,160,403,2022-03-20 22:10:07.301531
23023,81,3017,60,111,1028,4297,2022-03-20 22:10:10.740129
23037,1791,11142,1688,5369,7866,27856,2022-03-20 22:10:15.467218
23043,52,2632,26,43,605,3358,2022-03-20 22:10:17.650504
23053,18,467,8,28,227,748,2022-03-20 22:10:20.630669
23055,13,408,7,35,106,569,2022-03-20 22:10:21.727279
23057,65,3191,18,61,753,4088,2022-03-20 22:10:24.081615
23059,24,1206,15,26,351,1622,2022-03-20 22:10:25.942386
23061,19,486,10,37,249,801,2022-03-20 22:10:26.116529
23063,36,1090,13,42,445,1626,2022-03-20 22:10:27.910849
23065,17,484,12,30,237,780,2022-03-20 22:10:29.412438
23067,282,2049,261,370,1139,4101,2022-03-20 22:10:32.067171
23079,8137,88398,5467,19934,34246,156182,2022-03-20 22:10:32.42103
23083,73,1912,61,94,1089,3229,2022-03-20 22:10:32.607061
23089,15,428,5,55,69,572,2022-03-20 22:10:35.838503
23097,9,69,10,78,82,248,2022-03-20 22:10:37.689076
23099,63,2132,36,78,686,2995,2022-03-20 22:10:37.885608
23107,28,173,19,85,269,574,2022-03-20 22:10:38.130317
23115,213,3640,200,172,3476,7701,2022-03-20 22:10:40.380758
23121,4603,27744,3295,6877,21835,64354,2022-03-20 22:10:43.589661
23125,14,47,4,52,78,195,2022-03-20 22:10:43.776291
23129,17,272,13,37,208,547,2022-03-20 22:10:45.055645
23133,4649,19195,3635,7059,19676,54214,2022-03-20 22:10:47.76474
23135,3137,4076,1911,2187,7602,18913,2022-03-20 22:10:48.209909
23137,205,1978,150,174,2573,5080,2022-03-20 22:10:51.149707
23149,14,163,10,94,143,424,2022-03-20 22:10:52.727121
23151,995,4595,931,2533,5884,14938,2022-03-20 22:10:52.905565
23153,517,7168,313,173,4101,12272,2022-03-20 22:10:55.046059
23157,11,368,6,25,127,537,2022-03-20 22:10:55.222805
23177,24,262,18,39,280,623,2022-03-20 22:10:55.482319
23179,235,2704,117,188,2031,5275,2022-03-20 22:10:59.035786
23181,10,84,22,100,91,307,2022-03-20 22:10:59.225285
23183,21,102,25,106,121,375,2022-03-20 22:11:00.652554
23185,17,97,27,111,106,358,2022-03-20 22:11:01.76558
23187,17,107,28,110,117,379,2022-03-20 22:11:02.869813
23189,35,652,39,117,293,1136,2022-03-20 22:11:04.514737
23201,1330,13770,1029,1206,8858,26193,2022-03-20 22:11:07.047824
23209,6432,38321,4369,7591,43999,100712,2022-03-20 22:11:07.31514
23225,1239,49026,516,357,15519,66657,2022-03-20 22:11:07.818777
23251,10525,94501,7215,8497,47802,168540,2022-03-20 22:11:12.382391
23259,2578,10802,2209,4747,7246,27582,2022-03-20 22:11:12.582226
23265,25,474,9,61,121,690,2022-03-20 22:11:15.519806
23269,3206,44334,2142,1543,21757,72982,2022-03-20 22:11:17.765002
23273,98761,1364140,50593,45992,322091,1881577,2022-03-20 22:11:18.294083
23275,0,0,0,0,2245,2245,2022-03-20 22:11:22.517922
23277,32685,340964,15952,17449,161652,568702,2022-03-20 22:11:23.430595
23279,1557,13710,538,348,25542,41695,2022-03-20 22:11:27.550636
23281,20775,404447,12423,13704,133611,584960,2022-03-20 22:11:27.727432
23283,44356,654918,23080,19636,258896,1000886,2022-03-20 22:11:28.154668
23285,94,8178,46,48,1180,9546,2022-03-20 22:11:28.677214
23289,42117,567402,23069,20561,169966,823115,2022-03-20 22:11:29.197095
23319,1745,24619,1055,364,10443,38226,2022-03-20 22:11:32.62406
23349,20,365,17,89,97,588,2022-03-20 22:11:37.634625
23351,41,150,41,105,416,753,2022-03-20 22:11:39.158606
23359,350,9028,368,351,6158,16255,2022-03-20 22:11:44.302621
23361,351,9179,357,229,5482,15598,2022-03-20 22:11:46.814379
23363,259,4330,240,239,3111,8179,2022-03-20 22:11:49.954169
23365,14,1080,9,37,161,1301,2022-03-20 22:11:51.633017
23367,72,1310,48,62,657,2149,2022-03-20 22:11:51.823164
23383,804,48356,367,176,9566,59269,2022-03-20 22:11:58.962541
23385,2038,83989,939,351,27615,114932,2022-03-20 22:11:59.728423
23387,66,740,33,74,577,1490,2022-03-20 22:12:00.168327
23393,16,275,14,92,114,511,2022-03-20 22:12:01.192569
23399,513,13960,308,200,8135,23116,2022-03-20 22:12:01.36478
23405,456,5834,351,214,5518,12373,2022-03-20 22:12:08.184178
23409,50,355,27,132,457,1021,2022-03-20 22:12:11.2107
23421,8573,97982,6287,5947,37386,156175,2022-03-20 22:12:12.67365
23423,2855,9549,1170,1154,8669,23397,2022-03-20 22:12:12.932306
23425,240,3684,253,155,4923,9255,2022-03-20 22:12:15.861687
23433,586,8332,305,516,3613,13352,2022-03-20 22:12:21.175429
23441,650,48737,231,311,8300,58229,2022-03-20 22:12:23.693445
23447,760,33518,386,202,9446,44312,2022-03-20 22:12:26.356213
23483,22,1679,6,25,209,1941,2022-03-20 22:12:29.153222
23511,38,127,16,80,183,444,2022-03-20 22:12:33.409301
23515,14,179,7,50,120,370,2022-03-20 22:12:34.602418
23523,26,76,8,65,220,395,2022-03-20 22:12:37.227843
23537,6,63,5,65,87,226,2022-03-20 22:12:38.991931
23539,2627,1,1102,1023,5937,10690,2022-03-20 22:12:39.52721
23555,38,102,34,90,295,559,2022-03-20 22:12:43.189416
23575,13,101,6,51,90,261,2022-03-20 22:12:46.070693
23579,1394,6435,814,910,3364,12917,2022-03-20 22:12:49.01205
23581,31,346,19,56,398,850,2022-03-20 22:12:49.444505
23583,41,445,16,75,442,1019,2022-03-20 22:12:50.952324
23585,16,183,8,54,155,416,2022-03-20 22:12:51.132469
23587,4819,33554,2905,3006,25455,69739,2022-03-20 22:12:52.092127
23595,28,337,33,63,464,925,2022-03-20 22:12:54.270432
23607,13,90,10,66,137,316,2022-03-20 22:12:58.723392
23609,11,100,5,54,83,253,2022-03-20 22:12:59.98012
23613,15,78,3,65,82,243,2022-03-20 22:13:02.23392
23615,20,179,15,49,278,541,2022-03-20 22:13:04.095751
23617,12,110,7,66,93,288,2022-03-20 22:13:05.139394
23619,697,24605,320,168,6802,32592,2022-03-20 22:13:07.453856
23621,27,162,10,38,262,499,2022-03-20 22:13:08.867071
23627,161,2148,113,173,2371,4966,2022-03-20 22:13:13.362527
23633,10,65,11,74,87,247,2022-03-20 22:13:14.597105
23635,10,59,10,78,68,225,2022-03-20 22:13:15.733298
23637,9,72,10,77,89,257,2022-03-20 22:13:17.002407
23641,10,56,8,86,81,241,2022-03-20 22:13:19.35115
23643,12,131,5,54,91,293,2022-03-20 22:13:21.004552
23645,8,61,4,43,66,182,2022-03-20 22:13:22.70918
23647,11,295,9,67,135,517,2022-03-20 22:13:22.909186
23651,12,110,17,79,76,294,2022-03-20 22:13:24.433169
23659,19,156,17,62,243,497,2022-03-20 22:13:25.540099
23661,23,185,9,46,187,450,2022-03-20 22:13:26.728347
23673,16628,304144,7762,15141,71173,414848,2022-03-20 22:13:27.163457
23679,66,1141,73,74,905,2259,2022-03-20 22:13:28.87217
23697,310,7530,229,219,3184,11472,2022-03-20 22:13:29.131303
23711,19,354,9,49,188,619,2022-03-20 22:13:32.64953
23713,10,35,4,41,49,139,2022-03-20 22:13:32.863961
23723,21,70,7,45,195,338,2022-03-20 22:13:37.193303
23725,1065,12832,507,276,8273,22953,2022-03-20 22:13:37.417384
23729,7,27,3,40,44,121,2022-03-20 22:13:42.117249
23731,9,47,4,58,67,185,2022-03-20 22:13:43.122692
23735,340,4556,186,177,2168,7427,2022-03-20 22:13:45.125313
23737,77,87,72,121,196,553,2022-03-20 22:13:47.589154
23739,12,165,3,41,144,365,2022-03-20 22:13:48.798005
23741,23,224,8,62,184,501,2022-03-20 22:13:50.08409
23753,53,466,31,60,561,1171,2022-03-20 22:13:51.632818
23755,73271,1486149,27153,46925,155543,1789041,2022-03-20 22:13:51.827384
23759,25,624,6,61,123,839,2022-03-20 22:13:52.086452
23763,14,158,4,52,107,335,2022-03-20 22:13:54.765566
23769,17,61,5,45,97,225,2022-03-20 22:13:58.466444
23775,1819,68034,1016,1159,29686,101714,2022-03-20 22:13:58.723368
23779,18,123,11,77,196,425,2022-03-20 22:14:01.002326
23781,417,4124,377,292,2619,7829,2022-03-20 22:14:04.143525
23787,620,5732,499,1152,3111,11114,2022-03-20 22:14:04.322854
23801,9,55,4,54,90,212,2022-03-20 22:14:07.953047
23815,15,117,17,79,138,366,2022-03-20 22:14:08.193238
23819,20,92,7,45,198,362,2022-03-20 22:14:09.544484
23825,21,437,9,38,232,737,2022-03-20 22:14:10.770482
23847,30897,745805,11620,8298,112769,909389,2022-03-20 22:14:18.324098
23855,18,119,12,47,181,377,2022-03-20 22:14:25.701197
23857,23,93,9,66,105,296,2022-03-20 22:14:27.37812
23861,16,111,7,65,170,369,2022-03-20 22:14:28.561125
23863,13,57,5,52,75,202,2022-03-20 22:14:30.017948
23871,63,1137,60,92,1060,2412,2022-03-20 22:14:35.954629
23877,42,1723,14,43,467,2289,2022-03-20 22:14:36.145806
23889,17,86,9,45,191,348,2022-03-20 22:14:39.143078
23895,21,385,8,54,239,707,2022-03-20 22:14:39.395889
23901,32,286,22,101,367,808,2022-03-20 22:14:42.656194
23903,17,648,7,37,234,943,2022-03-20 22:14:42.927823
23911,11,58,10,82,91,252,2022-03-20 22:14:44.561472
23915,36,373,21,79,205,714,2022-03-20 22:14:44.786302
23945,4402,37689,2640,4537,19560,68828,2022-03-20 22:14:45.792718
23983,21,186,4,67,135,413,2022-03-20 22:14:48.382997
23985,398,4732,196,193,3197,8716,2022-03-20 22:14:48.855605
24011,3402,21744,2028,10104,10137,47415,2022-03-20 22:14:49.490976
24049,22,147,12,28,134,343,2022-03-20 22:14:55.312552
24053,13,150,3,21,83,270,2022-03-20 22:14:55.990442
24123,42,1203,33,74,677,2029,2022-03-20 22:14:57.87131
24159,15,100,7,50,189,361,2022-03-20 22:15:00.537624
24169,96,4498,83,118,1524,6319,2022-03-20 22:15:02.7121
24171,536,4270,384,163,2176,7529,2022-03-20 22:15:02.8901
24175,2140,18595,972,868,9856,32431,2022-03-20 22:15:03.411259
24197,16,797,4,21,102,940,2022-03-20 22:15:05.353691
24199,14,763,6,22,88,893,2022-03-20 22:15:07.334769
24201,13,726,4,24,92,859,2022-03-20 22:15:09.560587
24211,4028,72251,2038,4212,18690,101219,2022-03-20 22:15:09.761558
24227,9608,115107,3132,1484,21975,151306,2022-03-20 22:15:10.028051
24231,7417,137092,4421,3688,34113,186731,2022-03-20 22:15:10.305469
24261,570,28267,369,203,9436,38845,2022-03-20 22:15:11.069073
24355,13,112,7,42,66,240,2022-03-20 22:15:14.457473
24363,8,252,5,44,62,371,2022-03-20 22:15:15.667397
24365,490,24394,328,136,4218,29566,2022-03-20 22:15:18.167281
24371,106,2310,71,114,1581,4182,2022-03-20 22:15:18.368688
24373,15,204,10,68,250,547,2022-03-20 22:15:19.746484
24403,55,43,17,134,200,449,2022-03-20 22:15:21.030278
24405,47166,125959,24713,30895,124813,353546,2022-03-20 22:15:21.197609
24415,29950,529620,10591,6356,71171,647688,2022-03-20 22:15:25.063978
24417,54,273,46,106,422,901,2022-03-20 22:15:27.263001
24429,56,5470,28,73,679,6306,2022-03-20 22:15:30.285383
24437,40,370,14,87,225,736,2022-03-20 22:15:30.457366
24439,55755,425900,31360,30992,213164,757171,2022-03-20 22:15:31.516014
24441,23,130,4,55,73,285,2022-03-20 22:15:32.779709
24443,21,267,8,65,200,561,2022-03-20 22:15:34.381251
24447,13,102,3,59,106,283,2022-03-20 22:15:36.504271
24451,474,17284,205,131,4717,22811,2022-03-20 22:15:38.957855
24455,17895,212186,7882,12734,59949,310646,2022-03-20 22:15:41.770012
24459,1092,28319,404,310,10835,40960,2022-03-20 22:15:44.878274
24465,13,61,10,54,70,208,2022-03-20 22:15:46.078692
24469,431,20290,185,144,3187,24237,2022-03-20 22:15:50.066896
24471,839,9636,580,224,4587,15866,2022-03-20 22:15:53.500473
24475,2120,35887,1386,587,8637,48617,2022-03-20 22:15:55.949314
24501,41,29,13,67,159,309,2022-03-20 22:15:57.846575
24527,37,560,21,33,316,967,2022-03-20 22:15:59.404267
24531,2617,18086,963,1131,14285,37082,2022-03-20 22:16:02.077944
24543,1199,41232,534,286,20969,64220,2022-03-20 22:16:04.587136
24549,10,61,5,68,70,214,2022-03-20 22:16:05.974479
24575,20,147,26,125,116,434,2022-03-20 22:16:08.357281
24577,21,166,22,108,123,440,2022-03-20 22:16:08.523336
24591,80,3932,39,101,915,5067,2022-03-20 22:16:08.696476
24603,13,180,4,68,110,375,2022-03-20 22:16:10.323805
24627,2529,65898,1402,822,15717,86368,2022-03-20 22:16:11.090039
24669,16,95,4,72,99,286,2022-03-20 22:16:12.386271
24695,652,31497,306,183,7581,40219,2022-03-20 22:16:15.920625
24699,2554,12144,1619,3123,12622,32062,2022-03-20 22:16:18.326684
24703,22364,605651,8525,11264,58005,705809,2022-03-20 22:16:19.643159
24705,9114,74590,5494,12976,43185,145359,2022-03-20 22:16:19.854148
24727,533,16485,362,259,6112,23751,2022-03-20 22:16:26.131457
24751,607,28119,306,234,7695,36961,2022-03-20 22:16:26.343431
24763,96,1566,64,50,1144,2920,2022-03-20 22:16:28.469148
24773,57,0,11,65,134,267,2022-03-20 22:16:32.221401
24781,2528,24055,1044,636,17324,45587,2022-03-20 22:16:34.359306
24789,40,185,10,38,239,512,2022-03-20 22:16:36.75484
24791,6,65,6,56,62,195,2022-03-20 22:16:38.355373
24803,7,40,4,56,54,161,2022-03-20 22:16:40.184414
24807,15,267,4,41,74,401,2022-03-20 22:16:41.616394
24823,120,4793,41,100,1322,6376,2022-03-20 22:16:44.057816
24855,2818,12714,1893,6042,16862,40329,2022-03-20 22:16:45.471835
24873,8682,91807,4267,9380,28622,142758,2022-03-20 22:16:46.408369
24903,7,239,3,36,44,329,2022-03-20 22:16:50.7373
24913,706,35497,342,186,8369,45100,2022-03-20 22:16:52.12841
24919,692,14891,354,231,8415,24583,2022-03-20 22:16:54.376363
24921,897,15949,452,297,11354,28949,2022-03-20 22:16:56.893649
24927,8,64,6,79,81,238,2022-03-20 22:16:58.751651
24935,99,4800,58,51,1156,6164,2022-03-20 22:17:00.858417
24969,17,95,7,68,97,284,2022-03-20 22:17:02.225558
24975,63,866,59,74,1031,2093,2022-03-20 22:17:06.668304
24977,72,0,27,75,133,307,2022-03-20 22:17:06.905303
24989,31,168,16,73,221,509,2022-03-20 22:17:10.684393
24991,4311,124885,2258,2214,31677,165345,2022-03-20 22:17:13.062146
24995,12,200,2,25,46,285,2022-03-20 22:17:13.235125
24997,2205,88187,829,766,25977,117964,2022-03-20 22:17:15.625541
24999,6,245,4,42,58,355,2022-03-20 22:17:17.031904
25011,936,26320,568,396,10376,38596,2022-03-20 22:17:17.465904
25013,39897,451398,22946,21683,193651,729575,2022-03-20 22:17:17.656782
25015,3101,97880,1399,858,42401,145639,2022-03-20 22:17:20.384002
25033,24,241,11,52,189,517,2022-03-20 22:17:23.363968
25035,18,46,5,48,107,224,2022-03-20 22:17:24.436209
25045,814,21409,599,627,7111,30560,2022-03-20 22:17:26.895203
25049,57,248,32,109,200,646,2022-03-20 22:17:28.224604
25051,6,71,3,46,81,207,2022-03-20 22:17:30.056601
25053,20,133,9,43,171,376,2022-03-20 22:17:31.192899
25057,12,62,2,55,74,205,2022-03-20 22:17:32.831479
25063,17,94,8,69,88,276,2022-03-20 22:17:35.536595
25065,28,366,19,45,348,806,2022-03-20 22:17:36.991398
25069,25,286,13,75,195,594,2022-03-20 22:17:38.328254
25073,14,118,8,54,139,333,2022-03-20 22:17:38.949503
25075,18,101,7,59,144,329,2022-03-20 22:17:40.16654
25077,72,702,56,98,1287,2215,2022-03-20 22:17:41.986341
25079,23,179,7,64,181,454,2022-03-20 22:17:43.210346
25083,17,199,8,60,202,486,2022-03-20 22:17:45.833563
25087,36,440,23,66,332,897,2022-03-20 22:17:47.861909
25089,14,150,7,71,144,386,2022-03-20 22:17:49.138363
25091,10,57,4,54,61,186,2022-03-20 22:17:49.312981
25103,8,157,4,34,38,241,2022-03-20 22:17:52.533993
25113,53,974,23,42,466,1558,2022-03-20 22:17:53.992405
25183,36767,306337,20085,23663,121043,507895,2022-03-20 22:18:03.314924
25193,6,47,5,50,52,160,2022-03-20 22:18:05.287452
25241,1593,38770,1024,1624,7905,50916,2022-03-20 22:18:09.127283
25253,48,117,27,43,458,693,2022-03-20 22:18:10.563939
25257,188,1893,129,135,3496,5841,2022-03-20 22:18:10.754178
25265,53,689,26,47,673,1488,2022-03-20 22:18:15.30357
25267,50,535,28,52,394,1059,2022-03-20 22:18:16.788099
25271,54,2329,19,31,593,3026,2022-03-20 22:18:18.841812
25285,1302,25465,614,406,6982,34769,2022-03-20 22:18:24.702028
25291,24,832,14,59,487,1416,2022-03-20 22:18:26.37886
25299,9,56,3,57,76,201,2022-03-20 22:18:28.477811
25301,16,51,5,50,145,267,2022-03-20 22:18:30.276457
25303,1514,97375,701,397,16939,116926,2022-03-20 22:18:30.902494
25305,13,99,5,48,176,341,2022-03-20 22:18:32.767252
25313,844,23547,420,325,10585,35721,2022-03-20 22:18:32.95013
25329,11,53,4,60,90,218,2022-03-20 22:18:35.244649
25341,863,9990,890,286,3428,15457,2022-03-20 22:18:35.411191
25365,78,4620,84,110,1296,6188,2022-03-20 22:18:36.365309
25383,52,3104,68,91,557,3872,2022-03-20 22:18:36.906047
25441,86,676,71,85,909,1827,2022-03-20 22:18:38.229086
25517,8017,63796,5863,5588,27061,110325,2022-03-20 22:18:39.381133
25547,11,97,5,42,63,218,2022-03-20 22:18:41.688684
25549,15,922,5,36,168,1146,2022-03-20 22:18:43.442143
25567,412,22774,249,416,5806,29657,2022-03-20 22:18:43.620133
25597,9,74,5,56,97,241,2022-03-20 22:18:45.189296
25599,9,99,6,44,74,232,2022-03-20 22:18:48.489717
25601,14,57,3,58,94,226,2022-03-20 22:18:50.314162
25605,9,49,4,48,63,173,2022-03-20 22:18:50.484881
25609,7,83,7,66,74,237,2022-03-20 22:18:51.81752
25611,8,83,7,64,55,217,2022-03-20 22:18:54.682881
25615,9,79,6,61,57,212,2022-03-20 22:18:56.338448
25617,8,61,4,48,49,170,2022-03-20 22:18:57.432857
25619,7,62,5,56,52,182,2022-03-20 22:18:58.480165
25633,6,39,4,41,65,155,2022-03-20 22:19:03.69211
25635,209,2005,215,134,2302,4865,2022-03-20 22:19:03.910117
25639,11,274,3,25,67,380,2022-03-20 22:19:04.172765
25641,29,1104,14,31,283,1461,2022-03-20 22:19:04.432603
25687,2048,79921,809,752,22997,106527,2022-03-20 22:19:06.102985
25781,9670,361725,2975,1188,57633,433191,2022-03-20 22:19:07.902538
25835,29692,144787,21700,14732,191836,402747,2022-03-20 22:19:14.139458
25839,2928,34851,1574,3174,11843,54370,2022-03-20 22:19:15.613059
25857,79,1058,44,92,868,2141,2022-03-20 22:19:15.783647
25859,4009,26405,2901,7303,16142,56760,2022-03-20 22:19:19.191799
25861,208,12099,103,76,2103,14589,2022-03-20 22:19:22.391866
25867,5988,28639,4825,9549,34841,83842,2022-03-20 22:19:25.61234
25875,279,3216,180,302,1726,5703,2022-03-20 22:19:32.120614
25879,8768,154813,4167,3667,52367,223782,2022-03-20 22:19:32.594896
25883,77,3790,28,34,709,4638,2022-03-20 22:19:32.771993
25889,26,375,12,52,255,720,2022-03-20 22:19:33.021059
25907,911,15090,407,354,13161,29923,2022-03-20 22:19:33.886898
25963,7,299,7,60,92,465,2022-03-20 22:19:36.20384
25969,17,214,6,27,104,368,2022-03-20 22:19:40.075004
25971,12,298,8,41,138,497,2022-03-20 22:19:41.916242
25973,23,317,2,39,77,458,2022-03-20 22:19:42.098987
25975,8,348,3,40,54,453,2022-03-20 22:19:43.196425
25979,10,146,3,38,60,257,2022-03-20 22:19:45.289701
25983,19,87,6,33,161,306,2022-03-20 22:19:46.746873
25991,75,1567,24,57,707,2430,2022-03-20 22:19:51.249394
25999,159,1287,96,145,1332,3019,2022-03-20 22:19:53.234389
26007,9,161,2,39,52,263,2022-03-20 22:19:55.192418
26009,7,114,3,33,52,209,2022-03-20 22:19:56.230157
26013,9,254,6,57,54,380,2022-03-20 22:19:58.554041
26017,8,266,7,58,60,399,2022-03-20 22:20:01.525769
26023,1197,38473,471,285,12079,52505,2022-03-20 22:20:05.571958
26033,11,55,5,49,118,238,2022-03-20 22:20:06.890342
26035,24,238,10,46,257,575,2022-03-20 22:20:08.351901
26043,13,62,6,57,199,337,2022-03-20 22:20:09.604524
26053,61,964,49,68,767,1909,2022-03-20 22:20:11.409419
26055,27584,786730,6797,4115,70776,896002,2022-03-20 22:20:11.66375
26057,785,25288,416,280,10362,37131,2022-03-20 22:20:12.097641
26063,96,1117,50,62,870,2195,2022-03-20 22:20:14.207294
26079,23,308,10,54,200,595,2022-03-20 22:20:15.593571
26085,1932,22705,886,2789,10505,38817,2022-03-20 22:20:15.785797
26091,9,32,3,40,57,141,2022-03-20 22:20:21.942733
26093,11,36,3,50,61,161,2022-03-20 22:20:23.141296
26099,14,40,3,46,73,176,2022-03-20 22:20:26.379212
26101,8,60,3,59,109,239,2022-03-20 22:20:27.411616
26103,10,30,3,46,65,154,2022-03-20 22:20:28.47937
26105,8,35,2,49,54,148,2022-03-20 22:20:29.510071
26113,12,57,3,54,43,169,2022-03-20 22:20:34.269055
26115,13,47,5,45,78,188,2022-03-20 22:20:34.488729
26117,17,175,9,65,179,445,2022-03-20 22:20:36.339509
26123,22550,16493,7691,1653,23017,71404,2022-03-20 22:20:39.922321
26133,11,42,2,39,62,156,2022-03-20 22:20:41.102442
26141,8,44,8,43,104,207,2022-03-20 22:20:46.114942
26145,7,34,2,50,47,140,2022-03-20 22:20:48.50532
26147,7,42,4,48,52,153,2022-03-20 22:20:49.701075
26149,9,48,2,50,41,150,2022-03-20 22:20:50.742677
26155,8,37,3,44,50,142,2022-03-20 22:20:54.095702
26163,14,82,10,74,94,274,2022-03-20 22:20:57.83384
26165,5533,35446,4307,8250,39436,92972,2022-03-20 22:21:00.427395
26183,609,5883,280,185,5525,12482,2022-03-20 22:21:02.841158
26189,58,751,28,64,485,1386,2022-03-20 22:21:04.463476
26197,10,56,5,50,124,245,2022-03-20 22:21:06.122915
26213,1700,65937,771,1012,16726,86146,2022-03-20 22:21:12.357495
26233,6,32,4,41,47,130,2022-03-20 22:21:25.076893
26237,14,48,9,53,98,222,2022-03-20 22:21:27.179414
26241,8,50,5,38,56,157,2022-03-20 22:21:29.403266
26243,51136,818554,22477,29600,215618,1137385,2022-03-20 22:21:29.65482
26247,7,47,2,35,55,146,2022-03-20 22:21:31.356711
26253,7,37,3,40,38,125,2022-03-20 22:21:37.35192
26257,10,31,3,49,86,179,2022-03-20 22:21:39.655539
26259,6,33,5,44,58,146,2022-03-20 22:21:39.8504
26265,10,58,9,47,91,215,2022-03-20 22:21:42.568735
26283,19,97,8,52,163,339,2022-03-20 22:21:48.545645
26285,13,103,5,43,95,259,2022-03-20 22:21:50.243449
26287,11,32,2,50,57,152,2022-03-20 22:21:51.377989
26295,8,34,3,47,60,152,2022-03-20 22:21:55.4056
26297,10,33,1,45,55,144,2022-03-20 22:21:56.413761
26301,10,77,7,34,102,230,2022-03-20 22:21:57.57393
26305,10,44,3,47,50,154,2022-03-20 22:21:59.346409
26309,11,38,3,43,68,163,2022-03-20 22:22:00.598749
26323,11,40,3,41,48,143,2022-03-20 22:22:02.596777
26325,6,30,4,44,42,126,2022-03-20 22:22:02.794571
26341,8,50,4,48,51,161,2022-03-20 22:22:04.905451
26349,11478,220767,5365,6921,69655,314186,2022-03-20 22:22:06.365002
26453,513,1384,447,1200,1072,4616,2022-03-20 22:22:07.66223
27387,1470,27315,419,349,20574,50127,2022-03-20 22:22:11.094134
27393,16,76,6,51,109,258,2022-03-20 22:22:12.587303
27399,19,88,6,63,155,331,2022-03-20 22:22:13.946989
27405,19,318,10,46,117,510,2022-03-20 22:22:15.153684
27411,1023,21397,509,279,20137,43345,2022-03-20 22:22:15.326799
27453,10,142,9,49,55,265,2022-03-20 22:22:19.011789
27455,13,209,9,66,67,364,2022-03-20 22:22:20.100422
27457,14,200,10,80,69,373,2022-03-20 22:22:20.279337
27463,12,138,6,56,63,275,2022-03-20 22:22:22.142341
27465,8,173,7,56,61,305,2022-03-20 22:22:23.310201
27491,13,133,6,65,111,328,2022-03-20 22:22:26.019002
27493,12,84,6,59,73,234,2022-03-20 22:22:27.320747
27495,14,158,8,60,104,344,2022-03-20 22:22:28.542301
27501,12,115,4,59,76,266,2022-03-20 22:22:30.734976
27503,706,4715,508,2011,2882,10822,2022-03-20 22:22:31.200505
27521,36,92,16,99,125,368,2022-03-20 22:22:32.611534
27539,32,1014,21,56,352,1475,2022-03-20 22:22:37.82971
27557,20,103,8,58,178,367,2022-03-20 22:22:40.967455
27559,21,106,14,39,243,423,2022-03-20 22:22:42.283188
27567,61,1491,47,42,914,2555,2022-03-20 22:22:43.709401
27569,16,161,7,63,83,330,2022-03-20 22:22:45.006821
27573,14,811,6,55,139,1025,2022-03-20 22:22:45.642964
27589,13,212,12,79,139,455,2022-03-20 22:22:48.499008
27601,1865,90054,957,496,22464,115836,2022-03-20 22:22:51.296367
27613,448,4609,396,324,3241,9018,2022-03-20 22:22:53.968193
27619,652,5630,343,282,4930,11837,2022-03-20 22:22:56.672801
27621,37,241,33,81,391,783,2022-03-20 22:22:57.97593
27629,472,3869,363,619,3094,8417,2022-03-20 22:22:58.158044
27631,36736,284540,18015,35034,121423,495748,2022-03-20 22:23:02.592961
27633,3782,98841,1943,943,19296,124805,2022-03-20 22:23:05.125097
27651,30,201,27,56,383,697,2022-03-20 22:23:06.903992
27653,55,2821,31,89,590,3586,2022-03-20 22:23:09.424065
27655,9694,228867,5464,9661,35181,288867,2022-03-20 22:23:09.875082
27663,4606,64574,2280,1418,11071,83949,2022-03-20 22:23:10.319748
27683,11,96,6,68,82,263,2022-03-20 22:23:15.088993
27709,103,1877,66,68,1345,3459,2022-03-20 22:23:19.908901
27723,18,110,10,58,138,334,2022-03-20 22:23:22.657958
27727,5593,35780,4607,10075,21094,77149,2022-03-20 22:23:22.858752
27737,365,1346,204,432,1230,3577,2022-03-20 22:23:25.710805
27741,315,2590,272,453,2580,6210,2022-03-20 22:23:27.762814
27757,29,302,24,134,183,672,2022-03-20 22:23:29.199767
27775,40650,500930,24641,27087,220774,814082,2022-03-20 22:23:29.539118
27785,68,848,70,210,608,1804,2022-03-20 22:23:30.141585
27815,962,8795,554,1067,2690,14068,2022-03-20 22:23:37.185745
28353,8,50,3,31,52,144,2022-03-20 22:26:05.049436
27821,4088,245998,1305,800,32750,284941,2022-03-20 22:23:38.217198
27825,138,2818,58,97,1518,4629,2022-03-20 22:23:38.381883
27829,12170,65446,7105,13813,43192,141726,2022-03-20 22:23:38.649554
27857,629,10826,401,471,2990,15317,2022-03-20 22:23:46.982623
27891,1718,90674,719,966,14140,108217,2022-03-20 22:23:50.085924
27899,47766,1363503,17424,37442,85451,1551586,2022-03-20 22:23:53.09369
27907,114,2841,53,100,1162,4270,2022-03-20 22:23:56.613514
27915,20,147,8,70,167,412,2022-03-20 22:23:58.504695
27921,8,40,4,45,60,157,2022-03-20 22:24:00.933732
27927,827,6711,408,1412,5330,14688,2022-03-20 22:24:01.107265
27939,206,7223,107,140,2285,9961,2022-03-20 22:24:01.375056
27943,88,126,36,97,772,1119,2022-03-20 22:24:03.464959
27947,5369,22695,3407,1895,27722,61088,2022-03-20 22:24:07.102318
27949,31,253,12,34,299,629,2022-03-20 22:24:07.305241
27951,25,193,15,29,197,459,2022-03-20 22:24:09.880213
27957,1874,74781,979,547,19107,97288,2022-03-20 22:24:10.060714
27963,17,53,8,46,113,237,2022-03-20 22:24:13.569109
27965,13,63,8,54,57,195,2022-03-20 22:24:14.711178
27969,1123,13391,513,403,19979,35409,2022-03-20 22:24:17.386197
27991,17798,193782,9776,8349,69739,299444,2022-03-20 22:24:20.628488
27993,16,151,11,96,142,416,2022-03-20 22:24:21.974179
27997,66,443,32,52,766,1359,2022-03-20 22:24:23.606114
28013,7399,27709,3311,4205,27069,69693,2022-03-20 22:24:25.964805
28017,6,34,2,53,38,133,2022-03-20 22:24:27.174679
28019,10,52,4,65,69,200,2022-03-20 22:24:27.475943
28021,11,58,3,51,87,210,2022-03-20 22:24:28.676412
28023,10,46,2,71,76,205,2022-03-20 22:24:29.687534
28025,8362,272362,3369,1369,89783,375245,2022-03-20 22:24:29.854903
28035,14,303,4,54,94,469,2022-03-20 22:24:31.714244
28047,13,382,8,46,113,562,2022-03-20 22:24:38.326128
28049,22,374,7,55,105,563,2022-03-20 22:24:39.577907
28051,23,543,6,56,114,742,2022-03-20 22:24:40.606228
28053,22,573,20,52,329,996,2022-03-20 22:24:42.096372
28055,10,298,4,47,82,441,2022-03-20 22:24:43.76125
28063,1956,36229,1454,1857,15603,57099,2022-03-20 22:24:47.097732
28069,1234,77665,677,354,17963,97893,2022-03-20 22:24:49.315727
28071,75,208,18,91,379,771,2022-03-20 22:24:50.826087
28073,8,53,3,54,80,198,2022-03-20 22:24:51.875641
28077,50,2468,27,39,457,3041,2022-03-20 22:24:52.306187
28085,42,1444,22,46,674,2228,2022-03-20 22:24:54.222517
28087,16,74,18,63,141,312,2022-03-20 22:24:55.597929
28089,10,69,8,62,77,226,2022-03-20 22:24:56.674864
28091,22,76,9,60,188,355,2022-03-20 22:24:57.972157
28097,13,78,5,45,105,246,2022-03-20 22:24:59.848443
28099,10,69,6,45,75,205,2022-03-20 22:25:00.967363
28103,21,211,15,74,232,553,2022-03-20 22:25:03.602879
28105,860,15040,744,405,7471,24520,2022-03-20 22:25:06.694305
28109,16,46,7,51,137,257,2022-03-20 22:25:07.748196
28111,12,59,5,25,63,164,2022-03-20 22:25:08.858919
28113,8,51,3,52,59,173,2022-03-20 22:25:09.94463
28115,9,64,5,48,93,219,2022-03-20 22:25:11.045721
28119,10,46,6,47,97,206,2022-03-20 22:25:12.360922
28121,47220,1071762,17494,27589,155582,1319647,2022-03-20 22:25:12.79596
28143,26,470,7,59,220,782,2022-03-20 22:25:14.182881
28149,4393,11674,4074,1881,14493,36515,2022-03-20 22:25:15.588123
28171,78906,1111009,33444,37218,186579,1447156,2022-03-20 22:25:20.232659
28179,128,4444,73,68,1358,6071,2022-03-20 22:25:20.719156
28185,14,120,6,48,93,281,2022-03-20 22:25:22.561152
28197,6,226,1,33,42,308,2022-03-20 22:25:23.771677
43249,0,11,2,7,10,30,2022-03-21 11:28:12.049671
28201,16,100,7,52,146,321,2022-03-20 22:25:26.406539
28205,1549,1079,883,546,1671,5728,2022-03-20 22:25:28.559104
28207,132,3168,101,135,1070,4606,2022-03-20 22:25:28.742661
28211,1781,22118,797,766,28678,54140,2022-03-20 22:25:31.920401
28215,1667,18302,907,1389,4862,27127,2022-03-20 22:25:32.106039
28221,4844,32331,2941,5552,29918,75586,2022-03-20 22:25:32.373869
28223,73755,1060278,43154,33469,303489,1514145,2022-03-20 22:25:34.590768
28227,239,3183,136,125,2866,6549,2022-03-20 22:25:37.548441
28235,78,1610,34,73,1344,3139,2022-03-20 22:25:39.948638
28237,14,197,9,48,156,424,2022-03-20 22:25:42.514713
28241,16,730,8,63,154,971,2022-03-20 22:25:44.026242
28245,12,599,5,50,127,793,2022-03-20 22:25:45.43538
28249,25413,183979,17168,19108,95619,341287,2022-03-20 22:25:47.727437
28251,38,833,23,67,642,1603,2022-03-20 22:25:50.069455
28257,47,1144,32,91,774,2088,2022-03-20 22:25:50.246335
28283,1365,9017,943,2218,7656,21199,2022-03-20 22:25:53.897495
28285,2283,102294,745,453,19424,125199,2022-03-20 22:25:54.121063
28293,11,80,6,58,92,247,2022-03-20 22:25:55.793636
28297,52009,322006,34489,34200,139832,582536,2022-03-20 22:25:59.421848
28299,883,37769,405,260,10252,49569,2022-03-20 22:25:59.598901
28305,8,288,4,35,75,410,2022-03-20 22:26:01.557317
28339,23,1898,11,68,289,2289,2022-03-20 22:26:03.468829
28347,13,283,6,31,111,444,2022-03-20 22:26:03.657446
28351,86,5485,25,58,832,6486,2022-03-20 22:26:03.923825
28355,6,207,2,33,40,288,2022-03-20 22:26:05.225898
28377,35,94,19,53,1068,1269,2022-03-20 22:26:06.375343
28405,2765,87435,1207,914,27584,119905,2022-03-20 22:26:10.679808
28419,14,450,7,34,91,596,2022-03-20 22:26:11.158788
28423,8146,34111,6317,9921,24344,82839,2022-03-20 22:26:11.347537
28427,26,94,14,39,183,356,2022-03-20 22:26:13.26827
28447,373,10088,176,243,4032,14912,2022-03-20 22:26:21.438145
28479,534,28260,211,221,4100,33326,2022-03-20 22:26:24.041225
28483,6,36,4,42,46,134,2022-03-20 22:26:25.315789
28487,5,35,2,40,36,118,2022-03-20 22:26:25.85363
28489,14,65,5,51,124,259,2022-03-20 22:26:27.017097
28497,27333,392526,11657,17353,113894,562763,2022-03-20 22:26:29.950421
28531,184,3136,118,158,1290,4886,2022-03-20 22:26:32.884126
28537,2096,9335,1461,4154,11653,28699,2022-03-20 22:26:36.493483
28539,695,10927,317,254,10283,22476,2022-03-20 22:26:36.668576
28543,9,68,2,62,47,188,2022-03-20 22:26:38.415158
28545,9,34,3,55,62,163,2022-03-20 22:26:38.601815
28547,9,39,3,55,58,164,2022-03-20 22:26:39.755343
28553,7,32,2,47,38,126,2022-03-20 22:26:40.39465
28567,7,46,2,62,48,165,2022-03-20 22:26:43.565575
28569,8,38,2,47,44,139,2022-03-20 22:26:45.014309
28571,7,31,3,42,35,118,2022-03-20 22:26:45.950158
28573,7,28,1,45,37,118,2022-03-20 22:26:46.13135
28583,13,71,7,65,78,234,2022-03-20 22:26:53.381047
28585,5,62,5,69,50,191,2022-03-20 22:26:54.715277
28591,19,533,7,43,102,704,2022-03-20 22:26:55.330473
28603,132,2342,129,170,1991,4764,2022-03-20 22:26:58.45433
28607,1720,24335,1050,825,10470,38400,2022-03-20 22:26:58.671069
28615,13,148,6,74,162,403,2022-03-20 22:27:00.142578
28617,12955,105812,8242,18059,66490,211558,2022-03-20 22:27:00.321291
28621,8438,75613,5915,8810,55504,154280,2022-03-20 22:27:00.772352
28653,9,195,6,27,83,320,2022-03-20 22:27:09.794124
28655,13,418,1,28,84,544,2022-03-20 22:27:10.002971
28665,11,279,7,36,96,429,2022-03-20 22:27:13.285246
28669,1514,6446,926,967,4995,14848,2022-03-20 22:27:13.550248
28673,403,1157,213,360,3654,5787,2022-03-20 22:27:15.969101
28675,5270,160884,2065,858,60196,229273,2022-03-20 22:27:16.147328
28677,28698,505426,14325,16149,119963,684561,2022-03-20 22:27:16.664732
28685,17,216,2,37,153,425,2022-03-20 22:27:19.141579
28687,16,645,6,29,80,776,2022-03-20 22:27:21.226695
28689,7,64,12,71,74,228,2022-03-20 22:27:23.33818
28691,15,730,4,42,104,895,2022-03-20 22:27:25.881745
28693,9,49,7,66,97,228,2022-03-20 22:27:27.48327
28695,46,524,9,62,212,853,2022-03-20 22:27:28.953981
28701,19829,628670,6120,4135,89411,748165,2022-03-20 22:27:29.135442
28713,513,13826,209,192,5498,20238,2022-03-20 22:27:29.396521
28715,22,1025,6,22,182,1257,2022-03-20 22:27:29.65412
28733,37,350,36,50,557,1030,2022-03-20 22:27:30.405378
28735,18187,94871,11365,7738,128619,260780,2022-03-20 22:27:34.845609
28749,24,61,12,55,233,385,2022-03-20 22:27:36.591197
28755,6947,362589,1273,1669,32735,405213,2022-03-20 22:27:36.937643
28761,68,7860,32,93,863,8916,2022-03-20 22:27:41.189955
43259,1,10,2,9,8,30,2022-03-21 11:28:15.843599
28771,993,52253,329,308,11585,65468,2022-03-20 22:27:42.059678
28775,31,961,10,44,314,1360,2022-03-20 22:27:44.278614
28789,185,10354,120,172,2693,13524,2022-03-20 22:27:47.537542
28805,7980,253120,2364,830,105467,369761,2022-03-20 22:27:48.394314
28809,42,286,31,65,528,952,2022-03-20 22:27:49.791197
28811,62,458,36,76,750,1382,2022-03-20 22:27:52.4319
28817,5415,42257,3523,6161,25990,83346,2022-03-20 22:28:00.142354
28819,12352,179539,4392,8856,54635,259774,2022-03-20 22:28:00.33595
28825,32414,415088,17727,31472,114148,610849,2022-03-20 22:28:00.781995
28827,7,226,8,45,74,360,2022-03-20 22:28:02.836076
28831,17,513,5,39,229,803,2022-03-20 22:28:05.895112
28835,232,1590,131,307,1580,3840,2022-03-20 22:28:09.406197
28841,246,4409,134,104,4033,8926,2022-03-20 22:28:10.151925
28843,35,1934,9,43,417,2438,2022-03-20 22:28:12.551942
43260,0,7,2,9,9,27,2022-03-21 11:28:16.807109
28851,38551,1617467,5303,2553,237021,1900895,2022-03-20 22:28:12.90996
28853,96,3295,91,125,1437,5044,2022-03-20 22:28:13.090069
28861,526,9243,291,600,2818,13478,2022-03-20 22:28:15.693131
28869,265,3563,157,202,1537,5724,2022-03-20 22:28:15.865553
28881,465,16918,186,203,6269,24041,2022-03-20 22:28:16.387689
28887,19,27,7,61,72,186,2022-03-20 22:28:16.731187
28921,126,255,82,162,379,1004,2022-03-20 22:28:17.89358
28957,3061,59317,1209,644,48374,112605,2022-03-20 22:28:22.455453
28959,12,623,9,24,133,801,2022-03-20 22:28:22.651364
28963,50,508,19,43,583,1203,2022-03-20 22:28:24.317282
28965,10,51,3,48,68,180,2022-03-20 22:28:25.325342
28977,57643,213878,20467,14334,210578,516900,2022-03-20 22:28:25.737643
28979,9306,167469,4226,3766,45088,229855,2022-03-20 22:28:28.802388
28981,963,14101,593,2464,7218,25339,2022-03-20 22:28:31.410253
28983,11,140,4,60,157,372,2022-03-20 22:28:33.056732
43263,0,7,1,8,12,28,2022-03-21 11:28:18.026404
28987,15,262,7,24,83,391,2022-03-20 22:28:33.24474
28989,19,232,6,37,112,406,2022-03-20 22:28:33.514201
28991,17,266,5,31,103,422,2022-03-20 22:28:34.799864
28993,19,597,8,41,231,896,2022-03-20 22:28:37.152581
28999,50856,1054924,21304,27853,215501,1370438,2022-03-20 22:28:37.593715
29003,14,50,4,56,115,239,2022-03-20 22:28:37.783369
29027,2315,90030,724,669,16425,110163,2022-03-20 22:28:38.214529
29089,2398,5554,935,1160,13592,23639,2022-03-20 22:28:39.261639
29129,388,10766,242,231,4231,15858,2022-03-20 22:28:47.702519
29135,16,202,8,39,169,434,2022-03-20 22:28:49.244381
29151,13,85,5,41,94,238,2022-03-20 22:28:51.376547
29163,2923,20516,2091,2789,20499,48818,2022-03-20 22:28:52.484307
29165,432,3500,390,269,2818,7409,2022-03-20 22:28:52.742788
29223,385,7885,268,317,5174,14029,2022-03-20 22:28:56.387843
29233,17,283,10,70,146,526,2022-03-20 22:28:58.310739
29247,11,163,6,35,108,323,2022-03-20 22:29:01.299458
29249,11,121,6,35,95,268,2022-03-20 22:29:02.348054
29267,8,75,3,37,57,180,2022-03-20 22:29:06.142297
29271,10,88,4,43,67,212,2022-03-20 22:29:06.984334
29275,8,62,1,43,61,175,2022-03-20 22:29:09.773163
29291,11,737,4,21,95,868,2022-03-20 22:29:11.725166
29293,10,653,9,37,174,883,2022-03-20 22:29:13.469483
29301,307,6778,148,91,6788,14112,2022-03-20 22:29:13.645329
29311,12,437,6,30,88,573,2022-03-20 22:29:13.909439
29349,6,88,1,30,61,186,2022-03-20 22:29:16.010745
29353,9,215,2,26,43,295,2022-03-20 22:29:17.841176
29355,5,152,3,27,41,228,2022-03-20 22:29:19.410132
29361,34,27,3,67,102,233,2022-03-20 22:29:22.889322
29365,7,32,2,41,57,139,2022-03-20 22:29:23.274949
29391,11,198,4,47,64,324,2022-03-20 22:29:28.127361
29393,9,148,0,35,48,240,2022-03-20 22:29:29.196431
29395,8,196,1,38,52,295,2022-03-20 22:29:29.3694
29403,11,51,5,50,46,163,2022-03-20 22:29:31.32385
29411,12,547,12,81,125,777,2022-03-20 22:29:33.841713
29413,162,3006,110,162,1680,5120,2022-03-20 22:29:34.041699
29473,13,49,2,59,54,177,2022-03-20 22:29:39.801656
29475,9,142,3,43,72,269,2022-03-20 22:29:40.279904
29493,7,88,3,33,44,175,2022-03-20 22:29:44.435572
29497,7,69,6,43,49,174,2022-03-20 22:29:44.809918
29511,387,7108,145,169,4230,12039,2022-03-20 22:29:46.643086
29517,52,846,39,67,805,1809,2022-03-20 22:29:49.653871
29527,15,69,9,66,146,305,2022-03-20 22:29:51.39581
29535,11,128,7,46,90,282,2022-03-20 22:29:53.05292
29537,11,105,7,51,80,254,2022-03-20 22:29:53.281766
29539,12,108,5,47,84,256,2022-03-20 22:29:53.546404
29549,10,66,4,54,63,197,2022-03-20 22:29:54.435
29587,8,221,3,41,53,326,2022-03-20 22:29:56.776791
29589,12054,73484,8177,18715,30812,143242,2022-03-20 22:29:56.994597
29613,10,250,8,63,114,445,2022-03-20 22:30:00.014233
29615,9,850,6,34,103,1002,2022-03-20 22:30:00.215116
29629,14,781,6,36,138,975,2022-03-20 22:30:03.584496
29633,9,343,7,40,97,496,2022-03-20 22:30:04.949398
29635,7,331,6,37,91,472,2022-03-20 22:30:05.989468
29643,561,1,307,278,3602,4749,2022-03-20 22:30:09.916177
29645,9,215,5,40,85,354,2022-03-20 22:30:11.136145
29647,12,204,5,39,58,318,2022-03-20 22:30:12.388493
29649,10,211,6,41,60,328,2022-03-20 22:30:13.549632
29653,7,207,3,40,69,326,2022-03-20 22:30:16.374045
29661,7,315,5,33,70,430,2022-03-20 22:30:21.041305
29665,7,217,7,38,67,336,2022-03-20 22:30:22.076978
29667,14,187,7,47,87,342,2022-03-20 22:30:23.542681
29669,8,147,4,48,63,270,2022-03-20 22:30:24.790031
29671,10,190,2,32,63,297,2022-03-20 22:30:25.839016
29675,11,212,3,36,48,310,2022-03-20 22:30:27.402653
29677,11,295,6,37,139,488,2022-03-20 22:30:29.243602
29679,9,238,2,38,103,390,2022-03-20 22:30:30.463487
29681,9,325,5,37,68,444,2022-03-20 22:30:31.564835
29687,64,316,33,162,575,1150,2022-03-20 22:30:33.01839
29697,75,1187,51,88,837,2238,2022-03-20 22:30:35.156703
29701,7,330,6,37,89,469,2022-03-20 22:30:37.474797
29707,31,1429,14,40,266,1780,2022-03-20 22:30:37.658831
29708,9,60,8,56,81,214,2022-03-20 22:30:40.745207
29709,8,54,6,45,62,175,2022-03-20 22:30:40.922914
29710,6,144,6,33,79,268,2022-03-20 22:30:42.265366
29711,10,83,8,44,63,208,2022-03-20 22:30:43.39315
29712,11,53,8,48,100,220,2022-03-20 22:30:44.531659
29713,7,58,9,50,112,236,2022-03-20 22:30:45.620234
29716,27,199,20,70,310,626,2022-03-20 22:30:48.369072
29719,9,73,6,36,53,177,2022-03-20 22:30:49.975206
29722,82,306,77,191,582,1238,2022-03-20 22:30:52.193032
29729,13,129,8,73,128,351,2022-03-20 22:30:53.736504
29733,8,46,4,48,68,174,2022-03-20 22:30:55.643265
29738,19,81,8,64,103,275,2022-03-20 22:30:55.844804
29746,12,50,3,63,72,200,2022-03-20 22:31:01.52175
29748,12,49,6,58,65,190,2022-03-20 22:31:03.873999
29749,8,89,2,30,71,200,2022-03-20 22:31:04.976382
29750,21,108,9,71,126,335,2022-03-20 22:31:06.217394
29752,14,150,9,66,116,355,2022-03-20 22:31:08.005322
29755,1838,50093,837,662,25698,79128,2022-03-20 22:31:08.437238
29756,67,691,42,65,1077,1942,2022-03-20 22:31:08.59622
29765,25,380,13,28,430,876,2022-03-20 22:31:11.450921
29766,12,467,7,26,87,599,2022-03-20 22:31:13.175991
29767,7,170,5,25,75,282,2022-03-20 22:31:14.256855
29768,10,587,4,32,110,743,2022-03-20 22:31:15.565365
29770,13,510,5,22,114,664,2022-03-20 22:31:16.851658
29771,15,658,6,31,113,823,2022-03-20 22:31:17.028228
29772,23,1224,15,31,287,1580,2022-03-20 22:31:19.025304
29777,26,1375,9,69,264,1743,2022-03-20 22:31:20.973203
29780,14,180,6,33,89,322,2022-03-20 22:31:22.690779
29782,15,256,8,46,141,466,2022-03-20 22:31:23.872307
29785,14445,146414,6485,10943,57276,235563,2022-03-20 22:31:27.010702
29846,26,69,24,83,228,430,2022-03-20 22:31:54.735519
29786,38215,476309,18596,25034,135873,694027,2022-03-20 22:31:27.191857
29791,9,187,5,48,89,338,2022-03-20 22:31:30.812631
29792,6,167,7,41,62,283,2022-03-20 22:31:31.019806
29793,7,203,6,45,73,334,2022-03-20 22:31:32.1647
29797,8,124,4,38,61,235,2022-03-20 22:31:37.544551
29798,6,159,4,39,47,255,2022-03-20 22:31:38.691783
29799,6,162,3,45,54,270,2022-03-20 22:31:40.624297
29801,85,1419,54,88,1399,3045,2022-03-20 22:31:43.707611
29803,58021,996421,25130,33799,195098,1308469,2022-03-20 22:31:44.004616
29812,12,205,6,58,120,401,2022-03-20 22:31:44.167218
29820,22,205,22,66,222,537,2022-03-20 22:31:46.738946
29821,27,213,25,65,252,582,2022-03-20 22:31:46.987485
29825,19,169,3,50,142,383,2022-03-20 22:31:50.072939
29829,326,3772,196,145,4536,8975,2022-03-20 22:31:50.285892
29831,402,3630,214,181,5186,9613,2022-03-20 22:31:51.158586
29844,8,48,5,41,44,146,2022-03-20 22:31:54.524263
29860,14,174,21,51,155,415,2022-03-20 22:31:57.325282
29862,21,193,21,57,185,477,2022-03-20 22:31:59.923114
29865,209,848,346,572,566,2541,2022-03-20 22:32:03.960448
29867,9,157,4,46,47,263,2022-03-20 22:32:05.641185
29868,87,1893,57,91,1131,3259,2022-03-20 22:32:07.859196
29870,8,193,5,39,87,332,2022-03-20 22:32:08.98359
29871,10,438,4,32,93,577,2022-03-20 22:32:09.151589
29876,1860,5015,963,1644,6769,16251,2022-03-20 22:32:11.477406
29886,16,59,4,53,116,248,2022-03-20 22:32:12.63141
29888,7,166,4,30,30,237,2022-03-20 22:32:12.902171
29889,6,86,4,55,57,208,2022-03-20 22:32:13.883777
29893,1001,11865,495,324,10527,24212,2022-03-20 22:32:14.064895
29897,8,234,5,40,72,359,2022-03-20 22:32:17.504199
29898,12,155,5,33,69,274,2022-03-20 22:32:18.504057
29901,12,83,7,65,92,259,2022-03-20 22:32:20.232427
29904,11,410,2,34,146,603,2022-03-20 22:32:22.986171
29905,12,454,4,34,89,593,2022-03-20 22:32:24.420469
29910,75,249,23,88,603,1038,2022-03-20 22:32:30.88669
29917,9,155,2,48,66,280,2022-03-20 22:32:32.0813
29919,7,199,4,53,97,360,2022-03-20 22:32:34.200863
29920,6,167,6,43,83,305,2022-03-20 22:32:35.303083
29921,8,208,3,46,61,326,2022-03-20 22:32:35.722019
29922,6,127,2,34,62,231,2022-03-20 22:32:37.166077
29924,10,57,20,77,64,228,2022-03-20 22:32:40.168572
29925,9,129,2,49,53,242,2022-03-20 22:32:41.217225
29926,8,218,4,40,65,335,2022-03-20 22:32:42.891139
29927,42,927,30,71,809,1879,2022-03-20 22:32:44.656284
29928,6,149,1,45,62,263,2022-03-20 22:32:45.700864
29929,8,129,5,50,68,260,2022-03-20 22:32:46.817218
29932,18,513,10,39,115,695,2022-03-20 22:32:48.609481
29933,8,330,4,18,53,413,2022-03-20 22:32:48.787907
29935,59,200,22,69,426,776,2022-03-20 22:32:50.793122
29936,100,241,37,100,499,977,2022-03-20 22:32:52.044791
29937,30,199,16,69,242,556,2022-03-20 22:32:52.484904
29944,13,815,8,31,107,974,2022-03-20 22:32:56.075306
29946,9,448,6,21,57,541,2022-03-20 22:32:57.920301
29947,6,81,8,84,92,271,2022-03-20 22:32:58.965228
29949,315,12692,51,192,1586,14836,2022-03-20 22:33:04.18358
29952,12,625,5,27,88,757,2022-03-20 22:33:04.403506
29953,18,91,10,44,106,269,2022-03-20 22:33:05.588922
29954,13,463,7,27,93,603,2022-03-20 22:33:06.756206
29955,8,270,4,19,47,348,2022-03-20 22:33:08.115939
29957,8,731,4,28,70,841,2022-03-20 22:33:11.849838
29961,15,206,5,37,114,377,2022-03-20 22:33:14.353781
29963,6,155,1,29,41,232,2022-03-20 22:33:15.466752
29972,7,214,3,21,55,300,2022-03-20 22:33:18.47194
29976,6271,67822,3184,9136,26916,113329,2022-03-20 22:33:19.385362
29987,5,67,6,57,67,202,2022-03-20 22:33:21.611557
29988,9,363,7,38,87,504,2022-03-20 22:33:22.83138
29989,9,334,6,29,72,450,2022-03-20 22:33:24.161613
29998,273,6764,147,146,2796,10126,2022-03-20 22:33:26.52715
29999,22,86,15,46,614,783,2022-03-20 22:33:28.342181
30012,9,218,4,46,60,337,2022-03-20 22:33:32.2184
30013,28,183,5,53,283,552,2022-03-20 22:33:33.703606
30014,7781,40165,4381,5447,32509,90283,2022-03-20 22:33:36.365266
30015,39069,619367,18605,17857,193007,887905,2022-03-20 22:33:36.576614
30016,23819,156638,12706,20549,74216,287928,2022-03-20 22:33:36.745136
30018,8,233,12,50,67,370,2022-03-20 22:33:37.886273
30028,19,130,7,73,169,398,2022-03-20 22:33:40.287335
30029,13,65,4,65,107,254,2022-03-20 22:33:41.432331
30030,195,714,139,241,1183,2472,2022-03-20 22:33:43.265091
30034,13,76,8,56,100,253,2022-03-20 22:33:45.835455
30036,16,93,9,43,114,275,2022-03-20 22:33:46.280029
30039,324,3095,185,336,999,4939,2022-03-20 22:33:47.151222
30042,20,216,14,42,219,511,2022-03-20 22:33:48.436946
30045,14,373,7,53,94,541,2022-03-20 22:33:49.863955
30048,8,49,6,55,62,180,2022-03-20 22:33:52.542417
30050,15,89,6,48,110,268,2022-03-20 22:33:54.40562
30051,10,72,4,51,71,208,2022-03-20 22:33:56.650673
30053,12,476,5,44,176,713,2022-03-20 22:33:59.390653
30054,7,40,1,43,41,132,2022-03-20 22:34:00.684761
30055,6,43,1,35,46,131,2022-03-20 22:34:01.782752
30056,1245,26220,917,732,9235,38349,2022-03-20 22:34:04.694721
30057,7,43,3,42,45,140,2022-03-20 22:34:06.120322
30058,12,251,3,35,93,394,2022-03-20 22:34:07.336223
30059,9,268,5,43,63,388,2022-03-20 22:34:07.763947
30060,12,62,5,54,71,204,2022-03-20 22:34:08.91083
30064,10,103,5,54,101,273,2022-03-20 22:34:10.588832
30065,9,194,3,31,60,297,2022-03-20 22:34:11.665042
30066,26,242,14,36,203,521,2022-03-20 22:34:11.835753
30072,6,121,1,30,54,212,2022-03-20 22:34:13.325798
30073,5,230,2,30,44,311,2022-03-20 22:34:13.525795
30081,6,241,2,31,26,306,2022-03-20 22:34:14.845345
30090,11,197,1,48,69,326,2022-03-20 22:34:16.017456
30097,16,172,3,50,86,327,2022-03-20 22:34:18.888369
30098,14,126,3,42,76,261,2022-03-20 22:34:19.961302
30099,11,111,5,45,86,258,2022-03-20 22:34:21.24227
30100,440,10873,290,270,6216,18089,2022-03-20 22:34:24.232165
30105,6,246,2,39,76,369,2022-03-20 22:34:27.652368
30106,8,139,5,38,59,249,2022-03-20 22:34:28.624286
30117,10,40,4,39,43,136,2022-03-20 22:34:31.952104
30119,62,0,14,107,140,323,2022-03-20 22:34:33.470091
30120,12,47,5,63,67,194,2022-03-20 22:34:35.368888
30122,19,188,8,77,195,487,2022-03-20 22:34:35.947747
30134,14,56,5,51,64,190,2022-03-20 22:34:39.576441
30137,1126,25480,400,784,9336,37126,2022-03-20 22:34:39.77734
30153,17,98,15,73,140,343,2022-03-20 22:34:43.215898
30154,54,0,22,65,89,230,2022-03-20 22:34:44.241058
30155,33,1124,18,45,357,1577,2022-03-20 22:34:46.522469
30156,86,313,57,158,712,1326,2022-03-20 22:34:46.717646
30157,6,185,1,35,38,265,2022-03-20 22:34:46.957498
30163,5,164,4,29,32,234,2022-03-20 22:34:49.227568
30164,7,173,4,27,40,251,2022-03-20 22:34:50.336954
30165,11,250,1,42,47,351,2022-03-20 22:34:50.914305
30169,8,184,1,29,51,273,2022-03-20 22:34:51.838801
30191,1251,40215,725,354,18589,61134,2022-03-20 22:34:52.8083
30202,4,179,4,41,52,280,2022-03-20 22:34:54.229968
30208,8,76,3,38,27,152,2022-03-20 22:34:55.242782
30237,384,5612,175,122,2726,9019,2022-03-20 22:34:57.631006
30250,708,13796,271,177,7044,21996,2022-03-20 22:34:58.781495
30278,44,254,21,42,589,950,2022-03-20 22:35:01.769945
30279,4753,76736,2270,1537,26865,112161,2022-03-20 22:35:02.112551
30289,18,269,10,46,143,486,2022-03-20 22:35:03.759021
30290,303,2459,215,196,5269,8442,2022-03-20 22:35:03.979333
30307,31377,486231,14592,31897,92655,656752,2022-03-20 22:35:08.592955
30309,56,150,29,78,749,1062,2022-03-20 22:35:12.704041
30311,1484,28843,633,427,8735,40122,2022-03-20 22:35:12.902243
30312,9,55,5,47,54,170,2022-03-20 22:35:15.005377
30321,2470,63430,887,552,17895,85234,2022-03-20 22:35:17.996078
30324,35,743,11,49,378,1216,2022-03-20 22:35:19.678523
30326,11,277,6,45,60,399,2022-03-20 22:35:19.858426
30327,10,289,2,37,69,407,2022-03-20 22:35:20.097585
30335,10,244,2,29,58,343,2022-03-20 22:35:22.791
30336,10,269,3,35,58,375,2022-03-20 22:35:23.00475
30360,9,92,0,38,59,198,2022-03-20 22:35:32.065173
30363,14885,266119,6683,9248,47245,344180,2022-03-20 22:35:34.089126
30365,1662,54237,639,433,14754,71725,2022-03-20 22:35:40.066354
30367,16,880,9,49,93,1047,2022-03-20 22:35:41.590509
30376,185,3575,186,145,2861,6952,2022-03-20 22:35:43.748658
30379,528,12983,344,229,8006,22090,2022-03-20 22:35:49.862122
30381,199,4204,90,91,1638,6222,2022-03-20 22:35:52.417493
30382,1789,7331,1101,3323,7847,21391,2022-03-20 22:35:52.59848
30383,7205,53777,5009,11168,36846,114005,2022-03-20 22:35:52.863519
30384,986,12096,684,786,4531,19083,2022-03-20 22:35:53.39387
30395,6,189,1,22,55,273,2022-03-20 22:36:00.800255
30396,7,433,2,37,77,556,2022-03-20 22:36:01.00375
30397,8,238,1,27,56,330,2022-03-20 22:36:01.266741
30407,14,93,9,48,78,242,2022-03-20 22:36:06.536998
30410,22,263,14,79,159,537,2022-03-20 22:36:11.170386
30411,46,47,11,129,222,455,2022-03-20 22:36:12.45925
30412,269,870,138,208,1350,2835,2022-03-20 22:36:14.43081
30413,540,19161,246,214,7234,27395,2022-03-20 22:36:14.609148
30415,1574,53988,821,515,25884,82782,2022-03-20 22:36:14.842196
30417,20,78,12,73,159,342,2022-03-20 22:36:16.325633
30418,11,234,2,26,47,320,2022-03-20 22:36:17.495481
30419,207,3910,117,97,3454,7785,2022-03-20 22:36:17.664429
30425,10,385,4,26,41,466,2022-03-20 22:36:18.236742
30437,1591,25224,692,1544,8015,37066,2022-03-20 22:36:22.306228
30438,25,694,14,59,145,937,2022-03-20 22:36:23.696734
30442,17,150,4,56,95,322,2022-03-20 22:36:24.865075
30443,15,141,4,54,82,296,2022-03-20 22:36:25.918325
30444,14,127,4,52,82,279,2022-03-20 22:36:26.840502
30446,12,275,3,37,95,422,2022-03-20 22:36:29.805249
30447,11,88,4,40,74,217,2022-03-20 22:36:30.829878
30449,24,217,18,64,255,578,2022-03-20 22:36:32.611015
30453,26,290,16,66,322,720,2022-03-20 22:36:35.318292
30455,0,0,0,0,35073,35073,2022-03-20 22:36:35.524289
30457,17,113,18,94,114,356,2022-03-20 22:36:36.784474
30458,2562,184416,1063,884,32129,221054,2022-03-20 22:36:36.959607
30463,138,383,66,135,1154,1876,2022-03-20 22:36:37.227374
30473,62,413,34,63,1061,1633,2022-03-20 22:36:40.32997
30480,11,303,3,31,65,413,2022-03-20 22:36:42.326121
30483,32,169,30,65,439,735,2022-03-20 22:36:46.313356
30484,63396,397186,23732,15352,240507,740173,2022-03-20 22:36:48.600723
30485,7508,47715,3895,8443,53774,121335,2022-03-20 22:36:49.056581
30489,35,303,19,49,297,703,2022-03-20 22:36:50.800888
30499,215,1776,198,148,1511,3848,2022-03-20 22:36:50.980346
30503,46792,1038364,19965,12024,162989,1280134,2022-03-20 22:36:53.93189
30514,1098,26817,563,426,14335,43239,2022-03-20 22:36:58.327431
30519,73,353,44,142,697,1309,2022-03-20 22:36:58.518233
30524,1650,14405,969,3747,10258,31029,2022-03-20 22:37:01.478287
30530,6,55,2,48,58,169,2022-03-20 22:37:03.337571
30531,104,2603,58,163,1664,4592,2022-03-20 22:37:05.477361
30533,221,8530,84,140,1914,10889,2022-03-20 22:37:05.646581
30534,8,220,2,29,57,316,2022-03-20 22:37:07.545891
30537,83,865,69,76,1774,2867,2022-03-20 22:37:09.482095
30544,25149,444595,8973,21437,82614,582768,2022-03-20 22:37:09.921857
30547,342,4707,122,67,3450,8688,2022-03-20 22:37:10.101921
30549,698,6964,317,324,5292,13595,2022-03-20 22:37:10.377407
30576,13,206,2,20,67,308,2022-03-20 22:37:15.722814
30582,11,62,5,64,60,202,2022-03-20 22:37:15.969747
30625,70,940,46,64,878,1998,2022-03-20 22:37:18.910995
30641,613,13344,381,245,8416,22999,2022-03-20 22:37:22.535593
30648,22,339,13,53,241,668,2022-03-20 22:37:27.774864
30651,781,2586,571,1446,1483,6867,2022-03-20 22:37:32.469743
30652,1851,10238,1030,2810,9259,25188,2022-03-20 22:37:35.000761
30654,56987,947410,27839,16434,147041,1195711,2022-03-20 22:37:35.177496
30659,18,520,7,32,131,708,2022-03-20 22:37:37.77007
30663,53,1220,17,58,498,1846,2022-03-20 22:37:41.005489
30664,8,277,6,34,79,404,2022-03-20 22:37:42.375612
30666,9,240,7,30,73,359,2022-03-20 22:37:44.315189
30667,12,239,4,38,78,371,2022-03-20 22:37:44.51462
30668,11,576,6,39,146,778,2022-03-20 22:37:44.785005
30679,705,3845,282,264,5122,10218,2022-03-20 22:37:48.396286
30686,79,2861,75,120,1102,4237,2022-03-20 22:37:48.598344
30694,101999,485767,24878,32485,51471,696600,2022-03-20 22:37:48.868799
30695,312,2247,150,214,7587,10510,2022-03-20 22:37:53.101704
30704,14,122,16,50,142,344,2022-03-20 22:37:55.722338
43265,0,9,1,8,13,31,2022-03-21 11:28:19.156952
30709,8128,99566,2421,1264,30882,142261,2022-03-20 22:37:59.277739
30711,1370,53703,772,450,22128,78423,2022-03-20 22:38:02.263276
30714,2819,55738,1234,947,20366,81104,2022-03-20 22:38:02.590176
30721,2908,20309,1398,3233,18685,46533,2022-03-20 22:38:03.035454
30732,13,146,10,71,147,387,2022-03-20 22:38:06.802407
30736,21770,97489,8764,9035,78300,215358,2022-03-20 22:38:06.996805
30738,14,231,13,68,296,622,2022-03-20 22:38:09.016806
30739,234,3246,116,131,2092,5819,2022-03-20 22:38:13.459567
30740,5417,39394,4041,7810,21342,78004,2022-03-20 22:38:13.910648
30743,23,229,4,51,245,552,2022-03-20 22:38:17.003665
30745,1384,37514,560,454,14779,54691,2022-03-20 22:38:19.4741
30746,590,7481,317,991,3053,12432,2022-03-20 22:38:22.372867
30749,20018,233664,7185,14559,69289,344715,2022-03-20 22:38:22.539923
30751,72,969,27,104,473,1645,2022-03-20 22:38:24.949717
30752,13,84,7,80,91,275,2022-03-20 22:38:25.212997
43277,1,6,1,10,9,27,2022-03-21 11:28:22.699904
30754,13,95,5,54,87,254,2022-03-20 22:38:28.529536
30757,2910,5464,1507,2684,10178,22743,2022-03-20 22:38:32.514244
30761,7,63,0,32,40,142,2022-03-20 22:38:35.912509
30763,10,126,5,48,85,274,2022-03-20 22:38:37.410474
30764,6,61,3,34,37,141,2022-03-20 22:38:38.463822
30766,20,432,2,36,116,606,2022-03-20 22:38:39.263775
30778,2642,121398,1026,635,37564,163265,2022-03-20 22:38:39.966844
30813,1093,11234,324,327,6831,19809,2022-03-20 22:38:41.233482
30825,184,10260,133,79,2099,12755,2022-03-20 22:38:51.819215
30826,473,1277,518,853,1749,4870,2022-03-20 22:38:52.305614
30829,233,5486,157,202,3080,9158,2022-03-20 22:38:52.748414
30831,72576,1336704,26829,28697,187743,1652549,2022-03-20 22:38:53.175365
30839,8,78,6,51,96,239,2022-03-20 22:38:54.766282
30840,26,369,29,70,375,869,2022-03-20 22:38:56.245255
30842,62,985,21,38,470,1576,2022-03-20 22:38:58.430385
30845,93,1676,58,110,1162,3099,2022-03-20 22:38:58.615528
30850,115,963,67,100,1567,2812,2022-03-20 22:39:00.900188
30851,37,257,20,109,243,666,2022-03-20 22:39:02.561907
30859,11,651,5,29,108,804,2022-03-20 22:39:02.739039
30860,16,1058,9,33,103,1219,2022-03-20 22:39:05.215631
30861,6,69,2,35,37,149,2022-03-20 22:39:06.963434
30862,44,1110,11,32,549,1746,2022-03-20 22:39:09.197261
30863,13,452,5,39,77,586,2022-03-20 22:39:10.422422
30865,20,483,8,42,153,706,2022-03-20 22:39:11.293312
30868,1103,23616,519,815,15964,42017,2022-03-20 22:39:14.389827
30869,610,8886,459,514,14110,24579,2022-03-20 22:39:15.327904
30875,12,72,3,86,76,249,2022-03-20 22:39:21.5429
30885,6268,186951,2639,712,36286,232856,2022-03-20 22:39:23.882928
30886,17,476,8,36,180,717,2022-03-20 22:39:24.07457
30892,15,98,12,91,109,325,2022-03-20 22:39:27.407855
30893,19,105,7,83,128,342,2022-03-20 22:39:27.582931
30896,141,3058,107,102,2181,5589,2022-03-20 22:39:30.512928
30905,15,90,0,42,79,226,2022-03-20 22:39:37.236379
30906,9,46,4,38,39,136,2022-03-20 22:39:38.342949
30907,26,1646,4,29,202,1907,2022-03-20 22:39:38.513635
30909,12,645,0,30,87,774,2022-03-20 22:39:38.772547
30911,23128,167435,10781,16261,81426,299031,2022-03-20 22:39:39.040672
30919,217,6129,128,91,2839,9404,2022-03-20 22:39:40.326131
30925,477,17339,283,222,5648,23969,2022-03-20 22:39:41.348594
30933,7,30,2,54,41,134,2022-03-20 22:39:44.792181
30935,6,39,2,41,41,129,2022-03-20 22:39:46.947179
30938,7,28,1,40,48,124,2022-03-20 22:39:47.209362
30939,10,103,6,41,138,298,2022-03-20 22:39:48.407151
30940,7,26,2,48,42,125,2022-03-20 22:39:48.595229
30948,1842,14199,1154,4179,11053,32427,2022-03-20 22:39:49.908324
30960,16,83,4,47,128,278,2022-03-20 22:39:54.887576
30965,23,114,7,70,174,388,2022-03-20 22:39:57.650914
30967,32,738,18,39,381,1208,2022-03-20 22:39:57.858308
30969,7,56,1,55,39,158,2022-03-20 22:40:00.288104
30970,11,41,4,50,104,210,2022-03-20 22:40:01.457431
30977,7,32,1,53,38,131,2022-03-20 22:40:03.69124
30982,9,26,2,46,51,134,2022-03-20 22:40:05.717539
30988,406,4572,278,112,2025,7393,2022-03-20 22:40:06.590622
31000,7,31,3,42,51,134,2022-03-20 22:40:09.238789
31001,6,30,4,44,51,135,2022-03-20 22:40:09.857083
31002,6,26,4,48,51,135,2022-03-20 22:40:11.122856
31003,7,48,2,52,55,164,2022-03-20 22:40:12.213426
31004,6,31,1,48,39,125,2022-03-20 22:40:13.571557
31005,10,39,2,44,59,154,2022-03-20 22:40:15.769459
31008,8,34,2,43,38,125,2022-03-20 22:40:18.419821
31009,6,28,4,44,33,115,2022-03-20 22:40:18.625064
31014,74,1438,22,71,506,2111,2022-03-20 22:40:20.739507
31015,7,26,2,41,39,115,2022-03-20 22:40:21.828002
31016,9,34,1,43,50,137,2022-03-20 22:40:23.459655
31018,148,1355,91,422,1291,3307,2022-03-20 22:40:27.655804
31033,19,118,6,68,108,319,2022-03-20 22:40:31.519502
31035,117,2090,187,153,1824,4371,2022-03-20 22:40:34.092147
31043,62352,1413188,18973,14299,268078,1776890,2022-03-20 22:40:34.373944
31044,360,352,223,336,1510,2781,2022-03-20 22:40:34.544041
31049,1613,16930,1033,2445,3015,25036,2022-03-20 22:40:39.609843
31050,359,8599,192,336,3298,12784,2022-03-20 22:40:42.331246
31051,1931,73810,499,428,12035,88703,2022-03-20 22:40:42.515686
31052,8,104,5,46,89,252,2022-03-20 22:40:43.934298
31054,21,146,10,64,165,406,2022-03-20 22:40:46.004391
31055,63,518,31,96,748,1456,2022-03-20 22:40:48.21237
31056,1029,21835,584,397,9301,33146,2022-03-20 22:40:48.386327
31064,131,1422,88,100,1199,2940,2022-03-20 22:40:52.624161
31068,92,1102,52,153,548,1947,2022-03-20 22:40:54.643969
31070,245,4916,126,98,2252,7637,2022-03-20 22:40:54.907673
31071,27,132,14,80,213,466,2022-03-20 22:40:56.403558
31072,70,810,37,81,1088,2086,2022-03-20 22:40:58.176595
31073,62,714,38,79,1022,1915,2022-03-20 22:40:59.878387
31080,4636,35899,2710,5166,22703,71114,2022-03-20 22:41:03.468273
31091,3246,36984,1276,2666,19746,63918,2022-03-20 22:41:06.674331
31096,1098,19464,801,369,7903,29635,2022-03-20 22:41:09.182057
31102,33,1140,15,48,538,1774,2022-03-20 22:41:11.874163
31105,107,1944,62,98,1013,3224,2022-03-20 22:41:12.085148
31107,20,605,7,37,183,852,2022-03-20 22:41:13.874349
31108,105,2254,79,125,1168,3731,2022-03-20 22:41:14.055813
31109,7597,42191,3586,16051,31345,100770,2022-03-20 22:41:17.410018
31111,35,1039,14,47,570,1705,2022-03-20 22:41:19.220274
31113,109,1513,66,111,1097,2896,2022-03-20 22:41:21.524391
31116,10,144,1,41,50,246,2022-03-20 22:41:23.586109
31121,2123,26771,1200,1308,12176,43578,2022-03-20 22:41:23.804396
31128,308,9056,185,224,3250,13023,2022-03-20 22:41:24.228214
31133,151,2683,121,131,1636,4722,2022-03-20 22:41:25.723819
31143,1542,17373,785,2312,5791,27803,2022-03-20 22:41:26.605798
31163,17229,161380,10013,16445,71785,276852,2022-03-20 22:41:33.460475
31164,33,196,16,82,282,609,2022-03-20 22:41:35.542976
31165,313,3965,215,176,4333,9002,2022-03-20 22:41:38.030038
31166,21,114,9,36,199,379,2022-03-20 22:41:39.912609
31168,120,5719,88,128,1229,7284,2022-03-20 22:41:40.094257
31174,14710,68310,11155,13036,50416,157627,2022-03-20 22:41:45.201908
31178,2369,20349,1089,1262,12766,37835,2022-03-20 22:41:50.604187
31181,19543,262352,8868,4475,130327,425565,2022-03-20 22:41:51.129972
31196,555,6141,227,353,2102,9378,2022-03-20 22:41:51.39347
31201,63,3208,65,98,669,4103,2022-03-20 22:41:54.237011
31202,22,365,17,68,274,746,2022-03-20 22:41:56.314241
31205,18,69,2,59,63,211,2022-03-20 22:41:57.307198
31211,28,192,9,76,146,451,2022-03-20 22:41:58.64452
31223,4985,33917,2026,6052,17160,64140,2022-03-20 22:41:59.291377
31227,589,5176,330,309,3487,9891,2022-03-20 22:42:03.202658
31229,19083,131327,9836,19758,65117,245121,2022-03-20 22:42:03.732929
31231,264,24519,192,175,4311,29461,2022-03-20 22:42:07.102095
31233,442,1717,163,384,2711,5417,2022-03-20 22:42:09.750165
31234,2735,47997,1753,1402,16001,69888,2022-03-20 22:42:12.126681
31236,23,104,16,60,292,495,2022-03-20 22:42:15.563093
31237,14,56,6,82,88,246,2022-03-20 22:42:16.653913
31238,23,247,6,55,177,508,2022-03-20 22:42:16.831324
31239,16,96,7,87,81,287,2022-03-20 22:42:17.100198
31240,121449,1444792,40159,45165,224303,1875868,2022-03-20 22:42:17.624862
31251,18331,120031,9808,8218,42340,198728,2022-03-20 22:42:18.25415
31258,9,372,4,27,81,493,2022-03-20 22:42:19.488698
31266,9,309,6,33,88,445,2022-03-20 22:42:22.380449
31267,6,424,7,40,112,589,2022-03-20 22:42:22.859991
31268,13,274,7,24,113,431,2022-03-20 22:42:25.075875
31269,8,246,4,36,70,364,2022-03-20 22:42:26.228962
31280,464,7736,252,212,8438,17102,2022-03-20 22:42:30.299004
31283,330,11971,130,193,3099,15723,2022-03-20 22:42:30.732011
31289,667,27601,316,248,5076,33908,2022-03-20 22:42:34.994657
31297,2076,154172,1031,768,27489,185536,2022-03-20 22:42:35.169792
31298,340,7883,261,215,3633,12332,2022-03-20 22:42:37.941469
31299,22,161,9,42,129,363,2022-03-20 22:42:39.018389
31300,126,2031,37,45,848,3087,2022-03-20 22:42:40.973734
31302,27,156,11,30,162,386,2022-03-20 22:42:42.427929
31309,19,694,4,27,103,847,2022-03-20 22:42:44.564316
31310,13,604,4,24,111,756,2022-03-20 22:42:46.077793
31317,17,67,4,46,99,233,2022-03-20 22:42:47.640656
31318,7877,48314,5432,18317,22255,102195,2022-03-20 22:42:49.942759
31319,271,2635,118,193,1623,4840,2022-03-20 22:42:52.200444
31324,1055,44740,437,255,8371,54858,2022-03-20 22:42:55.867115
31326,2567,64373,960,619,10745,79264,2022-03-20 22:42:58.143584
31327,5396,80610,1900,755,22167,110828,2022-03-20 22:43:01.533656
31338,20289,227284,6673,18897,52915,326058,2022-03-20 22:43:01.967597
31344,191,3819,158,216,3411,7795,2022-03-20 22:43:05.357097
31361,20,53,4,83,182,342,2022-03-20 22:43:08.411007
43283,0,8,1,7,11,27,2022-03-21 11:28:25.138692
31370,794,6744,508,1123,3425,12594,2022-03-20 22:43:16.68243
31373,23,396,19,72,597,1107,2022-03-20 22:43:18.475513
31374,14021,148147,9535,14072,35005,220780,2022-03-20 22:43:18.664938
31376,18443,114480,11265,13528,81595,239311,2022-03-20 22:43:19.099083
31377,27,362,9,34,247,679,2022-03-20 22:43:20.449651
31378,1848,49563,771,340,20940,73462,2022-03-20 22:43:20.709114
31389,1347,78550,645,251,15503,96296,2022-03-20 22:43:21.464583
43290,0,0,0,0,0,0,2022-03-21 11:28:29.574746
31433,7293,32437,2829,3548,25848,71955,2022-03-20 22:43:26.49355
31436,13,59,3,49,70,194,2022-03-20 22:43:27.560349
31440,439,11972,192,192,3030,15825,2022-03-20 22:43:34.3276
31442,32496,268216,15686,31712,125949,474059,2022-03-20 22:43:37.910482
31445,0,0,0,0,856,856,2022-03-20 22:43:38.339997
31450,8,220,5,23,52,308,2022-03-20 22:43:41.222143
31452,6089,36991,3439,8580,26212,81311,2022-03-20 22:43:41.74315
31454,70,1274,58,75,890,2367,2022-03-20 22:43:43.555032
31456,6455,27935,3317,8306,29003,75016,2022-03-20 22:43:43.729788
31463,32,63,10,37,246,388,2022-03-20 22:43:45.145441
31465,9,71,1,34,41,156,2022-03-20 22:43:48.592789
31467,28,449,17,52,255,801,2022-03-20 22:43:48.795067
31478,80501,697044,36882,33471,255331,1103229,2022-03-20 22:43:53.327107
31483,1345,52150,630,338,14966,69429,2022-03-20 22:43:57.044347
31485,154,2698,76,140,1718,4786,2022-03-20 22:43:57.479326
31486,103,1825,64,97,1817,3906,2022-03-20 22:44:02.067945
31490,3063,135825,768,486,21961,162103,2022-03-20 22:44:02.250798
31491,1974,10635,706,916,6334,20565,2022-03-20 22:44:05.051096
31493,76,412,35,60,617,1200,2022-03-20 22:44:05.227481
31494,30,478,23,65,456,1052,2022-03-20 22:44:07.387602
31498,1883,16788,855,3569,7194,30289,2022-03-20 22:44:10.211588
31499,3846,12454,1451,2806,17870,38427,2022-03-20 22:44:13.458511
31500,5747,48591,2977,4690,34182,96187,2022-03-20 22:44:13.632253
31501,12,638,5,27,57,739,2022-03-20 22:44:15.103844
31506,9,139,0,25,36,209,2022-03-20 22:44:17.857479
31508,6,30,2,43,33,114,2022-03-20 22:44:20.765018
31509,6,43,2,36,39,126,2022-03-20 22:44:20.968596
31510,5,132,0,23,41,201,2022-03-20 22:44:21.172237
31513,6,470,4,28,48,556,2022-03-20 22:44:26.320411
31517,27,204,24,111,323,689,2022-03-20 22:44:27.857203
31519,1750,14751,977,2514,10552,30544,2022-03-20 22:44:30.613392
31521,229,5825,137,84,2339,8614,2022-03-20 22:44:30.793979
31530,179,2209,162,136,3294,5980,2022-03-20 22:44:32.929906
31537,8670,34415,3280,7181,52247,105793,2022-03-20 22:44:34.940146
31540,3063,23663,2039,6538,14207,49510,2022-03-20 22:44:37.673429
31547,22,54,5,50,102,233,2022-03-20 22:44:39.781155
31549,175,760,151,709,578,2373,2022-03-20 22:44:39.96627
31551,25,584,12,30,206,857,2022-03-20 22:44:41.585595
31552,921,30881,587,260,15673,48322,2022-03-20 22:44:43.917949
31553,2134,131048,892,502,24896,159472,2022-03-20 22:44:44.114803
31559,11745,91682,6961,15395,36130,161913,2022-03-20 22:44:45.250658
31560,599,9064,357,374,3537,13931,2022-03-20 22:44:48.953843
31561,281,15940,140,232,2892,19485,2022-03-20 22:44:51.932241
31563,17,130,5,52,167,371,2022-03-20 22:44:54.209038
31564,4018,24641,2134,3163,24305,58261,2022-03-20 22:44:56.673251
31566,82,2083,49,101,949,3264,2022-03-20 22:44:56.865339
31568,16,626,11,48,189,890,2022-03-20 22:44:57.121487
31573,374,1719,282,748,1148,4271,2022-03-20 22:44:57.647135
31580,26523,327900,15395,28595,125539,523952,2022-03-20 22:44:58.83793
31583,10,214,9,30,105,368,2022-03-20 22:45:02.235576
31584,9,207,7,28,92,343,2022-03-20 22:45:04.465587
31585,10,176,7,28,89,310,2022-03-20 22:45:06.047772
31586,34,3527,16,49,251,3877,2022-03-20 22:45:08.989372
31587,12,206,10,34,150,412,2022-03-20 22:45:11.253993
31588,10117,51596,5305,10880,22663,100561,2022-03-20 22:45:11.434117
43377,0,2,2,13,11,28,2022-03-21 11:29:07.846935
31592,4711,94341,2096,2942,10298,114388,2022-03-20 22:45:15.423933
31593,577,4132,353,284,5796,11142,2022-03-20 22:45:19.590677
31598,502,10473,186,343,9135,20639,2022-03-20 22:45:22.384503
31599,25,97,9,67,106,304,2022-03-20 22:45:23.530094
31603,15,124,3,47,85,274,2022-03-20 22:45:24.593674
31608,88,3859,85,80,1106,5218,2022-03-20 22:45:27.454473
31610,2673,16418,1621,1610,10071,32393,2022-03-20 22:45:27.653651
31617,142,917,89,80,3451,4679,2022-03-20 22:45:28.747325
31618,113,993,68,70,619,1863,2022-03-20 22:45:30.508833
31621,2313,30831,946,1587,11137,46814,2022-03-20 22:45:33.15873
31624,10,347,3,40,74,474,2022-03-20 22:45:34.63682
31631,2241,1716,1212,3205,5939,14313,2022-03-20 22:45:41.475888
31634,40,5125,14,67,307,5553,2022-03-20 22:45:44.368107
31636,30779,202523,19140,41890,106417,400749,2022-03-20 22:45:44.894631
31637,19528,393212,7415,7400,57307,484862,2022-03-20 22:45:45.762746
43381,0,7,1,14,15,37,2022-03-21 11:29:10.1532
31641,13,385,4,21,75,498,2022-03-20 22:45:52.02941
31643,9,101,5,28,49,192,2022-03-20 22:45:56.168037
31644,6,268,1,28,43,346,2022-03-20 22:45:57.394884
31645,1023,35146,351,335,13393,50248,2022-03-20 22:46:00.31122
31646,53584,267171,32913,20511,214622,588801,2022-03-20 22:46:00.760395
31647,208,358,101,180,731,1578,2022-03-20 22:46:03.309657
31662,6,130,2,46,48,232,2022-03-20 22:46:10.485019
31665,600,39347,339,144,8449,48879,2022-03-20 22:46:10.683955
31667,95,0,43,98,204,440,2022-03-20 22:46:13.380598
31668,93,2444,83,90,1360,4070,2022-03-20 22:46:13.564163
31669,70,1148,79,86,979,2362,2022-03-20 22:46:15.55233
31670,231,2592,128,201,1397,4549,2022-03-20 22:46:16.081535
31672,9,60,4,69,65,207,2022-03-20 22:46:17.486599
31673,35,842,15,87,105,1084,2022-03-20 22:46:18.549977
31674,13,488,9,47,71,628,2022-03-20 22:46:20.021816
31675,450,9688,356,356,8035,18885,2022-03-20 22:46:20.201835
31678,139,1601,80,85,2175,4080,2022-03-20 22:46:24.007445
31680,6861,93231,2563,7539,18766,128960,2022-03-20 22:46:24.21179
31683,298,17695,156,68,2834,21051,2022-03-20 22:46:27.664547
31685,13,910,5,48,99,1075,2022-03-20 22:46:30.330318
31686,21,1267,4,33,155,1480,2022-03-20 22:46:32.397522
31687,20,1809,10,46,238,2123,2022-03-20 22:46:32.57152
31689,14,887,5,38,87,1031,2022-03-20 22:46:34.403293
31690,14,45,5,44,108,216,2022-03-20 22:46:35.833734
31691,12,88,8,49,67,224,2022-03-20 22:46:38.667416
31692,12,35,4,38,44,133,2022-03-20 22:46:39.822109
31693,9,75,3,60,62,209,2022-03-20 22:46:41.602331
31694,11,65,5,44,39,164,2022-03-20 22:46:42.632362
31695,4,313,2,26,34,379,2022-03-20 22:46:43.052365
31696,12,61,5,55,65,198,2022-03-20 22:46:44.240068
31697,7,37,4,41,44,133,2022-03-20 22:46:45.249155
31699,30,158,18,103,227,536,2022-03-20 22:46:47.935335
31701,10,33,4,53,70,170,2022-03-20 22:46:49.671518
31704,4325,250089,1083,593,30353,286443,2022-03-20 22:46:50.124092
31706,4383,71937,2025,1687,30747,110779,2022-03-20 22:46:50.974449
31715,1995,72584,710,508,17968,93765,2022-03-20 22:46:51.703566
31737,15262,310120,5596,7929,43959,382866,2022-03-20 22:46:52.621545
31754,558,26947,276,219,5979,33979,2022-03-20 22:47:00.669311
31757,7213,290270,2125,919,82019,382546,2022-03-20 22:47:05.375705
31758,8610,283547,2452,1181,96004,391794,2022-03-20 22:47:05.584837
31759,14,537,4,26,75,656,2022-03-20 22:47:06.085839
31760,17,458,1,26,93,595,2022-03-20 22:47:09.055443
31761,17,531,3,28,95,674,2022-03-20 22:47:10.214653
31762,288,2953,111,161,3976,7489,2022-03-20 22:47:12.600443
31763,1505,39990,832,669,22848,65844,2022-03-20 22:47:16.425197
31764,16932,186297,5807,7920,67139,284095,2022-03-20 22:47:16.600029
31793,1278,14020,605,1646,6750,24299,2022-03-20 22:47:29.377467
31765,10535,523696,2583,2388,92308,631510,2022-03-20 22:47:16.859577
31771,6448,35426,4549,6730,33971,87124,2022-03-20 22:47:21.950537
31772,13186,224307,5346,2364,29615,274818,2022-03-20 22:47:22.404552
31780,181,7220,94,112,1896,9503,2022-03-20 22:47:25.112419
31783,6172,43397,2901,1957,15556,69983,2022-03-20 22:47:26.169207
31785,144,1426,86,92,1971,3719,2022-03-20 22:47:26.332669
31790,4340,21630,2966,11770,15713,56419,2022-03-20 22:47:28.92313
31797,1196,12375,537,329,9142,23579,2022-03-20 22:47:32.073821
31798,39558,393855,19393,26290,171792,650888,2022-03-20 22:47:33.036172
31812,3643,106242,1340,746,54576,166547,2022-03-20 22:47:41.140849
31815,642,18073,269,664,6029,25677,2022-03-20 22:47:45.581094
31821,5493,94006,2597,2049,25019,129164,2022-03-20 22:47:45.771342
31827,364,1640,210,235,2735,5184,2022-03-20 22:47:49.107034
31829,52,564,25,62,831,1534,2022-03-20 22:47:49.29357
31830,17,671,5,23,91,807,2022-03-20 22:47:51.213823
31832,7,575,6,31,81,700,2022-03-20 22:47:53.976382
31833,17,370,3,34,128,552,2022-03-20 22:47:55.658593
31834,12,395,5,33,82,527,2022-03-20 22:47:57.476294
31838,650,2604,168,295,2778,6495,2022-03-20 22:47:57.664286
31845,18138,145720,6683,18046,61429,250016,2022-03-20 22:47:57.922836
31846,54,1310,28,49,538,1979,2022-03-20 22:48:00.059535
31851,312,4006,154,144,2978,7594,2022-03-20 22:48:00.938686
31859,36377,413518,15614,23641,148157,637307,2022-03-20 22:48:01.557412
31892,25,35,9,43,220,332,2022-03-20 22:48:08.28655
31893,15,32,7,43,104,201,2022-03-20 22:48:11.149174
31894,67,1100,34,68,768,2037,2022-03-20 22:48:11.325082
31898,16,211,12,78,75,392,2022-03-20 22:48:11.584474
31909,118,6682,71,58,1441,8370,2022-03-20 22:48:12.553324
31926,22,174,8,21,197,422,2022-03-20 22:48:17.924721
31931,7072,41614,2353,1857,33813,86709,2022-03-20 22:48:19.625528
31933,54730,731738,14350,8216,88170,897204,2022-03-20 22:48:19.912558
31941,76,549,40,89,1196,1950,2022-03-20 22:48:21.971968
31942,7,151,1,39,31,229,2022-03-20 22:48:22.161088
31948,14,78,10,91,91,284,2022-03-20 22:48:23.514652
31953,22629,229589,11528,13316,111543,388605,2022-03-20 22:48:28.162843
31964,114705,2236213,24905,29539,155452,2560814,2022-03-20 22:48:28.525881
31965,50,288,26,97,385,846,2022-03-20 22:48:28.69491
31967,178,2171,100,120,1663,4232,2022-03-20 22:48:34.387698
31972,13,325,4,29,96,467,2022-03-20 22:48:36.975575
31973,2808,28850,1187,640,13116,46601,2022-03-20 22:48:37.182551
31977,51,1466,20,38,652,2227,2022-03-20 22:48:37.448004
31978,63,1699,43,87,625,2517,2022-03-20 22:48:37.964995
31988,9975,123166,5542,3264,54778,196725,2022-03-20 22:48:40.829362
31997,164,4593,97,97,2652,7603,2022-03-20 22:48:42.235925
32023,5455,30671,3344,11936,18604,70010,2022-03-20 22:48:49.852591
32026,158,8675,87,126,1996,11042,2022-03-20 22:48:50.343558
32030,86,2143,16,78,702,3025,2022-03-20 22:48:50.518166
32031,57,1948,19,68,476,2568,2022-03-20 22:48:53.063436
32032,8767,44744,4306,8433,34953,101203,2022-03-20 22:48:53.233508
32034,77,725,39,68,837,1746,2022-03-20 22:48:57.182636
32038,1914,13034,1180,1129,10516,27773,2022-03-20 22:48:58.303092
32041,28,406,8,33,189,664,2022-03-20 22:49:01.969877
32051,617,26237,308,238,5610,33010,2022-03-20 22:49:05.1126
32058,60,646,25,51,605,1387,2022-03-20 22:49:07.112894
32059,34,298,18,41,208,599,2022-03-20 22:49:08.492388
32071,1522,67914,470,538,15503,85947,2022-03-20 22:49:10.660354
32073,6,87,2,33,28,156,2022-03-20 22:49:13.173938
32074,9,95,2,37,32,175,2022-03-20 22:49:13.342909
32083,7693,52799,3768,12801,24145,101206,2022-03-20 22:49:16.006344
32084,273,1355,127,217,2533,4505,2022-03-20 22:49:16.452143
32086,1938,66566,626,625,24323,94078,2022-03-20 22:49:16.628379
32087,17,218,12,72,348,667,2022-03-20 22:49:18.855585
32088,20,218,14,72,354,678,2022-03-20 22:49:20.228434
32092,9,176,2,21,39,247,2022-03-20 22:49:20.437571
32093,25717,226690,13146,13252,118763,397568,2022-03-20 22:49:20.917133
32094,6546,47801,2387,4076,26282,87092,2022-03-20 22:49:24.6604
32105,62342,193747,31818,49865,111510,449282,2022-03-20 22:49:24.838895
32107,13,138,8,47,176,382,2022-03-20 22:49:28.33695
32108,1254,60414,553,402,11796,74419,2022-03-20 22:49:31.235502
32136,24,116,7,72,109,328,2022-03-20 22:49:38.615241
32139,20,1266,4,30,147,1467,2022-03-20 22:49:40.378873
32142,13,166,5,67,106,357,2022-03-20 22:49:41.547224
32145,17,102,8,63,120,310,2022-03-20 22:49:42.462275
32149,13,121,9,64,126,333,2022-03-20 22:49:45.682142
32153,512,15666,287,211,8202,24878,2022-03-20 22:49:46.684242
32175,5192,41570,2763,4724,21087,75336,2022-03-20 22:49:47.859696
32212,4357,8528,2331,3128,20370,38714,2022-03-20 22:49:49.090472
32230,34,385,22,83,228,752,2022-03-20 22:49:51.415025
32259,25,203,11,41,216,496,2022-03-20 22:49:56.241119
32262,22524,200371,8860,21799,67125,320679,2022-03-20 22:49:56.693751
32264,42,1132,22,56,391,1643,2022-03-20 22:49:56.866355
32270,10,76,1,51,55,193,2022-03-20 22:49:59.459236
32274,97,1841,67,115,910,3030,2022-03-20 22:50:00.524188
32281,50361,1966336,5991,3239,263596,2289523,2022-03-20 22:50:01.094879
32294,35,3470,11,76,223,3815,2022-03-20 22:50:04.277381
32295,16,537,5,43,114,715,2022-03-20 22:50:04.58962
32296,17,549,3,28,73,670,2022-03-20 22:50:06.482131
32297,21,344,6,23,74,468,2022-03-20 22:50:06.912893
32321,161,2415,91,87,2155,4909,2022-03-20 22:50:12.344
32322,7,139,1,30,26,203,2022-03-20 22:50:13.697492
32324,103,1558,45,95,905,2706,2022-03-20 22:50:14.514186
32338,106,2167,35,80,970,3358,2022-03-20 22:50:14.77267
32344,8,281,3,20,43,355,2022-03-20 22:50:15.217506
32365,1324,82502,424,460,11416,96126,2022-03-20 22:50:16.403647
32380,3861,311621,927,558,27927,344894,2022-03-20 22:50:20.654632
32382,91,925,42,73,1017,2148,2022-03-20 22:50:23.843201
32384,28,977,15,43,250,1313,2022-03-20 22:50:26.636325
32385,30,325,7,28,242,632,2022-03-20 22:50:29.156157
32388,9,104,2,49,53,217,2022-03-20 22:50:30.26459
32400,97,1131,83,200,520,2031,2022-03-20 22:50:32.207044
32402,26,41,12,105,211,395,2022-03-20 22:50:32.473315
32407,10278,68676,4695,17761,43196,144606,2022-03-20 22:50:36.135518
32409,1012,20121,480,356,7770,29739,2022-03-20 22:50:41.530564
32410,491,4265,230,297,5278,10561,2022-03-20 22:50:44.091084
32415,378,5661,140,158,3957,10294,2022-03-20 22:50:47.776755
32418,9,63,4,50,51,177,2022-03-20 22:50:51.118273
32420,7,55,2,48,26,138,2022-03-20 22:50:52.605107
32421,7,210,6,58,50,331,2022-03-20 22:50:53.736216
32422,11,271,3,37,132,454,2022-03-20 22:50:54.890233
32430,8,142,1,26,24,201,2022-03-20 22:50:56.080023
32437,350,4301,209,250,3551,8661,2022-03-20 22:50:56.512333
32438,13174,118148,5699,23319,43633,203973,2022-03-20 22:50:56.947598
32448,19,259,11,76,84,449,2022-03-20 22:50:58.60713
32454,579,6801,297,770,3085,11532,2022-03-20 22:51:01.91909
32455,1249,3913,462,1833,5688,13145,2022-03-20 22:51:04.598054
32461,107,1955,53,50,1743,3908,2022-03-20 22:51:04.798028
32467,120,2541,52,74,1401,4188,2022-03-20 22:51:06.999097
32468,168,5199,100,132,2052,7651,2022-03-20 22:51:07.18751
32472,9,53,2,51,28,143,2022-03-20 22:51:09.002458
32473,10,111,1,30,27,179,2022-03-20 22:51:10.63794
32475,8,59,4,47,34,152,2022-03-20 22:51:11.139861
32476,155,1915,98,129,2548,4845,2022-03-20 22:51:13.515959
32481,97,2825,81,102,1772,4877,2022-03-20 22:51:15.914306
32485,1845,111875,657,430,17810,132617,2022-03-20 22:51:19.425501
32491,4092,64109,1539,1004,42882,113626,2022-03-20 22:51:21.980974
32494,12068,70548,5729,12730,28523,129598,2022-03-20 22:51:24.368695
32502,167,1387,104,98,1665,3421,2022-03-20 22:51:26.331441
32503,76,584,26,55,620,1361,2022-03-20 22:51:28.534965
32511,221,1760,146,140,2477,4744,2022-03-20 22:51:28.708964
32521,31,878,14,49,333,1305,2022-03-20 22:51:32.139123
32526,9868,100874,4852,6288,40862,162744,2022-03-20 22:51:33.095456
32534,132,1094,45,87,1128,2486,2022-03-20 22:51:33.267646
32542,50026,400533,31607,43944,140902,667012,2022-03-20 22:51:33.776639
32543,163,1011,63,78,950,2265,2022-03-20 22:51:34.852304
32547,850,29903,356,183,11162,42454,2022-03-20 22:51:38.485127
32548,169,2234,49,82,1838,4372,2022-03-20 22:51:41.751788
32551,1225,51919,518,446,13046,67154,2022-03-20 22:51:43.462527
32553,1517,69014,861,412,14300,86104,2022-03-20 22:51:43.650179
32561,895,40311,365,289,9331,51191,2022-03-20 22:51:52.745001
32563,46,450,21,64,452,1033,2022-03-20 22:51:54.719731
32564,39,308,3,45,170,565,2022-03-20 22:51:54.901992
32568,44,75,23,98,319,559,2022-03-20 22:52:00.104539
32571,421,636,265,758,625,2705,2022-03-20 22:52:00.31528
32572,335,358,202,323,1428,2646,2022-03-20 22:52:02.551805
32574,670,26376,388,179,9651,37264,2022-03-20 22:52:02.732269
32580,17,92,7,66,98,280,2022-03-20 22:52:04.870657
32582,92,276,33,188,627,1216,2022-03-20 22:52:07.773875
32583,8,160,0,28,36,232,2022-03-20 22:52:07.980562
32590,20,62,4,66,77,229,2022-03-20 22:52:10.978071
32593,14,111,8,59,126,318,2022-03-20 22:52:11.179035
32595,9417,43297,3926,14806,21645,93091,2022-03-20 22:52:13.732368
32596,55,77,44,117,301,594,2022-03-20 22:52:15.172811
32600,33,887,10,35,275,1240,2022-03-20 22:52:18.35999
32601,2027,18364,1384,3066,6465,31306,2022-03-20 22:52:18.579382
32603,6829,109023,2404,2893,26174,147323,2022-03-20 22:52:21.733304
32606,2038,11328,814,2826,11791,28797,2022-03-20 22:52:21.919227
32607,6953,38643,4799,6679,39220,96294,2022-03-20 22:52:22.090793
43384,0,6,0,14,13,33,2022-03-21 11:29:11.472746
32608,7726,19973,4203,17577,17591,67070,2022-03-20 22:52:22.36278
32621,11,65,3,41,64,184,2022-03-20 22:52:25.52027
32622,16,146,8,42,103,315,2022-03-20 22:52:25.727339
32623,8,101,3,41,57,210,2022-03-20 22:52:27.24437
32625,483,7092,297,178,4543,12593,2022-03-20 22:52:29.892038
32626,9,149,4,52,73,287,2022-03-20 22:52:31.630099
32628,13,71,5,46,95,230,2022-03-20 22:52:33.576719
32630,15,81,8,68,79,251,2022-03-20 22:52:36.484372
32633,114,359,74,79,979,1605,2022-03-20 22:52:38.136101
32637,14,322,5,32,66,439,2022-03-20 22:52:38.748525
32639,11,249,1,31,69,361,2022-03-20 22:52:38.981074
32670,120,315,71,159,709,1374,2022-03-20 22:52:42.035108
32691,337,2158,232,367,1248,4342,2022-03-20 22:52:46.46076
32695,46,508,9,30,311,904,2022-03-20 22:52:48.062916
32697,1257,8966,600,2528,5846,19197,2022-03-20 22:52:52.727523
32698,3549,74548,1377,629,17191,97294,2022-03-20 22:52:52.946055
32700,192,5135,105,127,1901,7460,2022-03-20 22:52:53.197613
32707,77,296,44,81,386,884,2022-03-20 22:52:54.816011
32717,2454,5081,1081,1470,6997,17083,2022-03-20 22:52:59.783188
32729,41025,420000,20368,26425,198593,706411,2022-03-20 22:53:01.84095
32730,110,3611,72,99,1519,5411,2022-03-20 22:53:03.973274
32732,7,94,0,35,43,179,2022-03-20 22:53:06.970602
32733,16,128,6,72,109,331,2022-03-20 22:53:09.156072
32734,16,140,6,61,110,333,2022-03-20 22:53:10.187167
32735,174,2768,74,110,2509,5635,2022-03-20 22:53:12.639068
32737,46,648,29,83,480,1286,2022-03-20 22:53:14.589995
32740,804,13132,581,210,6062,20789,2022-03-20 22:53:16.021511
32747,9,344,1,24,46,424,2022-03-20 22:53:17.551448
32748,8,365,4,23,62,462,2022-03-20 22:53:19.407772
32749,7,405,8,21,52,493,2022-03-20 22:53:20.530028
32750,8,358,4,28,69,467,2022-03-20 22:53:21.745203
32764,10,294,5,17,65,391,2022-03-20 22:53:26.067739
32776,8,213,3,20,53,297,2022-03-20 22:53:27.591659
32783,6,185,4,19,41,255,2022-03-20 22:53:28.707354
32790,8,330,3,28,77,446,2022-03-20 22:53:29.698788
32801,2437,123349,721,495,26810,153812,2022-03-20 22:53:30.87018
32812,10,282,4,20,60,376,2022-03-20 22:53:36.675338
32813,10,889,3,40,82,1024,2022-03-20 22:53:38.272421
32816,79,2172,62,82,1024,3419,2022-03-20 22:53:40.405009
32817,81,1914,64,77,1019,3155,2022-03-20 22:53:40.576207
32818,10,125,5,77,46,263,2022-03-20 22:53:41.767989
32820,13,117,6,83,51,270,2022-03-20 22:53:44.04445
32821,8,101,4,75,48,236,2022-03-20 22:53:45.858353
32826,76,1592,36,58,701,2463,2022-03-20 22:53:48.924881
32827,16155,188714,7745,11354,76312,300280,2022-03-20 22:53:51.776057
32828,21814,143561,12879,13259,83218,274731,2022-03-20 22:53:51.960828
32829,1934,9925,1050,1718,5829,20456,2022-03-20 22:53:52.228417
32830,194,363,254,566,1045,2422,2022-03-20 22:53:52.485243
32836,2276,17217,785,714,10660,31652,2022-03-20 22:53:55.289084
32843,2697,13411,586,730,15929,33353,2022-03-20 22:53:56.496313
32847,11,198,1,18,63,291,2022-03-20 22:53:59.490623
32852,8,200,3,20,50,281,2022-03-20 22:54:03.206569
32855,13,240,3,18,60,334,2022-03-20 22:54:07.706444
32856,8,245,2,24,45,324,2022-03-20 22:54:09.518794
32857,7,128,0,14,33,182,2022-03-20 22:54:09.700669
32858,4,221,2,20,38,285,2022-03-20 22:54:10.793339
32861,10,226,0,17,46,299,2022-03-20 22:54:13.001685
32867,34729,510629,14574,7759,112108,679799,2022-03-20 22:54:14.008422
32876,39,42,11,122,290,504,2022-03-20 22:54:16.539186
32878,3267,19721,1681,7208,13125,45002,2022-03-20 22:54:20.625402
32879,146,3652,63,108,1725,5694,2022-03-20 22:54:23.010599
32881,2537,6763,1537,4051,5269,20157,2022-03-20 22:54:23.198645
32884,10,62,4,58,70,204,2022-03-20 22:54:23.462433
32885,14,77,4,35,88,218,2022-03-20 22:54:23.726201
32889,20,164,5,54,92,335,2022-03-20 22:54:26.375627
32892,33,88,10,83,145,359,2022-03-20 22:54:27.228868
32894,35,3178,13,67,258,3551,2022-03-20 22:54:29.892905
32897,17,97,10,44,128,296,2022-03-20 22:54:32.210393
32898,73,1241,47,78,789,2228,2022-03-20 22:54:32.401301
32899,25292,245349,12292,22577,83263,388773,2022-03-20 22:54:32.953061
32900,4097,110189,1427,709,48060,164482,2022-03-20 22:54:35.624458
32902,20476,143464,6860,3928,73749,248477,2022-03-20 22:54:36.725241
32904,7,49,5,37,39,137,2022-03-20 22:54:39.276573
32906,404,3580,192,1458,1599,7233,2022-03-20 22:54:42.571061
32915,1009,32053,576,286,15745,49669,2022-03-20 22:54:44.428872
32916,23,74,2,62,62,223,2022-03-20 22:54:44.69157
32920,15,73,4,43,114,249,2022-03-20 22:54:45.864333
32924,9799,44205,5121,9164,51304,119593,2022-03-20 22:54:46.302815
32927,63,785,35,49,767,1699,2022-03-20 22:54:49.005608
32928,6,155,0,20,23,204,2022-03-20 22:54:49.515028
32930,3675,55563,1461,732,13544,74975,2022-03-20 22:54:50.019819
32934,45,1408,21,62,485,2021,2022-03-20 22:54:52.028385
32935,34173,869517,7215,4582,88055,1003542,2022-03-20 22:54:52.509385
32937,48259,1076315,15052,11122,125752,1276500,2022-03-20 22:54:52.866385
43,9949,367665,4104,2185,158717,542620,2022-03-21 08:23:07.223238
50,6553,91122,6994,8506,34033,147208,2022-03-21 08:23:08.395569
43390,0,8,0,11,11,30,2022-03-21 11:29:13.809824
105,869,10889,881,1451,7484,21574,2022-03-21 08:23:19.320029
106,2817,28221,2380,3426,18210,55054,2022-03-21 08:23:19.833359
109,2959,35787,3648,4653,18649,65696,2022-03-21 08:23:20.497665
116,699,8792,679,727,5245,16142,2022-03-21 08:23:21.581266
158,2576,24196,2127,2960,28375,60234,2022-03-21 08:23:44.834674
121,62201,1004674,48272,45910,170088,1331145,2022-03-21 08:23:22.907056
128,243,6131,284,291,2954,9903,2022-03-21 08:23:24.003443
154,14719,232575,12935,14995,58315,333539,2022-03-21 08:23:35.277811
155,549,24116,352,389,8598,34004,2022-03-21 08:23:37.684795
159,834,7026,770,1252,7635,17517,2022-03-21 08:23:45.036736
160,5133,43680,3627,2766,68271,123477,2022-03-21 08:23:48.751943
161,2375,28065,2486,2286,18804,54016,2022-03-21 08:23:48.936154
162,831,12728,1151,1630,5595,21935,2022-03-21 08:23:52.472926
223,48125,718219,33538,29389,60341,889612,2022-03-21 08:24:01.014272
259,423,6354,336,374,3432,10919,2022-03-21 08:24:06.960695
275,767,12257,580,947,6112,20663,2022-03-21 08:24:13.114747
276,2300,32671,1964,1901,18754,57590,2022-03-21 08:24:15.8342
277,959,21250,811,709,6656,30385,2022-03-21 08:24:19.231531
278,474,5750,667,1236,2480,10607,2022-03-21 08:24:19.401004
279,1796,10408,1378,1248,18939,33769,2022-03-21 08:24:19.671619
285,1155,7657,1192,1392,13120,24516,2022-03-21 08:24:24.029085
286,460,6225,454,595,2928,10662,2022-03-21 08:24:24.228977
288,2174,85570,2030,4929,5976,100679,2022-03-21 08:24:27.423038
289,587,9705,806,1071,5924,18093,2022-03-21 08:24:30.554552
291,946,20638,896,938,8624,32042,2022-03-21 08:24:36.234083
294,517,4970,478,900,4669,11534,2022-03-21 08:24:41.554339
296,1368,11328,1641,1951,5432,21720,2022-03-21 08:24:42.462479
297,1924,31546,1777,2466,14599,52312,2022-03-21 08:24:42.653679
299,684,22435,1091,906,6625,31741,2022-03-21 08:24:46.307714
301,246,3170,293,446,2488,6643,2022-03-21 08:24:49.289407
302,1907,17700,1367,879,20513,42366,2022-03-21 08:24:49.465116
303,591,13451,876,1235,4855,21008,2022-03-21 08:24:52.664122
304,612,31518,392,286,7379,40187,2022-03-21 08:24:52.835882
306,3438,38554,3483,3468,31265,80208,2022-03-21 08:24:55.991505
310,47,884,53,173,534,1691,2022-03-21 08:24:56.998996
317,1549,188115,508,520,11390,202082,2022-03-21 08:24:58.167103
319,151,3783,136,170,1650,5890,2022-03-21 08:25:04.104913
321,581,7620,497,977,4133,13808,2022-03-21 08:25:04.370938
326,1396,36712,913,938,18936,58895,2022-03-21 08:25:05.311054
334,3514,23405,3320,3450,15337,49026,2022-03-21 08:25:10.151748
336,512,4416,640,958,5689,12215,2022-03-21 08:25:10.519017
337,396,6160,321,535,3257,10669,2022-03-21 08:25:10.783266
342,629,6001,584,718,6403,14335,2022-03-21 08:25:11.659243
373,350,5602,402,426,3798,10578,2022-03-21 08:25:20.546259
374,200,2728,219,287,1756,5190,2022-03-21 08:25:23.499487
375,299,3318,367,399,2596,6979,2022-03-21 08:25:23.936784
376,1672,152606,995,696,23603,179572,2022-03-21 08:25:28.645538
425,139,4103,90,156,1947,6435,2022-03-21 08:25:43.834604
427,3548,40438,4310,4075,24761,77132,2022-03-21 08:25:49.91893
429,225,9746,127,132,3127,13357,2022-03-21 08:25:50.297751
430,2709,265000,1479,869,35535,305592,2022-03-21 08:25:54.23861
431,11913,976085,2949,1171,101091,1093209,2022-03-21 08:25:54.424045
438,368,7613,246,298,4760,13285,2022-03-21 08:26:03.220252
440,14835,59853,11213,6063,92483,184447,2022-03-21 08:26:04.407999
441,726,29918,421,298,13205,44568,2022-03-21 08:26:04.66461
443,532,39067,306,212,5155,45272,2022-03-21 08:26:05.137687
445,532,8007,599,719,6202,16059,2022-03-21 08:26:13.195449
447,619,8612,983,1397,5952,17563,2022-03-21 08:26:13.57419
448,701,31272,387,248,7384,39992,2022-03-21 08:26:13.829855
461,637,61442,402,296,7857,70634,2022-03-21 08:26:15.807719
469,5866,116296,5255,7510,31798,166725,2022-03-21 08:26:17.144919
502,538,52477,315,293,5769,59392,2022-03-21 08:26:22.201745
507,332,25356,243,355,4415,30701,2022-03-21 08:26:23.030092
508,2206,27936,4443,10598,7494,52677,2022-03-21 08:26:27.362848
524,298,24127,222,146,3777,28570,2022-03-21 08:26:33.844147
525,858,4394,913,992,9243,16400,2022-03-21 08:26:34.054473
526,576,6519,403,371,8750,16619,2022-03-21 08:26:34.568423
527,37556,406617,33670,54601,23612,556056,2022-03-21 08:26:34.738403
532,4465,100610,2985,1875,19728,129663,2022-03-21 08:26:42.360414
533,354,3437,463,539,2990,7783,2022-03-21 08:26:42.570413
534,6087,73447,6000,4750,38114,128398,2022-03-21 08:26:44.9715
535,1859,48196,1464,970,12026,64515,2022-03-21 08:26:45.226832
541,494,14030,342,295,3915,19076,2022-03-21 08:26:48.704375
543,3192,103697,1064,627,42285,150865,2022-03-21 08:26:49.066301
546,440,5164,371,462,4379,10816,2022-03-21 08:26:53.03498
547,76,1620,83,79,908,2766,2022-03-21 08:26:53.323416
556,124,3101,115,125,1604,5069,2022-03-21 08:26:54.860149
563,1318,24763,1196,1688,10563,39528,2022-03-21 08:27:02.771566
564,546,21799,355,474,7537,30711,2022-03-21 08:27:02.970211
566,1027,12497,659,454,12881,27518,2022-03-21 08:27:07.66438
567,4019,41668,4516,3343,30698,84244,2022-03-21 08:27:07.840522
568,1515,17181,1737,1592,12107,34132,2022-03-21 08:27:08.107939
569,2353,16472,1870,1369,20922,42986,2022-03-21 08:27:11.658447
570,3723,82630,1334,718,58776,147181,2022-03-21 08:27:12.096066
572,3777,259016,1801,938,57280,322812,2022-03-21 08:27:15.750865
591,2962,44693,2683,4881,14652,69871,2022-03-21 08:27:21.016674
592,73,739,94,168,769,1843,2022-03-21 08:27:21.228472
596,365,37525,310,247,6284,44731,2022-03-21 08:27:25.831217
597,2186,190468,957,383,34684,228678,2022-03-21 08:27:26.307061
598,273,5240,347,435,2619,8914,2022-03-21 08:27:29.624991
599,195,2347,138,120,2383,5183,2022-03-21 08:27:32.476213
601,1139,44009,465,342,22545,68500,2022-03-21 08:27:37.039943
602,100,944,109,153,1219,2525,2022-03-21 08:27:38.965994
603,3285,20851,2952,2902,11625,41615,2022-03-21 08:27:39.889112
604,469,4500,507,575,4442,10493,2022-03-21 08:27:40.061433
605,335,2281,388,544,3146,6694,2022-03-21 08:27:42.387876
608,143,3906,100,97,1773,6019,2022-03-21 08:27:45.294715
609,363,10984,329,220,5192,17088,2022-03-21 08:27:48.394291
610,927,11393,985,1741,7354,22400,2022-03-21 08:27:48.571607
611,219,904,116,210,2141,3590,2022-03-21 08:27:49.280729
612,347,2638,287,378,2771,6421,2022-03-21 08:27:51.966166
614,401,3186,336,433,4253,8609,2022-03-21 08:27:55.187703
629,256,4493,219,233,3225,8426,2022-03-21 08:27:59.924474
630,398,4289,380,421,4438,9926,2022-03-21 08:28:00.128447
631,160,8073,139,93,2137,10602,2022-03-21 08:28:00.477172
635,683,9136,730,1026,5724,17299,2022-03-21 08:28:01.190435
652,225,6390,246,231,2356,9448,2022-03-21 08:28:03.466073
656,409,30975,419,285,6744,38832,2022-03-21 08:28:07.19157
658,4674,46539,3913,2832,33533,91491,2022-03-21 08:28:10.253203
659,307,31060,273,178,6139,37957,2022-03-21 08:28:10.436455
660,123,1729,129,153,1224,3358,2022-03-21 08:28:13.631751
664,688,25508,599,462,13462,40719,2022-03-21 08:28:14.065797
687,6238,85306,7383,10356,24368,133651,2022-03-21 08:28:17.275673
696,3003,43137,2346,2195,19498,70179,2022-03-21 08:28:21.567689
705,56,1476,53,51,699,2335,2022-03-21 08:28:24.176048
706,303,5025,409,486,2847,9070,2022-03-21 08:28:26.741968
707,58,2248,90,58,1112,3566,2022-03-21 08:28:27.091553
708,304,2745,259,281,3536,7125,2022-03-21 08:28:27.445062
709,1376,10862,1195,1019,11671,26123,2022-03-21 08:28:27.704255
734,145,4830,62,124,1445,6606,2022-03-21 08:28:33.650534
738,3790,20805,5079,5353,12396,47423,2022-03-21 08:28:33.851062
740,6215,109497,4003,2087,17442,139244,2022-03-21 08:28:34.282538
790,34557,238956,29925,21486,236105,561029,2022-03-21 08:28:43.585801
791,173,2693,87,100,2700,5753,2022-03-21 08:28:45.732096
792,227,15503,197,124,3097,19148,2022-03-21 08:28:45.905157
795,2642,9238,1606,1169,22984,37639,2022-03-21 08:28:51.920106
810,142,1252,165,264,1364,3187,2022-03-21 08:28:53.381986
817,467,4710,402,524,3402,9505,2022-03-21 08:28:57.058991
818,522,6258,466,662,4802,12710,2022-03-21 08:28:59.621765
819,737,30887,337,468,7921,40350,2022-03-21 08:29:02.289683
820,29606,61844,17235,6991,158242,273918,2022-03-21 08:29:05.067948
821,564,25129,271,287,6275,32526,2022-03-21 08:29:05.245086
822,733,36179,326,244,6505,43987,2022-03-21 08:29:08.280391
825,216,9161,158,200,2135,11870,2022-03-21 08:29:11.199224
831,933,11825,1370,1884,5859,21871,2022-03-21 08:29:11.399278
832,166,750,126,186,1523,2751,2022-03-21 08:29:13.543611
833,585,6009,512,633,4511,12250,2022-03-21 08:29:18.429037
835,336,4105,349,490,3233,8513,2022-03-21 08:29:18.77212
836,1503,10160,1191,1935,8041,22830,2022-03-21 08:29:19.037883
841,939,10565,704,1572,9977,23757,2022-03-21 08:29:20.171263
856,8147,75860,6076,5818,55644,151545,2022-03-21 08:29:26.383615
858,254,1431,232,400,2065,4382,2022-03-21 08:29:29.914183
860,1568,24318,1816,2540,11132,41374,2022-03-21 08:29:30.429278
876,934,17087,855,978,4733,24587,2022-03-21 08:29:32.770177
909,409,6519,496,724,4715,12863,2022-03-21 08:29:38.708986
921,148,3491,134,97,1865,5735,2022-03-21 08:29:43.171149
924,136,1746,90,170,770,2912,2022-03-21 08:29:45.814071
926,115,1527,122,137,766,2667,2022-03-21 08:29:49.579423
927,166,3416,137,326,864,4909,2022-03-21 08:29:49.750957
929,751,2250,583,433,6335,10352,2022-03-21 08:29:52.544958
930,864,3638,646,394,8255,13797,2022-03-21 08:29:53.067161
932,144,5469,79,58,1802,7552,2022-03-21 08:29:56.608882
934,43732,411243,36872,34133,198417,724397,2022-03-21 08:29:59.641397
935,5738,54842,5093,5664,34392,105729,2022-03-21 08:30:02.351197
936,1618,191232,750,603,13845,208048,2022-03-21 08:30:02.629771
43400,0,7,2,7,10,26,2022-03-21 11:29:20.764729
937,507,17838,281,274,8252,27152,2022-03-21 08:30:02.796566
949,3954,56227,2173,1248,45555,109157,2022-03-21 08:30:09.760262
950,157,10734,86,94,1896,12967,2022-03-21 08:30:12.30996
951,864,5188,1006,1300,2240,10598,2022-03-21 08:30:14.900748
952,307,2323,335,477,3184,6626,2022-03-21 08:30:15.331959
957,6192,38733,5304,4345,32894,87468,2022-03-21 08:30:19.094209
962,3803,32120,2928,1651,30842,71344,2022-03-21 08:30:19.990865
969,3304,75693,3625,3092,25332,111046,2022-03-21 08:30:23.425171
970,257,2459,285,295,2189,5485,2022-03-21 08:30:23.620803
971,858,12198,1177,1786,4337,20356,2022-03-21 08:30:26.639796
973,525,3851,539,834,5424,11173,2022-03-21 08:30:26.850594
974,1503,46791,672,578,33245,82789,2022-03-21 08:30:27.19009
990,1511,28159,1335,1690,12887,45582,2022-03-21 08:30:29.69165
1012,39,1121,16,59,360,1595,2022-03-21 08:30:33.120304
1019,914,9844,805,1254,8775,21592,2022-03-21 08:30:34.774281
1032,133,3958,83,71,2732,6977,2022-03-21 08:30:39.172739
1033,3102,85388,1408,582,62390,152870,2022-03-21 08:30:41.724874
1034,973,17987,444,269,19463,39136,2022-03-21 08:30:41.905732
1081,317,3180,223,173,3443,7336,2022-03-21 08:30:53.928258
1110,1071,31101,1208,1473,4860,39713,2022-03-21 08:30:58.404226
1133,1154,18294,1005,1359,6583,28395,2022-03-21 08:31:04.930668
1169,172,2672,130,85,2630,5689,2022-03-21 08:31:10.41769
1182,398,5413,366,415,4424,11016,2022-03-21 08:31:12.689723
1190,151,12657,90,111,2086,15095,2022-03-21 08:31:14.021498
1207,135,2283,83,79,2451,5031,2022-03-21 08:31:16.328913
1216,126,6936,69,151,1995,9277,2022-03-21 08:31:17.632728
1225,294,9440,242,197,3232,13405,2022-03-21 08:31:27.164432
1226,370,3414,321,499,3675,8279,2022-03-21 08:31:27.365731
1227,160,1097,84,127,1458,2926,2022-03-21 08:31:27.72151
1247,143,1241,172,204,1537,3297,2022-03-21 08:31:34.447949
1248,190,5193,116,113,2893,8505,2022-03-21 08:31:34.643698
1249,463,4732,493,538,4714,10940,2022-03-21 08:31:34.900622
1250,3915,54398,4231,4691,22764,89999,2022-03-21 08:31:35.176905
1254,10952,107367,8815,8578,31013,166725,2022-03-21 08:31:35.894426
1261,463,5941,832,1253,3551,12040,2022-03-21 08:31:37.070135
1270,347,8104,135,105,4932,13623,2022-03-21 08:31:38.37393
1279,389,6350,369,407,3790,11305,2022-03-21 08:31:39.541207
1312,448,3158,449,504,3924,8483,2022-03-21 08:31:46.274971
1317,149,5416,109,137,2375,8186,2022-03-21 08:31:55.998341
1325,243,1935,323,476,2954,5931,2022-03-21 08:31:59.063761
1328,97,2333,45,60,1396,3931,2022-03-21 08:31:59.517056
1357,451,7310,259,236,4852,13108,2022-03-21 08:32:02.964396
1361,330,63693,166,298,3521,68008,2022-03-21 08:32:08.924879
1362,355,22190,138,105,3748,26536,2022-03-21 08:32:12.813585
1363,612,49910,243,291,3866,54922,2022-03-21 08:32:13.273599
1364,643,50669,260,300,4065,55937,2022-03-21 08:32:13.610852
1365,1191,60101,409,509,6129,68339,2022-03-21 08:32:14.036694
1397,1374,12992,1347,1284,10378,27375,2022-03-21 08:32:19.070317
1412,6284,32709,4939,3044,43014,89990,2022-03-21 08:32:23.00795
1413,129,3981,102,93,2420,6725,2022-03-21 08:32:23.235307
1416,196,6055,140,122,3494,10007,2022-03-21 08:32:23.932376
1432,157,6226,112,111,2958,9564,2022-03-21 08:32:32.220795
1433,138,4826,112,112,2377,7565,2022-03-21 08:32:34.623127
1435,210,8048,125,117,3241,11741,2022-03-21 08:32:34.993559
1436,117,4196,85,92,2064,6554,2022-03-21 08:32:37.454638
1437,108,4190,101,100,2403,6902,2022-03-21 08:32:39.494436
1438,134,4107,102,90,2353,6786,2022-03-21 08:32:41.112303
1439,138,4453,114,104,2563,7372,2022-03-21 08:32:42.427853
1440,91,1638,53,77,963,2822,2022-03-21 08:32:44.530828
1441,409,9155,254,209,10029,20056,2022-03-21 08:32:46.85814
1442,275,3557,221,728,2536,7317,2022-03-21 08:32:47.592499
1443,186,2700,109,125,2549,5669,2022-03-21 08:32:50.387676
1455,144,4092,106,153,1891,6386,2022-03-21 08:32:52.044425
1462,3849,45511,1728,679,48033,99800,2022-03-21 08:32:53.004025
1472,518,10573,335,266,6352,18044,2022-03-21 08:32:54.203086
1480,110,5129,80,74,1555,6948,2022-03-21 08:32:58.888951
1481,95,2417,74,82,1367,4035,2022-03-21 08:33:01.214819
1482,58107,282470,57968,45871,187777,632193,2022-03-21 08:33:01.396243
1483,1393,5050,1063,706,14478,22690,2022-03-21 08:33:01.567555
1486,4551,26544,5429,3950,17992,58466,2022-03-21 08:33:02.772147
1537,110,733,89,160,856,1948,2022-03-21 08:33:11.599232
1538,1857,19232,1949,2351,13334,38723,2022-03-21 08:33:14.19073
1539,62,1979,45,86,803,2975,2022-03-21 08:33:14.363728
1540,73,2087,51,77,928,3216,2022-03-21 08:33:14.622952
1569,2618,32321,1866,2454,19958,59217,2022-03-21 08:33:23.689935
1577,888,8956,473,296,10359,20972,2022-03-21 08:33:27.812544
1603,350,3390,357,449,2702,7248,2022-03-21 08:33:32.222106
1613,44,1867,22,57,587,2577,2022-03-21 08:33:33.389479
1622,126,4604,77,130,2365,7302,2022-03-21 08:33:37.959623
1624,98,1859,82,73,1523,3635,2022-03-21 08:33:41.575882
1626,150,2259,98,112,2612,5231,2022-03-21 08:33:45.948811
1627,91,825,78,88,883,1965,2022-03-21 08:33:49.199776
1629,1162,6644,832,1088,11773,21499,2022-03-21 08:33:50.028413
1657,447,6282,458,707,6512,14406,2022-03-21 08:33:53.030676
1690,7923,54786,6756,6155,95257,170877,2022-03-21 08:33:58.000061
1698,12460,147306,10132,7570,111575,289043,2022-03-21 08:33:59.349448
1713,97,614,69,102,863,1745,2022-03-21 08:34:02.232087
1786,114,1085,62,93,909,2263,2022-03-21 08:34:16.699821
1734,506,7523,277,427,5017,13750,2022-03-21 08:34:05.13008
1789,59,2332,75,74,1058,3598,2022-03-21 08:34:19.240688
1792,666,3977,658,632,5518,11451,2022-03-21 08:34:21.473491
1796,221,4365,116,81,3238,8021,2022-03-21 08:34:22.496474
1812,166,2069,103,404,1543,4285,2022-03-21 08:34:24.814004
1822,333,2545,252,312,4552,7994,2022-03-21 08:34:26.108728
1850,31,329,23,40,381,804,2022-03-21 08:34:31.010471
1873,153,1444,145,187,1433,3362,2022-03-21 08:34:36.858332
1909,127,2902,55,111,1503,4698,2022-03-21 08:34:44.560026
1910,377,3073,230,141,4726,8547,2022-03-21 08:34:45.523552
1912,763,4799,673,1247,5693,13175,2022-03-21 08:34:48.44563
1913,1831,21203,1198,860,14829,39921,2022-03-21 08:34:51.482036
1917,293,9434,238,286,3790,14041,2022-03-21 08:35:01.339609
1918,196,3974,164,191,2312,6837,2022-03-21 08:35:04.033638
1919,234,2881,190,128,2210,5643,2022-03-21 08:35:04.207358
1920,158,5700,114,100,2765,8837,2022-03-21 08:35:04.478979
1923,126,3497,99,87,2112,5921,2022-03-21 08:35:08.960195
1924,140,3522,109,103,2299,6173,2022-03-21 08:35:11.03382
1925,154,3163,103,97,2547,6064,2022-03-21 08:35:12.747348
1926,33,1750,26,54,484,2347,2022-03-21 08:35:12.939692
1927,87,1501,40,58,847,2533,2022-03-21 08:35:13.205633
1928,96,1891,61,70,1113,3231,2022-03-21 08:35:13.472727
1935,1105,5032,705,459,9939,17240,2022-03-21 08:35:14.525122
1966,89,1182,53,113,1225,2662,2022-03-21 08:35:22.386945
1968,163,6941,129,149,2867,10249,2022-03-21 08:35:22.762431
1972,639,4126,619,466,4113,9963,2022-03-21 08:35:26.732737
1973,79,1612,40,73,1390,3194,2022-03-21 08:35:28.979764
1974,1856,13446,1555,1436,16740,35033,2022-03-21 08:35:31.891366
1975,72,304,60,119,722,1277,2022-03-21 08:35:33.751982
1977,67,1478,45,39,1370,2999,2022-03-21 08:35:35.828112
1995,273,4108,128,190,2609,7308,2022-03-21 08:35:40.743548
2004,648,4406,564,558,7323,13499,2022-03-21 08:35:45.868462
2006,599,41445,325,371,5375,48115,2022-03-21 08:35:49.149606
2008,60,920,39,63,920,2002,2022-03-21 08:35:49.340545
2014,365,5270,297,225,3307,9464,2022-03-21 08:35:50.590909
2023,134,1256,100,143,1403,3036,2022-03-21 08:35:51.910027
2030,2487,19317,3061,3030,21189,49084,2022-03-21 08:35:53.212183
2034,22231,326134,16330,17193,133141,515029,2022-03-21 08:35:54.160445
2050,146,3510,87,90,2240,6073,2022-03-21 08:35:56.717888
2064,100,1235,68,72,1065,2540,2022-03-21 08:36:01.493592
2066,62,713,54,51,757,1637,2022-03-21 08:36:04.904351
2068,119,1068,64,85,1344,2680,2022-03-21 08:36:06.914103
2069,55,674,29,38,585,1381,2022-03-21 08:36:08.72432
2071,132,4409,103,94,2764,7502,2022-03-21 08:36:08.892321
2072,85,849,56,117,824,1931,2022-03-21 08:36:09.432983
2078,57,1184,53,71,728,2093,2022-03-21 08:36:12.360881
2079,77,647,41,73,826,1664,2022-03-21 08:36:14.037374
2080,41,498,17,51,482,1089,2022-03-21 08:36:14.214373
2081,44,693,22,42,462,1263,2022-03-21 08:36:15.823027
2082,58,614,39,53,708,1472,2022-03-21 08:36:17.447796
2083,104,1369,62,62,1153,2750,2022-03-21 08:36:17.635106
2089,303,1376,274,222,3122,5297,2022-03-21 08:36:20.648378
2090,94,1475,82,89,1465,3205,2022-03-21 08:36:22.747618
2091,32,510,16,42,355,955,2022-03-21 08:36:24.194376
2093,40,527,15,48,471,1101,2022-03-21 08:36:27.311554
2095,56,547,39,76,661,1379,2022-03-21 08:36:28.44996
2106,804,2983,693,803,4624,9907,2022-03-21 08:36:32.97936
2108,564,10878,676,655,3060,15833,2022-03-21 08:36:33.804355
2109,445,5196,386,304,2353,8684,2022-03-21 08:36:34.074783
2118,98,4253,65,107,966,5489,2022-03-21 08:36:39.585111
2119,89,3460,66,113,911,4639,2022-03-21 08:36:42.613145
2120,74,3270,59,108,895,4406,2022-03-21 08:36:44.693665
2121,89,3451,57,103,919,4619,2022-03-21 08:36:46.12368
2123,211,15682,184,228,3166,19471,2022-03-21 08:36:49.432147
2126,258,7131,193,184,4173,11939,2022-03-21 08:36:50.055549
2148,1234,34948,593,1407,4788,42970,2022-03-21 08:36:52.445317
2163,868,12532,576,648,7281,21905,2022-03-21 08:36:58.212486
2164,7407,44468,7215,4740,69422,133252,2022-03-21 08:36:58.493766
2171,328,34989,201,188,3403,39109,2022-03-21 08:37:02.606216
2172,71,1953,43,105,686,2858,2022-03-21 08:37:05.425166
2173,27,203,19,49,220,518,2022-03-21 08:37:05.745177
2174,230,5609,131,129,2968,9067,2022-03-21 08:37:05.918384
2175,848,27378,503,223,16329,45281,2022-03-21 08:37:06.19681
2286,136,6413,81,89,2306,9025,2022-03-21 08:37:23.373475
2301,58,1016,37,63,687,1861,2022-03-21 08:37:27.082778
2302,78,2643,63,163,1182,4129,2022-03-21 08:37:28.948796
2303,94,2177,91,144,1105,3611,2022-03-21 08:37:29.138442
2304,74,1635,63,130,1106,3008,2022-03-21 08:37:30.443955
2307,137,1506,94,82,1208,3027,2022-03-21 08:37:31.369764
2336,115,7133,106,100,1754,9208,2022-03-21 08:37:34.8625
2471,4639,29090,4562,7814,5221,51326,2022-03-21 08:37:47.168152
2475,132,1516,81,197,1308,3234,2022-03-21 08:37:48.459571
2485,40,1006,41,75,593,1755,2022-03-21 08:37:51.548611
2486,302,2190,303,221,3428,6444,2022-03-21 08:37:51.743431
2487,89,646,77,93,736,1641,2022-03-21 08:37:53.709006
2498,224,10435,169,156,3558,14542,2022-03-21 08:37:57.961357
2500,405,5690,196,135,4981,11407,2022-03-21 08:37:58.588901
2503,48,206,37,101,471,863,2022-03-21 08:38:00.559981
2508,2070,54587,1834,1347,17779,77617,2022-03-21 08:38:03.122164
2510,142,708,110,133,1433,2526,2022-03-21 08:38:04.947631
2511,78,1136,41,63,1384,2702,2022-03-21 08:38:05.122719
2512,161,12820,114,131,2120,15346,2022-03-21 08:38:08.478078
2513,153,11917,116,126,1988,14300,2022-03-21 08:38:09.965322
2514,196,13359,126,136,2278,16095,2022-03-21 08:38:10.137334
2517,73,3246,68,82,1632,5101,2022-03-21 08:38:12.990376
2518,169,1581,233,151,839,2973,2022-03-21 08:38:17.237426
2520,367,23305,244,290,4209,28415,2022-03-21 08:38:20.804962
2522,62,1224,40,67,840,2233,2022-03-21 08:38:22.082516
2525,239,2273,133,214,2169,5028,2022-03-21 08:38:28.6384
2526,142,2211,75,75,1475,3978,2022-03-21 08:38:30.747019
2529,54,931,36,42,652,1715,2022-03-21 08:38:31.272054
2538,48,521,39,62,540,1210,2022-03-21 08:38:33.529674
2542,354,5197,359,358,2667,8935,2022-03-21 08:38:35.96502
2543,267,4886,272,341,1915,7681,2022-03-21 08:38:36.146717
2544,230,3040,184,221,1801,5476,2022-03-21 08:38:38.7332
2546,125,2065,121,200,1121,3632,2022-03-21 08:38:39.170338
2580,152,8381,134,91,2444,11202,2022-03-21 08:38:46.390846
2581,9020,139687,6326,4840,41357,201230,2022-03-21 08:38:46.674409
2582,1707,5575,1210,694,11671,20857,2022-03-21 08:38:47.014442
2589,278,14315,277,185,5676,20731,2022-03-21 08:38:47.786644
2655,70,6564,52,113,659,7458,2022-03-21 08:38:58.868205
2661,51,5360,85,101,529,6126,2022-03-21 08:39:00.074677
2668,48,3282,44,108,544,4026,2022-03-21 08:39:01.018652
2675,61,5504,39,106,594,6304,2022-03-21 08:39:02.173128
2709,107,2398,90,228,615,3438,2022-03-21 08:39:08.838265
2712,19,134,9,59,244,465,2022-03-21 08:39:09.741618
2743,140,5053,119,156,2184,7652,2022-03-21 08:39:14.218385
2758,89,401,66,133,528,1217,2022-03-21 08:39:18.478654
2760,77,2214,44,74,1426,3835,2022-03-21 08:39:21.257483
2761,216,3700,89,129,3825,7959,2022-03-21 08:39:21.717493
2762,390,4544,352,421,4057,9764,2022-03-21 08:39:24.556742
2766,159,1583,189,360,1277,3568,2022-03-21 08:39:24.901578
2767,112,1926,74,107,2718,4937,2022-03-21 08:39:25.421509
2808,172,8222,88,110,2289,10881,2022-03-21 08:39:31.094815
2816,200,3385,165,256,1108,5114,2022-03-21 08:39:34.937511
2876,25,309,12,57,440,843,2022-03-21 08:39:42.902587
2892,53,976,83,224,422,1758,2022-03-21 08:39:44.299167
2915,48,657,29,49,742,1525,2022-03-21 08:39:48.302032
2916,66,420,44,75,465,1070,2022-03-21 08:39:48.499987
2947,69,3072,66,85,1244,4536,2022-03-21 08:39:53.789604
2948,66,2939,58,84,1275,4422,2022-03-21 08:39:53.992311
2950,314,16175,208,214,6630,23541,2022-03-21 08:39:54.264974
3065,76,770,47,53,786,1732,2022-03-21 08:40:07.149994
3129,54,540,52,152,338,1136,2022-03-21 08:40:13.116943
3159,204,436,232,218,1561,2651,2022-03-21 08:40:15.803687
3213,98,696,82,162,1149,2187,2022-03-21 08:40:20.277723
3223,112,1909,105,108,2052,4286,2022-03-21 08:40:21.535494
3231,1965,32554,2284,3093,17069,56965,2022-03-21 08:40:22.707708
3248,106,1211,133,107,1160,2717,2022-03-21 08:40:26.84623
3251,35,139,20,62,221,477,2022-03-21 08:40:29.144013
3252,30,423,11,51,293,808,2022-03-21 08:40:31.423177
3256,212,2433,169,167,1677,4658,2022-03-21 08:40:31.595027
3258,171,3882,66,66,2847,7032,2022-03-21 08:40:34.260233
3259,82,521,56,90,865,1614,2022-03-21 08:40:36.969277
3265,99,3498,98,113,1700,5508,2022-03-21 08:40:39.437639
3266,256,13210,193,158,3214,17031,2022-03-21 08:40:39.613463
3267,62,192,38,63,653,1008,2022-03-21 08:40:42.046705
3268,496,9499,379,234,3141,13749,2022-03-21 08:40:42.251658
3269,551,20696,401,458,8702,30808,2022-03-21 08:40:42.514054
3270,678,10536,637,859,5623,18333,2022-03-21 08:40:42.80315
3274,37,382,23,76,380,898,2022-03-21 08:40:43.511918
3281,130,1343,85,162,1117,2837,2022-03-21 08:40:44.756267
3317,74,402,69,109,509,1163,2022-03-21 08:40:48.983708
3320,51,858,38,52,721,1720,2022-03-21 08:40:51.912759
3322,2029,13545,1923,1951,11187,30635,2022-03-21 08:40:52.201704
3355,48,295,36,88,561,1028,2022-03-21 08:40:56.962583
3356,171,1101,245,326,1585,3428,2022-03-21 08:40:59.076771
3358,3535,44600,2732,2650,31804,85321,2022-03-21 08:41:02.114024
3359,2835,31215,2932,3368,14903,55253,2022-03-21 08:41:02.28383
3361,61,337,36,123,361,918,2022-03-21 08:41:05.003211
3362,34,146,17,54,512,763,2022-03-21 08:41:05.717708
3375,1275,43235,411,639,5073,50633,2022-03-21 08:41:09.561997
3391,334,403,257,367,1811,3172,2022-03-21 08:41:10.517143
3424,136,537,134,157,1765,2729,2022-03-21 08:41:12.847382
3436,37,306,38,112,214,707,2022-03-21 08:41:14.086971
3447,178,6955,166,163,4468,11930,2022-03-21 08:41:15.278119
3458,61,175,37,98,193,564,2022-03-21 08:41:16.522196
3466,507,24720,336,174,9477,35214,2022-03-21 08:41:17.594224
3480,55,711,37,52,754,1609,2022-03-21 08:41:21.916795
3505,105,589,91,131,1002,1918,2022-03-21 08:41:24.890992
3513,34,461,20,44,436,995,2022-03-21 08:41:27.464599
3519,70,619,57,133,369,1248,2022-03-21 08:41:28.518533
3561,142,1079,103,171,770,2265,2022-03-21 08:41:31.061515
3619,77,568,65,132,870,1712,2022-03-21 08:41:40.689786
3625,170,3528,73,116,2894,6781,2022-03-21 08:41:41.330834
3637,70,295,36,100,371,872,2022-03-21 08:41:43.717495
3673,1829,12719,1552,1518,14659,32277,2022-03-21 08:41:47.190403
3726,45,675,20,46,499,1285,2022-03-21 08:41:50.77671
3760,47,750,27,55,824,1703,2022-03-21 08:41:54.288979
3769,28,160,12,70,228,498,2022-03-21 08:41:57.390052
3791,555,36770,338,260,6896,44819,2022-03-21 08:42:03.066349
3808,54,238,35,93,439,859,2022-03-21 08:42:04.354186
3837,156,917,133,182,1079,2467,2022-03-21 08:42:07.958643
3843,43,840,28,84,466,1461,2022-03-21 08:42:08.891848
4056,99,1616,71,115,766,2667,2022-03-21 08:42:24.623503
4086,64,1617,75,178,418,2352,2022-03-21 08:42:30.949402
4155,2998,182305,877,636,20052,206868,2022-03-21 08:42:36.491272
4191,134,1036,143,188,1365,2866,2022-03-21 08:42:41.615921
4198,173,1137,164,209,1156,2839,2022-03-21 08:42:42.770626
4208,95,819,82,161,667,1824,2022-03-21 08:42:43.80784
4220,12,154,7,41,166,380,2022-03-21 08:42:44.99995
4332,35,298,35,95,358,821,2022-03-21 08:42:48.679247
4375,112,1522,129,292,459,2514,2022-03-21 08:42:52.402815
4389,96,1862,54,127,996,3135,2022-03-21 08:42:53.586229
4439,90,614,63,150,775,1692,2022-03-21 08:43:00.613673
4443,120,3431,118,315,900,4884,2022-03-21 08:43:03.532461
4444,71,1322,46,185,718,2342,2022-03-21 08:43:03.728558
4447,418,37160,225,242,3701,41746,2022-03-21 08:43:06.791766
4450,202,5393,239,240,4259,10333,2022-03-21 08:43:09.9383
4452,35,414,12,37,321,819,2022-03-21 08:43:12.594759
4460,122,5715,48,71,2263,8219,2022-03-21 08:43:15.670862
4522,44,647,23,45,402,1161,2022-03-21 08:43:21.769797
4531,103,2613,58,122,1333,4229,2022-03-21 08:43:22.609547
4681,29,404,15,57,380,885,2022-03-21 08:43:33.719396
4682,16,284,8,50,175,533,2022-03-21 08:43:35.416996
4684,16,101,24,75,173,389,2022-03-21 08:43:35.583999
4688,92,1276,47,62,947,2424,2022-03-21 08:43:38.405727
4689,57,2043,32,46,1214,3392,2022-03-21 08:43:39.343258
4690,410,3623,523,526,3665,8747,2022-03-21 08:43:42.172356
4703,100,2898,80,114,1483,4675,2022-03-21 08:43:47.117564
4705,577,23362,498,443,7228,32108,2022-03-21 08:43:47.316161
4808,109,691,89,177,995,2061,2022-03-21 08:43:56.408585
4896,11687,99090,9282,11833,70280,202172,2022-03-21 08:43:59.397814
4934,42,677,21,68,388,1196,2022-03-21 08:44:07.484403
4936,400,6163,544,1337,809,9253,2022-03-21 08:44:08.268275
4983,827,12052,328,346,13091,26644,2022-03-21 08:44:14.732177
4985,511,19396,361,288,8575,29131,2022-03-21 08:44:15.192144
4991,29,548,15,67,374,1033,2022-03-21 08:44:15.357366
4997,127,3805,95,98,1590,5715,2022-03-21 08:44:15.625209
5020,703,8162,447,961,5548,15821,2022-03-21 08:44:21.082346
5032,392,4024,309,496,2800,8021,2022-03-21 08:44:22.526245
5043,61,1136,54,58,773,2082,2022-03-21 08:44:23.811367
5143,73,278,45,110,647,1153,2022-03-21 08:44:32.909786
5147,79,1695,87,60,1185,3106,2022-03-21 08:44:35.426864
5150,4611,47773,2854,3264,34545,93047,2022-03-21 08:44:35.602075
5151,32,204,36,64,693,1029,2022-03-21 08:44:36.669651
5152,442,41325,251,241,4706,46965,2022-03-21 08:44:36.923401
5153,182,839,132,149,1682,2984,2022-03-21 08:44:39.757026
5155,677,3638,644,838,7594,13391,2022-03-21 08:44:42.931705
5157,76,775,48,103,1198,2200,2022-03-21 08:44:43.190275
5158,43,4059,25,43,631,4801,2022-03-21 08:44:43.446444
5207,16,160,11,48,114,349,2022-03-21 08:44:46.752067
5231,10536,132779,7913,10126,16868,178222,2022-03-21 08:44:48.312672
5237,35,523,34,44,383,1019,2022-03-21 08:44:50.757494
5256,101,8251,113,140,2070,10675,2022-03-21 08:44:52.903924
5287,20,307,22,91,202,642,2022-03-21 08:45:01.249266
5288,87,1902,91,89,1628,3797,2022-03-21 08:45:01.411233
5289,36,689,33,63,447,1268,2022-03-21 08:45:01.672814
5290,103,3389,73,100,1116,4781,2022-03-21 08:45:01.929879
5351,149,3817,115,173,2652,6906,2022-03-21 08:45:06.264512
5372,82,873,58,77,959,2049,2022-03-21 08:45:07.58558
5458,236,13608,149,189,3039,17221,2022-03-21 08:45:09.99839
5473,32,104,13,68,201,418,2022-03-21 08:45:13.0937
5520,129,1059,130,166,1237,2721,2022-03-21 08:45:19.248703
5525,10935,122013,9570,13768,43208,199494,2022-03-21 08:45:19.785014
5526,160,30042,114,165,2011,32492,2022-03-21 08:45:23.171962
5529,142,8756,126,170,2300,11494,2022-03-21 08:45:27.065637
5530,23097,202430,20133,19122,134026,398808,2022-03-21 08:45:27.275924
5535,43,346,12,42,372,815,2022-03-21 08:45:32.178616
5538,235,8857,193,135,4402,13822,2022-03-21 08:45:32.396202
5618,128,317,152,210,622,1429,2022-03-21 08:45:37.672106
5620,44,724,26,86,405,1285,2022-03-21 08:45:37.873255
5622,56,1883,31,85,1009,3064,2022-03-21 08:45:38.138133
5624,62,3016,46,58,1020,4202,2022-03-21 08:45:40.649429
5629,41,440,34,42,509,1066,2022-03-21 08:45:43.406168
5631,33,1027,8,56,208,1332,2022-03-21 08:45:46.57765
5632,18,1115,4,45,195,1377,2022-03-21 08:45:49.962127
5636,45,228,20,74,392,759,2022-03-21 08:45:51.494285
5647,64,459,47,89,756,1415,2022-03-21 08:45:55.789127
5648,81,451,38,89,596,1255,2022-03-21 08:45:56.070599
5809,59,112,41,73,467,752,2022-03-21 08:46:06.688346
5828,71,894,48,58,739,1810,2022-03-21 08:46:11.940551
5830,85,1953,72,210,323,2643,2022-03-21 08:46:14.291307
5832,174,3565,132,228,1427,5526,2022-03-21 08:46:18.302705
5833,43,303,43,107,310,806,2022-03-21 08:46:19.72658
5834,114,447,111,167,1389,2228,2022-03-21 08:46:21.824817
5838,19,776,5,39,130,969,2022-03-21 08:46:23.749677
5841,25,95,10,98,175,403,2022-03-21 08:46:25.506195
5844,88,4063,94,144,1847,6236,2022-03-21 08:46:28.152065
5845,91,4587,105,143,1847,6773,2022-03-21 08:46:31.336903
5848,49,921,30,62,828,1890,2022-03-21 08:46:31.509186
5854,141,1118,129,127,1107,2622,2022-03-21 08:46:32.203204
5862,27,513,22,46,389,997,2022-03-21 08:46:40.756351
5865,49,1156,31,38,568,1842,2022-03-21 08:46:41.213393
5868,16,1184,6,36,136,1378,2022-03-21 08:46:43.132066
5880,11,887,5,23,180,1106,2022-03-21 08:46:46.21685
5883,366,724,335,452,2203,4080,2022-03-21 08:46:46.423566
5922,49,170,18,49,459,745,2022-03-21 08:46:52.02334
6024,2155,12893,1952,1616,8687,27303,2022-03-21 08:46:59.488712
6202,33,429,14,66,323,865,2022-03-21 08:47:12.542322
6448,46,240,46,153,262,747,2022-03-21 08:47:27.141547
6468,56,380,40,145,410,1031,2022-03-21 08:47:28.28469
6491,64,1008,31,64,559,1726,2022-03-21 08:47:31.9676
6560,603,4089,397,581,2881,8551,2022-03-21 08:47:39.005883
6566,69,2863,38,36,799,3805,2022-03-21 08:47:39.20828
6607,47,2845,15,37,472,3416,2022-03-21 08:47:45.083651
6653,66,1281,57,69,996,2469,2022-03-21 08:47:47.502141
6721,60,1374,46,130,767,2377,2022-03-21 08:47:54.97668
6730,14,141,8,76,87,326,2022-03-21 08:47:55.795304
6761,11,128,5,46,93,283,2022-03-21 08:47:59.751809
6792,80,1175,78,137,938,2408,2022-03-21 08:48:01.913301
6834,20,894,3,62,111,1090,2022-03-21 08:48:05.538971
6852,14,1329,9,61,170,1583,2022-03-21 08:48:12.091815
6861,33,724,11,41,470,1279,2022-03-21 08:48:12.907201
6889,41,286,34,126,366,853,2022-03-21 08:48:15.355696
6901,194,1446,92,191,1081,3004,2022-03-21 08:48:16.575847
6937,45,468,28,53,480,1074,2022-03-21 08:48:18.782351
6951,385,37325,212,217,4953,43092,2022-03-21 08:48:26.73306
6954,1881,71614,1025,498,30192,105210,2022-03-21 08:48:32.928256
6956,16622,243790,11221,11825,115381,398839,2022-03-21 08:48:33.405295
6965,23,244,10,47,164,488,2022-03-21 08:48:36.554441
6970,50,245,40,102,404,841,2022-03-21 08:48:38.290592
6971,120,618,124,184,1082,2128,2022-03-21 08:48:41.145328
6973,3046,12767,2748,3649,20233,42443,2022-03-21 08:48:41.417834
6974,5482,48860,3924,5455,32664,96385,2022-03-21 08:48:41.593365
6975,100,492,80,90,1938,2700,2022-03-21 08:48:41.949953
7021,15,551,7,38,130,741,2022-03-21 08:48:45.115572
7192,38,663,25,50,605,1381,2022-03-21 08:48:54.751275
7330,37,1202,30,70,649,1988,2022-03-21 08:49:00.63624
7363,102,2116,51,83,1198,3550,2022-03-21 08:49:01.792935
7518,9,1151,6,44,179,1389,2022-03-21 08:49:11.457415
7575,76,219,69,102,602,1068,2022-03-21 08:49:15.280103
7591,87,2397,48,110,1121,3763,2022-03-21 08:49:16.385331
7605,25,266,17,103,123,534,2022-03-21 08:49:19.529044
7752,28,254,13,46,198,539,2022-03-21 08:49:33.948634
7759,132,2098,112,124,1730,4196,2022-03-21 08:49:34.393397
7761,111,933,133,144,910,2231,2022-03-21 08:49:34.843431
7762,3484,13219,1619,861,10063,29246,2022-03-21 08:49:37.472027
7768,1920,19757,1603,2660,16071,42011,2022-03-21 08:49:40.27226
7769,12592,159079,7321,8504,70518,258014,2022-03-21 08:49:43.419384
7771,16,321,5,59,166,567,2022-03-21 08:49:46.028221
7774,191,4430,120,102,2588,7431,2022-03-21 08:49:50.198323
7781,73,120,54,87,2889,3223,2022-03-21 08:49:55.742564
7955,35,272,28,96,330,761,2022-03-21 08:50:05.189307
7960,61,119,28,66,505,779,2022-03-21 08:50:07.857205
7967,23,174,14,45,426,682,2022-03-21 08:50:09.564057
7972,109,4236,84,87,2261,6777,2022-03-21 08:50:14.778896
7980,17,152,14,99,136,418,2022-03-21 08:50:15.129919
7981,20,251,20,94,134,519,2022-03-21 08:50:15.402967
7982,22,103,6,52,419,602,2022-03-21 08:50:16.231789
8038,649,30504,367,214,8978,40712,2022-03-21 08:50:21.199462
8041,42,215,49,151,377,834,2022-03-21 08:50:23.530397
8042,48,575,29,53,738,1443,2022-03-21 08:50:25.98656
8057,796,11020,528,475,6536,19355,2022-03-21 08:50:27.721151
8062,112,3647,67,59,1819,5704,2022-03-21 08:50:27.895061
8079,56,603,32,62,627,1380,2022-03-21 08:50:29.121481
8108,37,1024,27,71,642,1801,2022-03-21 08:50:30.438233
8132,54,991,47,152,841,2085,2022-03-21 08:50:35.712408
8134,74,2015,51,78,1000,3218,2022-03-21 08:50:38.916205
8139,43,408,20,94,191,756,2022-03-21 08:50:39.142478
8140,41,802,44,119,211,1217,2022-03-21 08:50:42.562852
8142,3480,96154,1604,906,71403,173547,2022-03-21 08:50:44.596437
8143,13,53,9,73,131,279,2022-03-21 08:50:45.071283
8145,45,457,36,64,447,1049,2022-03-21 08:50:46.986357
8146,54,453,32,58,444,1041,2022-03-21 08:50:47.335447
8154,30,261,23,66,352,732,2022-03-21 08:50:48.189189
8235,107,1083,84,191,779,2244,2022-03-21 08:50:55.201889
8310,5483,35946,3077,2090,17681,64277,2022-03-21 08:50:58.821475
8360,60,3013,40,105,653,3871,2022-03-21 08:51:05.273505
8361,60,2515,37,110,643,3365,2022-03-21 08:51:08.616408
8362,79,5462,41,109,624,6315,2022-03-21 08:51:08.802817
8363,64,3142,35,89,603,3933,2022-03-21 08:51:09.072893
8369,75,4199,41,113,639,5067,2022-03-21 08:51:10.117786
8408,3112,128357,1889,838,25216,159412,2022-03-21 08:51:15.11591
8409,67,288,53,78,481,967,2022-03-21 08:51:17.585171
8417,15,130,11,77,130,363,2022-03-21 08:51:21.033919
8526,46,1372,15,37,590,2060,2022-03-21 08:51:29.380464
8554,41,481,27,76,517,1142,2022-03-21 08:51:31.524959
8619,335,7043,185,165,3276,11004,2022-03-21 08:51:34.098078
8632,73,598,58,104,1397,2230,2022-03-21 08:51:35.052593
8647,17,679,5,27,111,839,2022-03-21 08:51:37.628005
8666,344,6637,205,225,3429,10840,2022-03-21 08:51:43.687542
8667,10,335,5,30,115,495,2022-03-21 08:51:43.95459
8671,8,257,5,31,65,366,2022-03-21 08:51:47.307173
8675,23584,258829,14408,15690,133013,445524,2022-03-21 08:51:50.616832
8676,19476,174038,13126,18714,112828,338182,2022-03-21 08:51:53.292112
8678,31,276,11,38,270,626,2022-03-21 08:51:55.544966
8689,39,1690,12,55,626,2422,2022-03-21 08:51:59.714968
8696,11,271,4,29,75,390,2022-03-21 08:51:59.940821
8697,8,356,5,27,70,466,2022-03-21 08:52:03.422267
8710,31,633,14,32,210,920,2022-03-21 08:52:04.848984
8740,1031,63872,408,338,8151,73800,2022-03-21 08:52:09.826042
8745,30,317,16,44,327,734,2022-03-21 08:52:14.754272
8749,7,102,5,37,74,225,2022-03-21 08:52:15.905014
8753,37,224,21,104,213,599,2022-03-21 08:52:19.688072
8899,28,220,28,101,286,663,2022-03-21 08:52:27.285156
8920,62,716,22,39,791,1630,2022-03-21 08:52:28.50545
8937,16729,301516,10397,7821,81006,417469,2022-03-21 08:52:32.668908
23979,19,44,8,46,213,330,2022-03-21 09:13:00.917683
9001,102,4513,48,52,2324,7039,2022-03-21 08:52:41.994512
9005,207,2223,136,107,1833,4506,2022-03-21 08:52:42.451158
9043,79,304,50,70,775,1278,2022-03-21 08:52:44.154739
9062,39492,167186,10257,4196,32481,253612,2022-03-21 08:52:45.630862
9135,2150,127714,1521,878,36877,169140,2022-03-21 08:52:49.189691
9200,66,997,49,86,520,1718,2022-03-21 08:52:51.592242
9242,27,396,19,60,295,797,2022-03-21 08:52:57.083068
9244,21,323,16,56,217,633,2022-03-21 08:52:57.54409
9252,531,48260,305,220,7378,56694,2022-03-21 08:52:57.980949
9292,11,158,8,45,168,390,2022-03-21 08:53:02.500201
9330,6739,111932,4080,7391,31677,161819,2022-03-21 08:53:06.329552
9343,17,118,10,41,219,405,2022-03-21 08:53:17.434938
9346,214,1735,104,244,1308,3605,2022-03-21 08:53:18.407938
9361,24,1322,10,35,234,1625,2022-03-21 08:53:21.535603
9362,698,15899,431,314,5295,22637,2022-03-21 08:53:21.745464
9393,184,2086,167,153,1643,4233,2022-03-21 08:53:27.265382
9395,78,649,63,156,521,1467,2022-03-21 08:53:29.693241
9396,244,13483,154,123,3374,17378,2022-03-21 08:53:29.873935
9403,27,219,17,64,298,625,2022-03-21 08:53:31.984043
9438,40,193,52,123,306,714,2022-03-21 08:53:33.65965
9464,14,108,8,40,140,310,2022-03-21 08:53:34.907063
9494,112,1132,47,112,1456,2859,2022-03-21 08:53:36.097779
9502,9,800,4,31,108,952,2022-03-21 08:53:39.352733
9518,26,119,19,61,301,526,2022-03-21 08:53:42.241081
9539,3336,28563,2602,4991,9460,48952,2022-03-21 08:53:47.724061
9546,18,71,4,57,183,333,2022-03-21 08:53:52.557466
9547,121,3654,63,129,843,4810,2022-03-21 08:53:52.767701
9548,42,1170,28,74,377,1691,2022-03-21 08:53:53.04376
9549,44,1201,31,75,375,1726,2022-03-21 08:53:57.289014
9558,20,174,8,45,170,417,2022-03-21 08:53:57.633171
9561,56,1010,30,83,430,1609,2022-03-21 08:53:57.976003
9624,2768,31140,1608,3120,19759,58395,2022-03-21 08:54:01.58874
9749,20,64,3,42,109,238,2022-03-21 08:54:10.975933
9834,4411,44141,3666,5143,30650,88011,2022-03-21 08:54:18.040335
9895,21,1133,12,51,263,1480,2022-03-21 08:54:23.073221
9911,386,11664,213,396,4446,17105,2022-03-21 08:54:25.237702
10000,18,136,8,54,175,391,2022-03-21 08:54:39.500612
10003,154,1999,80,85,2604,4922,2022-03-21 08:54:42.784925
10005,35,398,16,59,419,927,2022-03-21 08:54:42.953682
10012,8302,105090,5585,3958,54106,177041,2022-03-21 08:54:43.219273
10013,51,615,32,58,752,1508,2022-03-21 08:54:45.441021
10014,330,1394,382,464,2766,5336,2022-03-21 08:54:45.621064
10045,25,118,16,59,344,562,2022-03-21 08:54:50.075698
10048,132,2825,70,138,1588,4753,2022-03-21 08:54:52.823373
10049,6814,106468,3790,2713,30140,149925,2022-03-21 08:54:53.000701
10055,56,1161,45,69,928,2259,2022-03-21 08:54:56.058447
10076,1175,46151,574,535,8350,56785,2022-03-21 08:55:00.79677
10109,1330,9676,966,2085,8903,22960,2022-03-21 08:55:03.003639
10116,54,3010,43,84,585,3776,2022-03-21 08:55:07.240254
10191,1572,11310,1192,1377,12805,28256,2022-03-21 08:55:11.27037
10313,25,423,24,53,330,855,2022-03-21 08:55:21.877053
10319,48,307,36,88,486,965,2022-03-21 08:55:24.929666
10355,37,573,17,52,624,1303,2022-03-21 08:55:35.796991
10357,10303,65804,8222,7594,82155,174078,2022-03-21 08:55:36.276476
10390,177,3854,153,232,3252,7668,2022-03-21 08:55:43.560864
10391,133,5504,106,121,3196,9060,2022-03-21 08:55:43.830233
10444,636,18433,519,637,4772,24997,2022-03-21 08:55:46.122088
10477,228,8485,188,155,3773,12829,2022-03-21 08:55:51.64949
10479,764,11469,508,380,8410,21531,2022-03-21 08:55:52.114839
10481,34,263,20,53,432,802,2022-03-21 08:55:55.966969
10483,139,4248,97,92,2477,7053,2022-03-21 08:55:56.145215
10495,15705,172427,10922,12017,100478,311549,2022-03-21 08:56:03.715897
10500,298,11716,192,100,6686,18992,2022-03-21 08:56:08.303875
10506,108,0,23,216,283,630,2022-03-21 08:56:14.258504
10507,2480,56314,1416,2471,6296,68977,2022-03-21 08:56:17.082093
10511,51,455,20,54,570,1150,2022-03-21 08:56:21.075479
10513,50,2146,25,99,371,2691,2022-03-21 08:56:21.272643
10521,6836,186847,4053,2803,42902,243441,2022-03-21 08:56:24.835969
10524,60,507,32,126,519,1244,2022-03-21 08:56:30.455572
10527,69,1138,37,148,673,2065,2022-03-21 08:56:36.616217
10528,77,1005,36,154,622,1894,2022-03-21 08:56:36.815894
10532,296,8771,190,170,4328,13755,2022-03-21 08:56:41.284447
10534,167,8821,64,178,893,10123,2022-03-21 08:56:44.665486
10536,1125,28394,843,376,12828,43566,2022-03-21 08:56:44.86624
10539,19,110,13,59,162,363,2022-03-21 08:56:48.980329
10540,48,182,43,90,567,930,2022-03-21 08:56:49.162397
10671,947,13040,622,1061,6952,22622,2022-03-21 08:57:00.114959
10679,68,2567,54,97,1215,4001,2022-03-21 08:57:00.829253
10693,128,1661,89,115,2162,4155,2022-03-21 08:57:11.06735
10701,29,317,14,54,184,598,2022-03-21 08:57:12.913003
10705,17,111,9,63,192,392,2022-03-21 08:57:17.906596
10709,24,83,15,68,199,389,2022-03-21 08:57:21.610079
10710,53,1076,40,63,1117,2349,2022-03-21 08:57:22.101581
10711,4946,120800,1760,1341,53603,182450,2022-03-21 08:57:22.272853
10713,573,27101,320,170,7933,36097,2022-03-21 08:57:22.537396
10716,517,23890,287,158,7840,32692,2022-03-21 08:57:28.869707
10718,35,379,24,30,425,893,2022-03-21 08:57:35.93819
10719,24915,540900,12690,18185,135729,732419,2022-03-21 08:57:40.186388
10720,22,2023,9,28,361,2443,2022-03-21 08:57:42.211018
10721,17152,113871,14003,11868,117454,274348,2022-03-21 08:57:42.692745
26269,12,39,5,47,116,219,2022-03-21 09:15:39.406291
10731,176,7374,104,136,2384,10174,2022-03-21 08:57:45.80995
10735,63,963,64,91,924,2105,2022-03-21 08:57:46.629414
10905,105,2024,83,100,1423,3735,2022-03-21 08:57:58.230109
10923,138,4687,84,89,1787,6785,2022-03-21 08:57:59.321505
10937,9049,25091,2999,949,23381,61469,2022-03-21 08:58:04.240334
10941,14,653,6,23,88,784,2022-03-21 08:58:07.005729
10947,135,2868,127,128,2699,5957,2022-03-21 08:58:10.839761
10950,135,2064,144,160,2662,5165,2022-03-21 08:58:15.72207
10954,58,1335,30,43,661,2127,2022-03-21 08:58:20.207162
10958,281,4710,147,405,2266,7809,2022-03-21 08:58:20.705725
10964,36,246,19,50,331,682,2022-03-21 08:58:20.97388
10965,23,130,18,74,144,389,2022-03-21 08:58:23.424642
10967,37,197,13,64,342,653,2022-03-21 08:58:23.765727
11017,112,767,62,164,789,1894,2022-03-21 08:58:25.710548
11245,33,126,24,67,205,455,2022-03-21 08:58:33.485273
11255,556,8849,320,229,6685,16639,2022-03-21 08:58:33.692319
11266,1873,98118,910,490,22610,124001,2022-03-21 08:58:37.303872
11268,56,334,82,130,348,950,2022-03-21 08:58:37.564455
11307,32,593,26,78,258,987,2022-03-21 08:58:38.884281
11313,1566,24457,775,610,12864,40272,2022-03-21 08:58:44.623907
11339,452,15676,283,187,4610,21208,2022-03-21 08:58:44.980212
11341,808,9828,704,652,5327,17319,2022-03-21 08:58:48.441996
11355,428,16614,190,256,7455,24943,2022-03-21 08:58:52.089704
11371,2100,39740,1364,1409,11202,55815,2022-03-21 08:58:52.89442
11389,11,178,10,49,94,342,2022-03-21 08:58:54.700274
11405,30,142,28,101,176,477,2022-03-21 08:58:56.253472
11411,58,1032,33,46,821,1990,2022-03-21 08:58:58.44093
11421,13,112,13,72,127,337,2022-03-21 08:58:59.731912
11433,13996,208657,8900,10214,107809,349576,2022-03-21 08:59:02.142447
11441,968,15929,648,421,7191,25157,2022-03-21 08:59:02.430075
11447,37,1183,11,58,487,1776,2022-03-21 08:59:04.754661
11457,1840,5043,1294,2192,3837,14206,2022-03-21 08:59:04.920247
11471,96,2325,70,143,1397,4031,2022-03-21 08:59:10.042954
11483,186,6110,73,102,2515,8986,2022-03-21 08:59:12.710428
11487,68,5515,30,39,745,6397,2022-03-21 08:59:12.882845
11561,25,606,8,40,331,1010,2022-03-21 08:59:19.065096
11597,24618,493330,11790,6744,129281,665763,2022-03-21 08:59:20.632519
11633,26570,433453,16876,21696,123248,621843,2022-03-21 08:59:21.590211
11679,42,5524,12,76,658,6312,2022-03-21 08:59:26.266272
11681,13,43,5,52,85,198,2022-03-21 08:59:28.766011
11685,41,890,21,38,327,1317,2022-03-21 08:59:30.815958
11687,36,4269,9,54,408,4776,2022-03-21 08:59:33.241314
11689,15,2111,5,60,169,2360,2022-03-21 08:59:33.415999
11693,21,386,6,55,207,675,2022-03-21 08:59:35.050419
11695,24,178,17,87,211,517,2022-03-21 08:59:36.447839
11697,5208,37321,4154,6001,15381,68065,2022-03-21 08:59:36.621934
11701,1533,149605,881,500,22626,175145,2022-03-21 08:59:40.266334
11703,14812,191093,9343,17065,67090,299403,2022-03-21 08:59:40.5016
11711,8,42,4,48,55,157,2022-03-21 08:59:42.659042
11713,9,43,4,51,79,186,2022-03-21 08:59:44.199801
11717,27,1459,19,38,410,1953,2022-03-21 08:59:48.408118
11729,25,722,4,33,149,933,2022-03-21 08:59:50.368118
11731,13,66,7,50,92,228,2022-03-21 08:59:51.455836
11791,21,248,5,61,132,467,2022-03-21 08:59:57.926532
11793,140,5276,151,94,2748,8409,2022-03-21 08:59:58.140531
11795,21,961,5,32,171,1190,2022-03-21 08:59:58.399881
11829,48,346,22,74,238,728,2022-03-21 09:00:03.368223
11841,64,463,31,92,487,1137,2022-03-21 09:00:06.704909
11843,44884,433606,30948,19930,188364,717732,2022-03-21 09:00:07.141167
11853,77,3027,93,125,1688,5010,2022-03-21 09:00:07.315164
11857,25,122,18,81,217,463,2022-03-21 09:00:09.796453
11859,2162,17270,1179,1821,15852,38284,2022-03-21 09:00:09.974155
11867,185,6332,94,121,3547,10279,2022-03-21 09:00:13.354316
11883,12,2030,5,50,134,2231,2022-03-21 09:00:19.043996
11887,32634,466234,20273,19698,212547,751386,2022-03-21 09:00:19.516987
11889,332,15089,211,158,5642,21432,2022-03-21 09:00:22.65509
11897,17,2506,8,57,190,2778,2022-03-21 09:00:24.092339
11911,125,1408,99,145,942,2719,2022-03-21 09:00:24.296271
11915,26,2069,12,68,246,2421,2022-03-21 09:00:28.656424
12121,87,3200,41,108,787,4223,2022-03-21 09:00:33.485757
12341,13,167,9,48,110,347,2022-03-21 09:00:40.725983
12447,496,5726,591,482,4039,11334,2022-03-21 09:00:47.852967
12467,13419,150509,8024,14519,73216,259687,2022-03-21 09:00:49.00419
12709,211,3235,170,102,2266,5984,2022-03-21 09:00:56.280549
12753,2400,28198,2203,2027,10967,45795,2022-03-21 09:01:00.277376
12755,38,1184,12,35,378,1647,2022-03-21 09:01:00.491181
12763,31,207,49,153,336,776,2022-03-21 09:01:02.609909
12859,3451,199266,798,560,20055,224130,2022-03-21 09:01:05.909773
12971,21,221,9,41,235,527,2022-03-21 09:01:12.029719
13089,10,324,7,34,108,483,2022-03-21 09:01:14.357721
13167,16,82,7,73,126,304,2022-03-21 09:01:22.615455
13195,10,373,3,25,80,491,2022-03-21 09:01:24.222903
13497,16,83,9,60,195,363,2022-03-21 09:01:34.84043
13655,16650,116755,13326,15703,105834,268268,2022-03-21 09:01:43.587666
13659,11764,319042,5674,9577,55020,401077,2022-03-21 09:01:43.750166
13727,212,4904,148,113,3310,8687,2022-03-21 09:01:46.049879
13781,16,122,5,50,145,338,2022-03-21 09:01:52.595747
13789,28,695,5,30,232,990,2022-03-21 09:01:54.637315
29383,8,43,8,46,62,167,2022-03-21 09:18:09.319293
13799,106,6212,104,131,2014,8567,2022-03-21 09:01:58.201954
13807,1953,100113,805,741,25786,129398,2022-03-21 09:01:58.37948
13969,25,1501,14,44,372,1956,2022-03-21 09:02:04.532719
13983,31,789,16,51,467,1354,2022-03-21 09:02:05.019484
14059,49,758,46,63,736,1652,2022-03-21 09:02:06.233722
14131,11696,160265,7405,10045,74753,264164,2022-03-21 09:02:11.018653
14145,602,8328,249,298,4975,14452,2022-03-21 09:02:11.217669
14173,295,10889,143,112,3179,14618,2022-03-21 09:02:11.482344
14189,1106,57084,515,238,13640,72583,2022-03-21 09:02:12.304601
14645,1967,33730,1381,1755,10514,49347,2022-03-21 09:02:25.032695
14647,165,3302,113,130,1790,5500,2022-03-21 09:02:28.162018
14663,341,9258,180,175,3703,13657,2022-03-21 09:02:34.986078
14675,102,1297,74,88,1371,2932,2022-03-21 09:02:35.611061
14685,139,2758,114,101,1508,4620,2022-03-21 09:02:35.778672
14735,387,28848,193,232,4076,33736,2022-03-21 09:02:39.461828
14741,47322,856739,27127,29909,229385,1190482,2022-03-21 09:02:39.82771
14743,7,345,3,20,69,444,2022-03-21 09:02:40.001076
14749,22089,329502,10733,15274,112274,489872,2022-03-21 09:02:40.512533
14807,2550,60819,1166,453,36932,101920,2022-03-21 09:02:41.293876
14875,224,6185,174,139,3474,10196,2022-03-21 09:02:43.763365
15061,5418,10169,3389,4142,14953,38071,2022-03-21 09:02:47.200547
15201,1363,59898,878,493,30259,92891,2022-03-21 09:02:51.101188
15291,164,6195,51,129,1175,7714,2022-03-21 09:02:52.227069
15399,25,85,11,45,228,394,2022-03-21 09:02:54.586535
15451,22726,713395,8801,11327,54284,810533,2022-03-21 09:03:00.235996
15455,23,646,6,44,206,925,2022-03-21 09:03:03.533862
15479,30,109,17,60,165,381,2022-03-21 09:03:05.900285
15489,1722,23029,1265,1573,6710,34299,2022-03-21 09:03:11.292196
15505,127,1080,116,104,848,2275,2022-03-21 09:03:13.491433
15525,10,322,6,43,112,493,2022-03-21 09:03:15.118701
15579,47,122,32,70,520,791,2022-03-21 09:03:16.654605
15609,835,32821,401,236,8393,42686,2022-03-21 09:03:17.795713
15653,13,228,6,35,80,362,2022-03-21 09:03:19.25391
15743,28,352,21,40,319,760,2022-03-21 09:03:22.967505
15751,4365,64497,2300,3200,34966,109328,2022-03-21 09:03:25.044615
15787,36,137,21,90,397,681,2022-03-21 09:03:26.223491
15815,14,175,12,54,168,423,2022-03-21 09:03:28.890605
15819,74,757,59,66,859,1815,2022-03-21 09:03:29.187202
15963,469,14667,236,142,5728,21242,2022-03-21 09:03:37.293708
15977,6,163,8,47,58,282,2022-03-21 09:03:39.328429
15979,128,2305,102,169,2436,5140,2022-03-21 09:03:39.697522
16023,384,5252,142,248,3777,9803,2022-03-21 09:03:41.294928
16347,51,1460,33,85,318,1947,2022-03-21 09:03:48.364823
16460,18,121,8,60,143,350,2022-03-21 09:03:54.710518
16468,417,19536,298,197,4896,25344,2022-03-21 09:03:55.248508
16554,8,85,8,48,91,240,2022-03-21 09:03:58.020531
16602,17,1894,9,58,178,2156,2022-03-21 09:04:02.684999
16604,21,2730,5,43,220,3019,2022-03-21 09:04:06.707786
16606,27,2553,7,47,190,2824,2022-03-21 09:04:08.776853
16608,114,17912,38,153,1065,19282,2022-03-21 09:04:11.785345
16610,20,3926,7,50,278,4281,2022-03-21 09:04:11.964004
16776,18,74,11,49,194,346,2022-03-21 09:04:18.212851
16806,11,89,5,46,90,241,2022-03-21 09:04:20.581016
43401,0,7,1,7,13,28,2022-03-21 11:29:21.860191
17161,20,259,10,63,162,514,2022-03-21 09:04:35.059622
17163,19,236,10,65,160,490,2022-03-21 09:04:35.43158
17215,14,120,8,66,85,293,2022-03-21 09:04:37.27612
17247,15283,193945,8087,10814,68745,296874,2022-03-21 09:04:38.531778
17273,441,11533,267,261,4767,17269,2022-03-21 09:04:42.674426
17277,376,5308,428,429,6816,13357,2022-03-21 09:04:43.151824
17291,48,253,27,87,276,691,2022-03-21 09:04:47.72509
17295,33,253,17,49,293,645,2022-03-21 09:04:50.108832
17307,15,92,11,57,143,318,2022-03-21 09:04:50.308541
17313,9,86,2,55,85,237,2022-03-21 09:04:51.834438
17317,7,64,2,56,72,201,2022-03-21 09:04:54.178247
17395,216,5007,91,114,2743,8171,2022-03-21 09:04:56.594109
17613,14,103,6,66,131,320,2022-03-21 09:05:06.2553
17615,31,189,19,48,390,677,2022-03-21 09:05:08.074703
17703,51,128,47,145,529,900,2022-03-21 09:05:15.97072
17705,191,1684,148,288,1342,3653,2022-03-21 09:05:16.167597
17707,62,394,57,133,699,1345,2022-03-21 09:05:20.63698
17717,130,6297,79,91,1804,8401,2022-03-21 09:05:24.656068
17725,408,24000,286,181,4598,29473,2022-03-21 09:05:25.721101
17729,25064,366801,12049,17038,120971,541923,2022-03-21 09:05:26.119195
17753,22,160,9,43,199,433,2022-03-21 09:05:28.822687
17813,272,8943,141,149,2361,11866,2022-03-21 09:05:32.428479
17815,65,3545,34,54,538,4236,2022-03-21 09:05:32.892796
43405,0,9,2,6,9,26,2022-03-21 11:29:27.531926
17947,293,4882,136,120,6937,12368,2022-03-21 09:05:36.940679
17961,28,361,20,78,401,888,2022-03-21 09:05:38.295594
18053,360,4730,268,189,4199,9746,2022-03-21 09:05:44.262856
18055,2394,39355,1297,1109,14586,58741,2022-03-21 09:05:47.706555
18115,33090,541873,17231,13093,145229,750516,2022-03-21 09:05:54.551896
18133,38,491,7,83,158,777,2022-03-21 09:05:59.902143
18155,71,183,57,116,336,763,2022-03-21 09:06:08.409794
18177,294,13475,149,160,3802,17880,2022-03-21 09:06:11.383087
18179,15111,129150,10000,9069,44698,208028,2022-03-21 09:06:11.585636
18191,18,92,17,74,128,329,2022-03-21 09:06:14.359301
43406,0,9,2,5,9,25,2022-03-21 11:29:28.487581
18323,11,70,3,47,61,192,2022-03-21 09:06:19.476644
18391,90,964,65,124,622,1865,2022-03-21 09:06:24.630661
18393,1649,97513,696,508,15777,116143,2022-03-21 09:06:24.847584
18397,14334,321708,6678,2546,47329,392595,2022-03-21 09:06:25.357033
18411,2835,27481,2183,3247,17817,53563,2022-03-21 09:06:28.639612
18637,28,404,22,75,407,936,2022-03-21 09:06:43.576106
18639,117,1373,80,67,1372,3009,2022-03-21 09:06:44.057059
18643,26,259,13,34,218,550,2022-03-21 09:06:45.475277
18661,6051,86329,1182,520,16978,111060,2022-03-21 09:06:45.961457
18669,30,650,31,55,499,1265,2022-03-21 09:06:47.90865
18671,22951,502564,14402,13213,98144,651274,2022-03-21 09:06:48.258817
43411,0,13,2,6,9,30,2022-03-21 11:29:30.70935
18677,15698,162654,7904,12246,74742,273244,2022-03-21 09:06:52.975347
18679,101554,982650,73531,81544,278978,1518257,2022-03-21 09:06:56.506653
18689,23670,113249,14963,10264,52379,214525,2022-03-21 09:06:57.592359
18703,20,131,5,43,188,387,2022-03-21 09:06:57.956248
18795,22,456,12,50,157,697,2022-03-21 09:07:00.3152
43434,0,0,0,0,1900,1900,2022-03-21 11:29:48.528631
18939,13,97,11,78,93,292,2022-03-21 09:07:04.116477
19165,642,6354,542,505,11860,19903,2022-03-21 09:07:10.016456
19191,753,32002,401,220,13668,47044,2022-03-21 09:07:11.189027
19211,895,29707,574,288,6719,38183,2022-03-21 09:07:15.833243
19213,17,838,10,32,228,1125,2022-03-21 09:07:16.030889
19237,12,530,6,22,91,661,2022-03-21 09:07:17.346617
19279,25,646,9,38,220,938,2022-03-21 09:07:18.436714
19285,2276,99345,915,1027,19858,123421,2022-03-21 09:07:20.110792
19431,185,3533,74,86,1297,5175,2022-03-21 09:07:27.501583
19433,11,114,5,65,89,284,2022-03-21 09:07:29.166972
19445,28,85,15,114,167,409,2022-03-21 09:07:31.843802
19447,95,898,82,118,1112,2305,2022-03-21 09:07:32.116393
19653,2021,23980,628,443,19738,46810,2022-03-21 09:07:37.905014
19831,25,107,17,63,232,444,2022-03-21 09:07:53.10766
19849,23,183,19,75,227,527,2022-03-21 09:07:54.050855
19917,12,85,5,57,107,266,2022-03-21 09:07:56.573918
19971,20,189,6,52,212,479,2022-03-21 09:07:59.072164
19987,21,76,12,80,110,299,2022-03-21 09:08:00.215158
20423,348,20682,244,149,5971,27394,2022-03-21 09:08:16.454016
20449,1108,60552,553,475,18562,81250,2022-03-21 09:08:21.996346
20541,16362,213518,8351,8041,108265,354537,2022-03-21 09:08:24.862588
20871,209,6634,148,191,2472,9654,2022-03-21 09:08:34.307434
21075,168,6152,113,117,3011,9561,2022-03-21 09:08:45.82406
21077,99,1497,76,133,1334,3139,2022-03-21 09:08:50.065341
21081,25,473,11,48,167,724,2022-03-21 09:08:53.226608
21085,16078,183851,7802,11763,68069,287563,2022-03-21 09:08:56.790886
21089,22,623,8,27,209,889,2022-03-21 09:08:56.985913
21099,17,104,8,49,196,374,2022-03-21 09:08:57.600787
21101,11,67,3,43,91,215,2022-03-21 09:08:59.432464
21105,8149,179541,3602,7441,33721,232454,2022-03-21 09:08:59.882543
21107,36,410,10,29,234,719,2022-03-21 09:09:03.240256
21121,20,102,9,42,207,380,2022-03-21 09:09:04.97373
21129,17,158,9,57,191,432,2022-03-21 09:09:06.306477
21167,3870,27069,3062,6032,17883,57916,2022-03-21 09:09:11.820858
21177,8509,40379,6203,13035,25839,93965,2022-03-21 09:09:12.022847
21185,6991,85165,4941,5485,33375,135957,2022-03-21 09:09:20.000731
21189,469,15558,224,204,5623,22078,2022-03-21 09:09:20.474347
21195,864,11881,582,551,10557,24435,2022-03-21 09:09:23.678004
21431,13582,198663,7481,11960,77291,308977,2022-03-21 09:09:28.954885
21523,59,1255,38,140,483,1975,2022-03-21 09:09:36.656016
21539,13,130,10,92,135,380,2022-03-21 09:09:37.207963
21647,9080,196044,3126,1378,116067,325695,2022-03-21 09:09:41.042006
21671,421,4708,389,655,2212,8385,2022-03-21 09:09:45.464164
43514,0,13,1,7,11,32,2022-03-21 11:30:23.593466
21713,23,152,15,61,132,383,2022-03-21 09:09:47.028778
21797,1843,59944,1232,780,16271,80070,2022-03-21 09:09:52.257173
21821,1858,10183,1027,3228,8641,24937,2022-03-21 09:09:52.648004
21891,12,266,3,21,51,353,2022-03-21 09:09:55.551227
21939,14173,130016,6932,2978,110328,264427,2022-03-21 09:10:00.271674
21959,14,113,7,63,77,274,2022-03-21 09:10:02.256709
21969,12,117,5,65,83,282,2022-03-21 09:10:03.017621
22059,12,428,2,18,94,554,2022-03-21 09:10:13.343256
22065,14,112,10,65,98,299,2022-03-21 09:10:15.183778
22071,573,33212,303,139,7467,41694,2022-03-21 09:10:15.406662
22093,13,307,3,22,59,404,2022-03-21 09:10:20.238222
22097,7972,78216,3491,1804,25558,117041,2022-03-21 09:10:20.58702
22125,534,34599,290,234,7772,43429,2022-03-21 09:10:21.721744
22159,11,337,9,37,90,484,2022-03-21 09:10:22.848358
22171,11,260,3,27,78,379,2022-03-21 09:10:33.552684
22173,10,724,6,34,109,883,2022-03-21 09:10:35.124428
22175,15,325,7,34,95,476,2022-03-21 09:10:36.796952
22177,15,893,12,40,209,1169,2022-03-21 09:10:36.973718
22189,2640,19202,1785,3387,15789,42803,2022-03-21 09:10:39.037159
22199,78762,1392578,33284,55655,236329,1796608,2022-03-21 09:10:39.469896
22241,12,190,12,76,190,480,2022-03-21 09:10:42.701808
22247,22,106,17,62,205,412,2022-03-21 09:10:45.458082
22249,58,1615,21,49,716,2459,2022-03-21 09:10:45.893436
22255,16,675,4,39,116,850,2022-03-21 09:10:47.405119
22265,20684,281715,12039,11243,48786,374467,2022-03-21 09:10:50.818694
22271,24,112,9,56,220,421,2022-03-21 09:10:52.451065
22273,6418,74538,4084,6961,47344,139345,2022-03-21 09:10:55.200374
22279,11,43,5,64,84,207,2022-03-21 09:10:59.143164
22335,113,7134,62,94,1419,8822,2022-03-21 09:11:00.798682
22421,9,74,7,38,81,209,2022-03-21 09:11:03.171762
22473,11,203,3,34,47,298,2022-03-21 09:11:08.578317
22479,11,194,8,43,118,374,2022-03-21 09:11:11.004041
22481,15,194,6,45,105,365,2022-03-21 09:11:11.273468
22585,34,36,6,90,98,264,2022-03-21 09:11:19.776493
22591,30,206,24,87,390,737,2022-03-21 09:11:22.58223
22603,13,269,6,66,147,501,2022-03-21 09:11:26.99362
22605,13,147,6,50,103,319,2022-03-21 09:11:28.195701
22611,9,206,8,59,127,409,2022-03-21 09:11:30.90884
22615,10,133,6,41,92,282,2022-03-21 09:11:33.463563
22617,9,116,5,44,87,261,2022-03-21 09:11:34.637693
22619,9,104,7,43,84,247,2022-03-21 09:11:36.311116
22621,11,153,9,62,114,349,2022-03-21 09:11:37.362221
22847,197,5788,132,180,2898,9195,2022-03-21 09:11:50.694235
22975,15,141,10,72,129,367,2022-03-21 09:11:53.059195
22991,9,85,5,68,72,239,2022-03-21 09:11:54.116049
23005,13,102,9,77,133,334,2022-03-21 09:11:55.344998
23229,131,512,77,142,1433,2295,2022-03-21 09:12:03.642195
23233,29113,429344,12434,24790,91880,587561,2022-03-21 09:12:07.311075
23237,1322,45375,956,512,13852,62017,2022-03-21 09:12:07.534916
23249,418,6208,198,157,5308,12289,2022-03-21 09:12:14.907745
43545,0,12,1,6,10,29,2022-03-21 11:30:36.867072
23267,18,346,9,56,97,526,2022-03-21 09:12:19.068063
23299,82,4839,81,118,1376,6496,2022-03-21 09:12:21.225588
23317,5520,158241,2173,1695,48923,216552,2022-03-21 09:12:22.667402
23341,987,17131,735,788,6040,25681,2022-03-21 09:12:23.626331
43552,0,9,1,6,11,27,2022-03-21 11:30:39.143555
23459,445,12649,217,115,5437,18863,2022-03-21 09:12:32.188639
23487,629,6560,416,277,5628,13510,2022-03-21 09:12:32.664392
23499,175,839,167,103,1086,2370,2022-03-21 09:12:34.930688
23551,449,8092,241,394,2770,11946,2022-03-21 09:12:36.247641
23727,9,38,4,38,61,150,2022-03-21 09:12:45.83757
23849,127,4216,139,185,2442,7109,2022-03-21 09:12:50.64838
23867,7,66,6,59,60,198,2022-03-21 09:12:51.746248
23917,11,240,3,21,56,331,2022-03-21 09:12:54.125964
23975,17,219,8,40,143,427,2022-03-21 09:13:00.703845
24029,422,7215,180,151,3490,11458,2022-03-21 09:13:07.863429
24041,12,49,7,70,74,212,2022-03-21 09:13:13.983587
24047,18,149,9,32,90,298,2022-03-21 09:13:14.438797
24075,4416,44518,3565,5828,22749,81076,2022-03-21 09:13:15.661778
24151,3054,104000,1533,604,20416,129607,2022-03-21 09:13:20.240383
24489,23,96,6,38,174,337,2022-03-21 09:13:28.71732
24629,5272,30361,4110,7454,27544,74741,2022-03-21 09:13:33.721085
24633,15,290,4,25,99,433,2022-03-21 09:13:33.922772
24645,20,203,9,66,207,505,2022-03-21 09:13:40.86304
24647,19,188,5,68,143,423,2022-03-21 09:13:42.571291
24675,29,354,14,77,255,729,2022-03-21 09:13:48.942552
24681,12,134,4,45,122,317,2022-03-21 09:13:53.416911
24687,1796,58285,791,389,27648,88909,2022-03-21 09:13:58.208311
24701,12256,115658,5741,2769,95618,232042,2022-03-21 09:13:59.009432
24785,6,217,7,43,57,330,2022-03-21 09:14:02.10818
24857,9,82,16,88,75,270,2022-03-21 09:14:06.932657
24859,13,68,6,46,116,249,2022-03-21 09:14:08.153443
24875,13,73,7,54,78,225,2022-03-21 09:14:10.369452
24877,16,153,11,46,135,361,2022-03-21 09:14:12.774403
24881,12,138,19,100,111,380,2022-03-21 09:14:12.940797
24893,4953,76001,2827,2387,24032,110200,2022-03-21 09:14:15.572995
24909,846,5720,612,1283,4102,12563,2022-03-21 09:14:20.515499
24913,707,35516,342,186,8373,45124,2022-03-21 09:14:20.728596
24923,7,56,3,63,66,195,2022-03-21 09:14:22.798502
25081,16,106,10,59,144,335,2022-03-21 09:14:28.60059
25095,8,36,3,45,50,142,2022-03-21 09:14:32.010373
25099,12954,158201,4999,7983,59748,243885,2022-03-21 09:14:32.209731
25101,9,104,2,42,46,203,2022-03-21 09:14:32.653596
25139,21,93,12,53,152,331,2022-03-21 09:14:38.658972
25143,383,15621,151,230,5824,22209,2022-03-21 09:14:38.859454
25149,10,174,2,37,86,309,2022-03-21 09:14:42.995892
25157,30737,542307,13638,24845,124972,736499,2022-03-21 09:14:43.173052
25159,19713,231574,9970,12691,101312,375260,2022-03-21 09:14:43.442109
25161,1171,67194,405,326,7557,76653,2022-03-21 09:14:43.976824
25293,34,224,20,38,323,639,2022-03-21 09:14:49.276205
25397,20555,372839,10135,24197,68347,496073,2022-03-21 09:14:51.945281
25439,64,2364,54,64,1006,3552,2022-03-21 09:14:55.421706
25457,149,3379,64,91,1480,5163,2022-03-21 09:14:55.792167
25495,16,1213,7,22,165,1423,2022-03-21 09:14:58.109519
25503,23,89,11,86,140,349,2022-03-21 09:14:58.309546
25533,10,342,4,23,42,421,2022-03-21 09:15:00.124104
25537,7485,251330,2236,990,113536,375577,2022-03-21 09:15:00.578745
25623,36,77,12,60,376,561,2022-03-21 09:15:03.790312
25717,15,212,18,97,442,784,2022-03-21 09:15:09.370826
25719,155,7393,81,73,1895,9597,2022-03-21 09:15:09.820539
25729,404,4159,248,135,5853,10799,2022-03-21 09:15:13.946505
25731,12038,92686,5651,8554,59031,177960,2022-03-21 09:15:14.394739
25755,234,6657,142,186,3740,10959,2022-03-21 09:15:15.281222
43569,0,7,1,7,10,25,2022-03-21 11:30:41.586852
25915,47,471,22,52,724,1316,2022-03-21 09:15:18.953595
25967,18,449,11,70,97,645,2022-03-21 09:15:22.179683
26089,8,55,5,58,51,177,2022-03-21 09:15:27.592244
26143,6,52,2,59,69,188,2022-03-21 09:15:31.233739
26199,6,73,2,53,57,191,2022-03-21 09:15:33.623278
26271,8,40,3,44,61,156,2022-03-21 09:15:40.563779
26299,9,40,2,46,57,154,2022-03-21 09:15:45.188281
26327,12,44,5,45,91,197,2022-03-21 09:15:48.794212
26329,10,33,4,46,51,144,2022-03-21 09:15:49.005347
26447,8,166,3,38,63,278,2022-03-21 09:15:54.037217
26449,805,25082,482,681,8104,35154,2022-03-21 09:15:56.98869
27371,13,110,4,61,78,266,2022-03-21 09:16:00.599168
27373,10,89,5,59,75,238,2022-03-21 09:16:01.683055
27375,18,73,11,74,182,358,2022-03-21 09:16:01.844071
27377,9,54,6,82,67,218,2022-03-21 09:16:03.050153
27379,11,74,7,78,94,264,2022-03-21 09:16:04.37995
27389,9,42,2,49,63,165,2022-03-21 09:16:05.799037
27437,15,210,4,37,109,375,2022-03-21 09:16:08.721908
27441,5158,30690,3121,5386,32244,76599,2022-03-21 09:16:11.41364
27451,15,228,13,67,73,396,2022-03-21 09:16:11.670302
43581,0,9,1,10,11,31,2022-03-21 11:30:44.033071
27787,19511,496748,9889,11987,74821,612956,2022-03-21 09:16:21.323144
27853,11,37,2,43,48,141,2022-03-21 09:16:32.368101
27887,292,5834,199,107,2264,8696,2022-03-21 09:16:33.348959
27967,717,10158,331,179,6602,17987,2022-03-21 09:16:36.303663
28067,9,204,3,37,77,330,2022-03-21 09:16:39.862896
28155,1848,13357,1882,4620,8791,30498,2022-03-21 09:16:44.595345
28625,2497,33245,1024,766,36787,74319,2022-03-21 09:17:05.054614
28637,17,800,16,42,214,1089,2022-03-21 09:17:09.943747
28641,9,692,5,31,202,939,2022-03-21 09:17:15.71518
28645,9,836,7,28,125,1005,2022-03-21 09:17:19.168749
28647,13,666,7,26,105,817,2022-03-21 09:17:19.455793
28675,5278,160959,2070,855,60213,229375,2022-03-21 09:17:20.645555
28733,37,351,36,50,557,1031,2022-03-21 09:17:23.044058
28915,39,509,32,82,524,1186,2022-03-21 09:17:32.675761
28925,18,297,17,80,269,681,2022-03-21 09:17:33.049102
28927,22883,555012,9506,8436,81069,676906,2022-03-21 09:17:33.573277
28955,6,290,5,32,68,401,2022-03-21 09:17:36.04995
29053,5,177,3,35,42,262,2022-03-21 09:17:38.9531
29099,14,86,10,85,87,282,2022-03-21 09:17:43.077639
29101,1996,58958,967,708,10298,72927,2022-03-21 09:17:43.285698
29103,6,141,3,31,33,214,2022-03-21 09:17:43.808783
29123,27,1348,16,24,255,1670,2022-03-21 09:17:47.146179
29177,11,134,2,35,46,228,2022-03-21 09:17:50.783076
29181,5,168,3,32,29,237,2022-03-21 09:17:53.445606
29207,7,87,2,41,59,196,2022-03-21 09:17:54.671381
29209,9,41,3,44,48,145,2022-03-21 09:17:54.849808
29231,34,308,18,51,261,672,2022-03-21 09:17:56.884215
29373,13,63,18,58,59,211,2022-03-21 09:18:05.864551
29375,76,0,17,83,105,281,2022-03-21 09:18:07.059003
29385,14,61,4,59,73,211,2022-03-21 09:18:10.513165
29387,34,37,9,62,74,216,2022-03-21 09:18:12.153281
29389,15,43,9,53,55,175,2022-03-21 09:18:13.238759
29399,36,27,10,85,115,273,2022-03-21 09:18:16.568521
29419,72,2405,74,116,1059,3726,2022-03-21 09:18:18.747975
29433,11,53,6,44,68,182,2022-03-21 09:18:19.934917
29467,14,65,4,54,63,200,2022-03-21 09:18:23.372649
29469,9,70,7,60,56,202,2022-03-21 09:18:24.5117
29471,14,100,6,52,118,290,2022-03-21 09:18:25.785723
29489,11,53,4,56,50,174,2022-03-21 09:18:27.356568
29513,555,12848,212,132,7018,20765,2022-03-21 09:18:29.482221
29541,10,94,7,47,73,231,2022-03-21 09:18:30.810896
29557,12,247,7,45,88,399,2022-03-21 09:18:33.146317
29559,12,189,4,51,57,313,2022-03-21 09:18:34.301216
29583,378,15919,248,211,5424,22180,2022-03-21 09:18:34.671456
29609,14,279,1,34,74,402,2022-03-21 09:18:39.803896
29651,11,194,3,38,55,301,2022-03-21 09:18:44.105288
29743,10,66,11,34,57,178,2022-03-21 09:18:51.015075
29744,7,158,2,27,26,220,2022-03-21 09:18:51.216986
29751,10,102,3,43,87,245,2022-03-21 09:18:53.253414
29800,8,153,3,48,49,261,2022-03-21 09:18:58.502632
29822,33,336,37,80,336,822,2022-03-21 09:19:02.811629
29833,11,136,6,40,81,274,2022-03-21 09:19:07.58161
29835,10,129,4,72,98,313,2022-03-21 09:19:11.436439
29836,11,123,9,71,102,316,2022-03-21 09:19:12.709878
29837,46,202,16,59,340,663,2022-03-21 09:19:15.139896
29842,8,77,4,61,64,214,2022-03-21 09:19:16.286325
29843,11,94,8,71,92,276,2022-03-21 09:19:16.567331
29861,21,193,23,62,187,486,2022-03-21 09:19:21.822848
29895,13,215,1,49,82,360,2022-03-21 09:19:24.022219
29948,6,74,7,83,77,247,2022-03-21 09:19:30.08809
29956,11,212,4,27,75,329,2022-03-21 09:19:31.142165
29980,29,1806,15,53,383,2286,2022-03-21 09:19:35.386641
29984,22,857,5,45,124,1053,2022-03-21 09:19:35.881822
29985,11,74,7,60,66,218,2022-03-21 09:19:37.243281
30015,39079,619721,18619,17869,193113,888401,2022-03-21 09:19:39.418058
30027,12,58,5,59,62,196,2022-03-21 09:19:41.433504
30076,6,227,2,32,44,311,2022-03-21 09:19:46.92028
30082,7,141,2,32,35,217,2022-03-21 09:19:47.882357
30091,7373,46117,4769,18623,26624,103506,2022-03-21 09:19:49.044569
30121,12,56,6,65,47,186,2022-03-21 09:19:53.754884
30122,19,188,8,77,196,488,2022-03-21 09:19:53.958988
30138,19,54,4,42,92,211,2022-03-21 09:20:02.028999
30139,9,61,2,46,51,169,2022-03-21 09:20:03.817857
30143,51,975,31,72,607,1736,2022-03-21 09:20:06.29932
30144,16,130,12,93,195,446,2022-03-21 09:20:08.787239
30145,40,319,23,48,396,826,2022-03-21 09:20:10.605128
30148,14,86,9,59,96,264,2022-03-21 09:20:11.731213
30150,17,111,11,67,125,331,2022-03-21 09:20:13.438867
30151,165,0,40,232,423,860,2022-03-21 09:20:13.644361
30177,13,317,7,60,96,493,2022-03-21 09:20:21.177592
30178,55,671,37,94,732,1589,2022-03-21 09:20:24.477036
30187,12639,101093,8144,10833,62345,195054,2022-03-21 09:20:27.896277
30196,186,2424,79,82,2183,4954,2022-03-21 09:20:31.323954
30198,9,61,4,40,62,176,2022-03-21 09:20:33.759037
30200,9,73,2,42,43,169,2022-03-21 09:20:35.389679
30201,10,128,5,27,60,230,2022-03-21 09:20:35.822908
30206,1088,71130,498,245,13246,86207,2022-03-21 09:20:38.979506
30207,9,98,2,43,43,195,2022-03-21 09:20:39.183024
30212,13,678,5,31,106,833,2022-03-21 09:20:42.553722
30213,7,197,3,34,77,318,2022-03-21 09:20:42.754562
30214,16,513,5,53,149,736,2022-03-21 09:20:44.307891
30218,119,1659,74,114,1647,3613,2022-03-21 09:20:49.188907
30228,12,72,3,46,73,206,2022-03-21 09:20:51.150008
30230,9836,83112,4160,2377,20297,119782,2022-03-21 09:20:51.318738
30234,13,1147,5,48,147,1360,2022-03-21 09:20:53.720555
30235,10,61,1,30,50,152,2022-03-21 09:20:54.950489
30240,35381,643819,17224,33808,136986,867218,2022-03-21 09:20:55.642395
30246,113,1132,113,112,1726,3196,2022-03-21 09:20:58.379582
30247,12,132,8,45,97,294,2022-03-21 09:21:01.274024
30251,383,2027,224,768,3301,6703,2022-03-21 09:21:01.87896
30268,9,48,1,35,47,140,2022-03-21 09:21:03.843032
30276,117868,2366147,38451,34249,163066,2719781,2022-03-21 09:21:04.056931
30296,33866,625416,11300,18074,119235,807891,2022-03-21 09:21:09.187044
30298,28,263,10,65,242,608,2022-03-21 09:21:12.575552
30300,2553,118751,933,689,19692,142618,2022-03-21 09:21:12.848604
30346,4107,155891,1217,1338,59825,222378,2022-03-21 09:21:22.495397
30347,3824,142804,1401,719,21893,170641,2022-03-21 09:21:22.694664
30349,10,52,3,51,65,181,2022-03-21 09:21:25.470542
30355,2123,22271,1182,2095,12842,40513,2022-03-21 09:21:28.224513
30358,77,1514,28,40,757,2416,2022-03-21 09:21:28.48352
30362,24,83,20,50,390,567,2022-03-21 09:21:28.905643
30370,8373,82288,3613,1078,21763,117115,2022-03-21 09:21:29.766239
30404,9,267,4,34,58,372,2022-03-21 09:21:33.496492
30427,7,309,1,20,36,373,2022-03-21 09:21:38.250933
30435,14,91,6,36,115,262,2022-03-21 09:21:42.097432
30470,37,107,14,104,137,399,2022-03-21 09:21:48.962991
30567,505,13479,192,220,3342,17738,2022-03-21 09:21:56.672991
30571,26,205,13,44,235,523,2022-03-21 09:21:56.959177
30705,1725,24578,793,4525,7449,39070,2022-03-21 09:22:05.898388
30762,8,59,2,38,44,151,2022-03-21 09:22:10.745241
30781,12,117,0,44,63,236,2022-03-21 09:22:13.157095
30782,4401,45152,1862,7204,19569,78188,2022-03-21 09:22:13.362963
30895,5943,33730,3954,12413,28540,84580,2022-03-21 09:22:19.439675
30927,9,36,4,52,47,148,2022-03-21 09:22:29.423233
30928,8,29,3,55,41,136,2022-03-21 09:22:29.631832
30929,8,65,4,68,51,196,2022-03-21 09:22:32.964574
30930,8,34,3,47,40,132,2022-03-21 09:22:33.995009
30931,8,31,2,61,43,145,2022-03-21 09:22:35.065292
30944,7,41,3,47,61,159,2022-03-21 09:22:37.780085
30947,155,1203,127,343,820,2648,2022-03-21 09:22:40.509187
30952,438,14562,189,191,6416,21796,2022-03-21 09:22:41.119343
30955,22,475,4,44,130,675,2022-03-21 09:22:43.527073
30957,18,108,23,117,97,363,2022-03-21 09:22:45.448211
30958,8,38,3,46,51,146,2022-03-21 09:22:45.801054
30959,7,37,4,56,44,148,2022-03-21 09:22:47.735913
30979,7,34,2,46,37,126,2022-03-21 09:22:51.826457
30997,7,31,1,48,36,123,2022-03-21 09:22:55.877556
31133,151,2683,121,131,1637,4723,2022-03-21 09:23:08.102129
31147,6160,28354,4889,10448,32480,82331,2022-03-21 09:23:13.522959
31149,1400,38798,565,325,20494,61582,2022-03-21 09:23:13.73064
31150,130,132,57,217,143,679,2022-03-21 09:23:15.748337
31157,1980,5333,1573,5479,10038,24403,2022-03-21 09:23:16.559969
31158,191,4079,122,102,2628,7122,2022-03-21 09:23:19.74289
43583,0,10,1,7,12,30,2022-03-21 11:30:45.673362
31173,12820,230395,7283,4414,56822,311734,2022-03-21 09:23:20.966673
31244,64,1012,84,152,1391,2703,2022-03-21 09:23:26.711653
31245,6534,110210,2076,1013,72197,192030,2022-03-21 09:23:27.899929
43592,0,8,1,7,12,28,2022-03-21 11:30:48.363281
31246,41,229,36,87,300,693,2022-03-21 09:23:30.162858
31251,18340,120090,9812,8217,42375,198834,2022-03-21 09:23:30.344235
31252,20,906,11,22,187,1146,2022-03-21 09:23:30.524503
31255,17,94,10,34,99,254,2022-03-21 09:23:32.179992
31257,15,476,9,32,167,699,2022-03-21 09:23:34.066903
31259,18,461,10,38,146,673,2022-03-21 09:23:35.496673
31264,9,215,4,30,63,321,2022-03-21 09:23:39.204909
31265,10,203,4,29,60,306,2022-03-21 09:23:40.413721
31414,13567,114281,6772,7824,64351,206795,2022-03-21 09:23:50.109652
31417,1896,13196,1323,1808,8573,26796,2022-03-21 09:23:50.301905
31426,76,1033,39,50,834,2032,2022-03-21 09:23:54.918232
31427,119,586,65,123,480,1373,2022-03-21 09:23:58.744654
31562,16,73,8,78,143,318,2022-03-21 09:24:11.073202
31578,805,4053,409,2323,3189,10779,2022-03-21 09:24:14.824365
31581,108,1092,73,77,1537,2887,2022-03-21 09:24:20.363909
31582,13,186,6,31,131,367,2022-03-21 09:24:22.622268
43594,0,8,1,7,9,25,2022-03-21 11:30:50.709402
31698,34,203,10,76,103,426,2022-03-21 09:24:36.383559
31710,12047,76621,6696,25702,35624,156690,2022-03-21 09:24:37.34635
31730,25,78,7,47,153,310,2022-03-21 09:24:41.745372
31733,2957,33309,1316,918,12541,51041,2022-03-21 09:24:46.076112
31736,894,11058,445,359,4640,17396,2022-03-21 09:24:46.268258
31737,15276,310279,5598,7930,43974,383057,2022-03-21 09:24:46.519747
43595,0,7,0,7,10,24,2022-03-21 11:30:51.638783
31738,55,876,13,49,337,1330,2022-03-21 09:24:48.787546
31741,17956,311996,8371,6920,79095,424338,2022-03-21 09:24:49.039801
31746,15,81,7,69,93,265,2022-03-21 09:24:51.678363
31747,24,262,14,91,117,508,2022-03-21 09:24:52.115042
31749,59,302,16,59,481,917,2022-03-21 09:24:55.247844
31750,61,1609,76,135,822,2703,2022-03-21 09:24:55.496834
31753,19,61,9,79,106,274,2022-03-21 09:24:55.757019
31867,319,7396,150,122,4168,12155,2022-03-21 09:25:07.648209
31868,12,73,3,51,149,288,2022-03-21 09:25:10.340919
31873,12,166,2,27,54,261,2022-03-21 09:25:11.802676
31878,10,113,3,28,49,203,2022-03-21 09:25:13.908407
31880,26,1447,11,29,234,1747,2022-03-21 09:25:14.364533
31883,808,4751,585,417,2490,9051,2022-03-21 09:25:18.933048
31884,1417,3878,877,836,4289,11297,2022-03-21 09:25:19.304736
31911,64,2456,54,87,885,3546,2022-03-21 09:25:24.389975
31924,12,60,3,53,56,184,2022-03-21 09:25:25.625444
31966,188,2564,57,194,1146,4149,2022-03-21 09:25:27.886155
31989,645,11865,373,299,12124,25306,2022-03-21 09:25:33.975502
32005,790,28212,243,303,5351,34899,2022-03-21 09:25:37.867652
32010,17,135,7,49,107,315,2022-03-21 09:25:40.428485
32012,0,0,0,0,2176,2176,2022-03-21 09:25:44.420292
32014,14,67,9,55,88,233,2022-03-21 09:25:45.176451
32015,3185,23209,1847,853,13410,42504,2022-03-21 09:25:45.444877
32151,217,3587,109,106,1973,5992,2022-03-21 09:25:51.941008
32158,35,393,31,88,516,1063,2022-03-21 09:25:56.481452
32160,105,1828,54,91,1006,3084,2022-03-21 09:25:59.388171
32167,9,131,0,26,29,195,2022-03-21 09:26:03.690777
32171,3815,17521,1888,5741,21880,50845,2022-03-21 09:26:04.156852
32174,244,4608,124,102,2874,7952,2022-03-21 09:26:06.674361
32182,87819,1259200,34946,24830,266956,1673751,2022-03-21 09:26:07.115979
32188,3810,173597,1387,511,42534,221839,2022-03-21 09:26:12.200442
32189,15831,215409,7682,7489,64636,311047,2022-03-21 09:26:12.37142
32190,163,3560,71,53,1981,5828,2022-03-21 09:26:15.537612
32191,261,5626,133,146,2769,8935,2022-03-21 09:26:15.794301
32214,3417,17148,2151,5377,14298,42391,2022-03-21 09:26:22.425884
32219,28,363,8,37,166,602,2022-03-21 09:26:24.921515
32221,13,161,7,71,58,310,2022-03-21 09:26:26.490547
32222,29,689,22,79,589,1408,2022-03-21 09:26:26.666556
32225,7,48,5,47,52,159,2022-03-21 09:26:27.925038
32228,432,10963,169,174,3051,14789,2022-03-21 09:26:32.711769
32233,34,2085,3,48,174,2344,2022-03-21 09:26:36.357255
32237,14,86,9,49,54,212,2022-03-21 09:26:37.578802
32240,229,4256,276,269,3658,8688,2022-03-21 09:26:37.750236
32245,11774,63803,6780,9916,35170,127443,2022-03-21 09:26:40.762912
32248,381,334,142,171,2594,3622,2022-03-21 09:26:45.921338
32253,6,53,5,66,43,173,2022-03-21 09:26:49.930576
32254,13,90,3,36,69,211,2022-03-21 09:26:51.483336
32255,12,92,4,57,126,291,2022-03-21 09:26:52.657514
32256,20,386,10,36,193,645,2022-03-21 09:26:52.835898
32288,13,629,4,29,81,756,2022-03-21 09:26:59.960175
32289,19,734,5,45,95,898,2022-03-21 09:27:02.557436
32291,15,350,5,27,107,504,2022-03-21 09:27:02.737833
32293,9,362,2,19,48,440,2022-03-21 09:27:03.005647
32311,77,5877,50,83,844,6931,2022-03-21 09:27:04.482981
32343,17,367,6,23,140,553,2022-03-21 09:27:05.739258
32360,11823,85135,4861,11684,54910,168413,2022-03-21 09:27:09.801566
32366,2766,50963,841,577,17812,72959,2022-03-21 09:27:10.190081
32370,11841,97290,5246,5440,54173,173990,2022-03-21 09:27:10.879358
32419,9,60,4,54,59,186,2022-03-21 09:27:16.638572
32557,17,165,4,47,90,323,2022-03-21 09:27:29.333926
32615,45665,509128,21289,25693,158083,759858,2022-03-21 09:27:34.075913
32668,2973,80109,664,642,22406,106794,2022-03-21 09:27:41.3477
32686,23418,205518,11480,26053,88932,355401,2022-03-21 09:27:42.517583
32693,9,121,5,59,75,269,2022-03-21 09:27:45.931747
32728,25,639,5,41,171,881,2022-03-21 09:27:47.482866
32736,30,366,19,50,299,764,2022-03-21 09:27:50.877522
32738,12,64,5,42,57,180,2022-03-21 09:27:52.239972
32745,10,369,2,20,54,455,2022-03-21 09:27:59.010821
32757,9,199,1,18,45,272,2022-03-21 09:28:00.6096
32775,7,192,3,22,36,260,2022-03-21 09:28:04.176927
32794,16,91,2,35,112,256,2022-03-21 09:28:08.182466
32796,13,39,4,55,61,172,2022-03-21 09:28:09.27642
32799,49,0,18,58,63,188,2022-03-21 09:28:11.610131
32800,8,169,3,20,38,238,2022-03-21 09:28:11.785474
32806,104,1673,59,117,1134,3087,2022-03-21 09:28:15.222434
32809,11,120,6,85,71,293,2022-03-21 09:28:18.489394
32811,6,309,1,19,62,397,2022-03-21 09:28:18.856403
32819,11,109,8,83,57,268,2022-03-21 09:28:20.682378
32831,247,1,110,102,160,620,2022-03-21 09:28:22.426127
32862,10,132,1,13,44,200,2022-03-21 09:28:25.866398
32871,733,21340,297,345,10088,32803,2022-03-21 09:28:31.03911
32875,12,409,4,37,91,553,2022-03-21 09:28:32.837987
32888,47,520,25,64,725,1381,2022-03-21 09:28:34.286165
32933,12,209,6,48,70,345,2022-03-21 09:28:40.673436
32943,28,347,15,37,237,664,2022-03-21 09:28:42.917913
32944,34,74,24,99,383,614,2022-03-21 09:28:43.120986
32949,38304,341332,16336,29880,165012,590864,2022-03-21 09:28:47.195316
32950,208,2413,85,136,3133,5975,2022-03-21 09:28:47.39743
32951,34955,453939,10580,18500,91883,609857,2022-03-21 09:28:50.297732
32954,875,8670,617,643,4380,15185,2022-03-21 09:28:54.707203
32956,180,0,63,176,234,653,2022-03-21 09:28:54.907928
32959,585,2290,389,258,552,4074,2022-03-21 09:28:58.697877
32961,2903,7464,1625,4356,11323,27671,2022-03-21 09:28:58.962489
32962,12346,74111,6987,16282,71363,181089,2022-03-21 09:29:05.822377
32977,10883,49984,6202,5175,21885,94129,2022-03-21 09:29:09.228899
32979,12948,74772,9177,8966,67342,173205,2022-03-21 09:29:09.406139
32981,6351,36891,3012,20764,29389,96407,2022-03-21 09:29:13.607597
32983,9529,85052,3167,1792,60718,160258,2022-03-21 09:29:14.577201
32989,51,212,31,72,545,911,2022-03-21 09:29:14.746052
32993,109,3150,65,46,1142,4512,2022-03-21 09:29:17.480686
43596,0,18,0,5,8,31,2022-03-21 11:30:52.59396
32995,40152,572555,16452,29434,105934,764527,2022-03-21 09:29:17.74358
32998,39535,326412,24739,23753,190480,604919,2022-03-21 09:29:18.259309
33003,9538,73359,4530,7874,48923,144224,2022-03-21 09:29:18.737443
33012,9727,52352,4710,16726,35811,119326,2022-03-21 09:29:20.172051
33024,172,3719,78,79,1704,5752,2022-03-21 09:29:21.161587
33033,198,3521,107,153,2834,6813,2022-03-21 09:29:25.158307
33035,234,7107,116,91,3652,11200,2022-03-21 09:29:31.177869
33036,3220,53864,1229,521,38071,96905,2022-03-21 09:29:31.636309
33037,2232,9485,1301,2392,9921,25331,2022-03-21 09:29:34.637823
33038,620,417,316,403,3375,5131,2022-03-21 09:29:37.404978
33041,1607,14658,864,1421,6187,24737,2022-03-21 09:29:41.013011
33042,29,686,8,41,196,960,2022-03-21 09:29:42.651761
33044,67,104,30,199,289,689,2022-03-21 09:29:44.622012
33045,980,5802,575,1273,4398,13028,2022-03-21 09:29:47.207217
33046,3416,19852,1772,3848,13546,42434,2022-03-21 09:29:47.393184
33047,11932,99933,6300,12376,64192,194733,2022-03-21 09:29:48.115476
33048,123,388,73,110,2296,2990,2022-03-21 09:29:50.780843
33050,6023,153843,1672,652,97213,259403,2022-03-21 09:29:51.872206
33051,9057,81667,3788,2256,21148,117916,2022-03-21 09:29:52.319929
33056,234,3244,76,110,2111,5775,2022-03-21 09:29:52.491984
33071,1713,104199,731,342,30219,137204,2022-03-21 09:29:53.769706
33079,12,49,4,51,109,225,2022-03-21 09:29:56.694649
43598,1,21,6,30,19,77,2022-03-21 11:30:53.828486
33080,4463,51679,1947,2045,14699,74833,2022-03-21 09:29:56.910311
33082,827,43574,294,239,9106,54040,2022-03-21 09:30:00.692204
33083,9,63,4,59,44,179,2022-03-21 09:30:03.286439
33084,7,59,2,54,33,155,2022-03-21 09:30:04.45165
33086,18,105,3,59,76,261,2022-03-21 09:30:07.65767
33087,200,501,126,117,2912,3856,2022-03-21 09:30:11.506216
33089,4525,34706,2544,4486,28090,74351,2022-03-21 09:30:14.972284
33091,4314,45658,2025,1911,32375,86283,2022-03-21 09:30:17.744358
33094,7674,87963,3786,4960,37749,142132,2022-03-21 09:30:17.931852
33095,10275,66311,5265,3364,80931,166146,2022-03-21 09:30:18.452986
33103,142,2149,75,69,1123,3558,2022-03-21 09:30:21.654201
33105,49,558,26,68,478,1179,2022-03-21 09:30:21.872217
33106,210,3526,105,114,2730,6685,2022-03-21 09:30:26.116158
33113,1771,4843,813,4424,7726,19577,2022-03-21 09:30:28.877844
33114,11,193,7,36,148,395,2022-03-21 09:30:31.029199
33115,9,74,2,47,58,190,2022-03-21 09:30:32.112153
33116,10,84,4,47,57,202,2022-03-21 09:30:33.175151
33118,498,3508,526,193,2195,6920,2022-03-21 09:30:33.346559
33119,170,2813,82,101,1787,4953,2022-03-21 09:30:35.842332
33123,17,61,6,50,80,214,2022-03-21 09:30:37.500488
33124,11,224,1,35,41,312,2022-03-21 09:30:37.716593
33126,48,213,21,42,399,723,2022-03-21 09:30:39.406271
33129,286,7928,162,150,5907,14433,2022-03-21 09:30:40.704639
33130,33,92,25,55,677,882,2022-03-21 09:30:42.958874
33133,14,82,12,89,86,283,2022-03-21 09:30:45.673692
33134,8,40,7,60,39,154,2022-03-21 09:30:46.804881
33136,7,39,5,61,37,149,2022-03-21 09:30:49.003986
33142,2288,49522,1145,1610,13146,67711,2022-03-21 09:30:52.478292
33144,46,201,27,44,557,875,2022-03-21 09:30:54.961906
33146,71,656,68,103,995,1893,2022-03-21 09:30:57.666732
33148,66,652,60,92,964,1834,2022-03-21 09:30:58.417729
33150,68,657,58,107,971,1861,2022-03-21 09:31:00.266074
33151,38,259,40,57,630,1024,2022-03-21 09:31:00.452104
33157,1299,17331,751,339,10742,30462,2022-03-21 09:31:01.305989
33161,4089,177036,1089,648,27021,209883,2022-03-21 09:31:08.387952
33163,32,304,16,55,269,676,2022-03-21 09:31:10.429813
33170,166,2708,103,103,1918,4998,2022-03-21 09:31:13.385079
33173,271,3830,183,80,2096,6460,2022-03-21 09:31:13.577009
33175,10,53,2,37,73,175,2022-03-21 09:31:15.688147
33176,16,119,1,40,94,270,2022-03-21 09:31:16.900524
33181,425,8835,243,154,6937,16594,2022-03-21 09:31:20.205727
33183,82,1608,53,115,1121,2979,2022-03-21 09:31:20.424001
33184,1843,5674,889,3575,10715,22696,2022-03-21 09:31:26.222492
33185,162,1295,97,105,5176,6835,2022-03-21 09:31:26.645017
33187,26,6086,17,47,233,6409,2022-03-21 09:31:26.817623
33188,22,43,4,108,95,272,2022-03-21 09:31:30.181003
33190,1548,17190,675,294,21944,41651,2022-03-21 09:31:30.6223
33192,32,480,14,39,227,792,2022-03-21 09:31:34.930043
33193,35,217,26,64,311,653,2022-03-21 09:31:35.96286
33195,39,209,21,54,291,614,2022-03-21 09:31:38.880743
33196,50,85,17,53,314,519,2022-03-21 09:31:40.343577
33197,3669,24667,1980,3673,19201,53190,2022-03-21 09:31:40.518819
33199,18,64,5,65,116,268,2022-03-21 09:31:40.780066
33200,10,57,5,58,58,188,2022-03-21 09:31:41.841078
33201,132,11560,61,62,1024,12839,2022-03-21 09:31:44.545897
33203,6989,54724,3528,7643,35308,108192,2022-03-21 09:31:44.734622
33204,1103,14100,504,310,19482,35499,2022-03-21 09:31:47.381988
33205,60,3075,18,51,593,3797,2022-03-21 09:31:50.406045
33206,62328,777311,25776,23791,164651,1053857,2022-03-21 09:31:50.592125
33208,243,1236,137,91,2610,4317,2022-03-21 09:31:53.421202
33215,5,196,2,22,42,267,2022-03-21 09:31:59.359769
33217,6,257,2,23,46,334,2022-03-21 09:32:00.61478
33218,974,7915,515,280,23281,32965,2022-03-21 09:32:04.07303
33219,446,3850,271,171,10437,15175,2022-03-21 09:32:04.247825
33220,12,696,3,34,73,818,2022-03-21 09:32:04.517036
33221,500,13321,173,165,4646,18805,2022-03-21 09:32:05.03655
33226,30,374,25,81,417,927,2022-03-21 09:32:05.515499
33228,45,345,29,69,561,1049,2022-03-21 09:32:07.369913
33232,74,545,24,64,738,1445,2022-03-21 09:32:10.209655
33234,9,90,7,39,85,230,2022-03-21 09:32:11.595851
33238,32,377,7,41,273,730,2022-03-21 09:32:15.729737
33239,70,99,46,35,946,1196,2022-03-21 09:32:17.974186
33240,781,1505,520,795,3021,6622,2022-03-21 09:32:18.15284
33242,993,18519,438,469,9081,29500,2022-03-21 09:32:23.693872
33244,2049,12331,782,2072,10680,27914,2022-03-21 09:32:23.901633
33245,309,2558,234,405,2730,6236,2022-03-21 09:32:29.193494
33247,171,1938,71,71,1851,4102,2022-03-21 09:32:31.595496
33248,1067,13307,610,380,45835,61199,2022-03-21 09:32:31.76081
33253,9752,201581,4787,4750,43050,263920,2022-03-21 09:32:35.428879
33254,1056,10401,758,329,7223,19767,2022-03-21 09:32:35.603389
33255,90425,555555,42236,28414,164294,880924,2022-03-21 09:32:38.468478
33258,28,145,11,65,191,440,2022-03-21 09:32:39.805428
33262,20,50,10,94,99,273,2022-03-21 09:32:40.966447
33263,8130,31855,4004,2200,45584,91773,2022-03-21 09:32:41.138988
33266,85,234,28,93,417,857,2022-03-21 09:32:46.121165
33267,79,9,16,61,343,508,2022-03-21 09:32:47.604067
33272,20,213,6,30,77,346,2022-03-21 09:32:51.073851
33273,11,189,2,35,93,330,2022-03-21 09:32:53.806789
33276,22,724,22,62,315,1145,2022-03-21 09:32:57.555436
33278,37,171,19,66,259,552,2022-03-21 09:32:58.142796
33279,22,132,8,38,96,296,2022-03-21 09:33:00.447399
33280,1030,19008,386,239,15607,36270,2022-03-21 09:33:01.250349
33281,36,2226,7,44,323,2636,2022-03-21 09:33:03.313477
33283,12,466,3,39,80,600,2022-03-21 09:33:06.553359
33286,12278,107237,4789,3916,44271,172491,2022-03-21 09:33:09.01626
33299,3362,25902,1254,2287,16800,49605,2022-03-21 09:33:10.963417
33300,15,98,6,67,83,269,2022-03-21 09:33:15.157866
33302,248,5546,142,135,4777,10848,2022-03-21 09:33:17.829598
33308,60,987,36,60,966,2109,2022-03-21 09:33:20.122446
33310,15,88,6,64,94,267,2022-03-21 09:33:24.240505
33312,15,638,8,27,93,781,2022-03-21 09:33:25.898565
33314,1430,5087,988,1729,3665,12899,2022-03-21 09:33:26.143432
33318,9,138,0,20,45,212,2022-03-21 09:33:27.488045
33323,1113,40692,387,232,10926,53350,2022-03-21 09:33:30.325639
33325,14,122,5,61,98,300,2022-03-21 09:33:31.447467
33326,8,1277,7,39,133,1464,2022-03-21 09:33:33.133313
33335,16,360,12,54,211,653,2022-03-21 09:33:33.298176
33337,8206,72130,5500,7110,51020,143966,2022-03-21 09:33:35.411182
33341,1151,5965,736,2216,5398,15466,2022-03-21 09:33:42.925656
33344,10,240,11,50,149,460,2022-03-21 09:33:47.484523
33349,15,92,6,43,77,233,2022-03-21 09:33:50.392501
33350,3000,7169,1002,1024,23200,35395,2022-03-21 09:33:50.766125
33352,112875,902410,49426,43985,346081,1454777,2022-03-21 09:33:51.197081
33354,16285,42150,6867,5334,35614,106250,2022-03-21 09:33:51.368245
33357,190,261,82,100,717,1350,2022-03-21 09:33:54.25602
33358,24,167,10,50,235,486,2022-03-21 09:33:56.228498
33360,236,3518,280,265,3611,7910,2022-03-21 09:33:56.429061
33362,951,8076,501,660,5376,15564,2022-03-21 09:34:00.927289
33363,149,2464,64,84,1606,4367,2022-03-21 09:34:06.938918
33366,36,310,20,42,236,644,2022-03-21 09:34:08.321566
33369,7,457,3,14,49,530,2022-03-21 09:34:09.74797
33377,12760,32154,7293,19148,36431,107786,2022-03-21 09:34:17.098972
33378,807,8508,270,180,11580,21345,2022-03-21 09:34:20.837045
33383,20,43,3,39,80,185,2022-03-21 09:34:22.383941
33389,41,142,32,45,726,986,2022-03-21 09:34:25.861474
33391,64,854,35,44,1359,2356,2022-03-21 09:34:28.627218
33394,419,2090,193,1431,3484,7617,2022-03-21 09:34:33.19189
33396,183,298,52,124,537,1194,2022-03-21 09:34:33.469737
33398,162,0,36,232,753,1183,2022-03-21 09:34:37.8208
33401,7,266,2,18,39,332,2022-03-21 09:34:39.384703
33414,36,66,10,88,141,341,2022-03-21 09:34:40.996921
33415,30,29,5,58,106,228,2022-03-21 09:34:42.626968
33417,3644,59196,1380,2193,13398,79811,2022-03-21 09:34:42.910582
33419,810,9883,417,778,3707,15595,2022-03-21 09:34:45.498035
33421,13852,69685,5141,11828,71317,171823,2022-03-21 09:34:48.807017
33429,12,207,0,35,60,314,2022-03-21 09:34:51.693773
33431,5,30,3,16,27,81,2022-03-21 09:34:53.813822
33438,100,93,54,56,1409,1712,2022-03-21 09:34:59.977974
33443,759,713,214,200,2127,4013,2022-03-21 09:35:00.181922
33446,850,6401,269,266,4756,12542,2022-03-21 09:35:00.442078
33447,929,8453,420,1434,3876,15112,2022-03-21 09:35:07.408425
33449,14,419,5,32,111,581,2022-03-21 09:35:08.972214
33454,40,273,18,57,435,823,2022-03-21 09:35:09.15093
33455,312,4257,113,101,3226,8009,2022-03-21 09:35:10.759019
33456,1036,12941,720,290,7183,22170,2022-03-21 09:35:11.262558
33457,48,908,60,146,1154,2316,2022-03-21 09:35:11.441517
33462,1226,10603,690,2500,5738,20757,2022-03-21 09:35:14.322199
33473,25,121,7,94,220,467,2022-03-21 09:35:20.433004
33474,13,213,8,55,187,476,2022-03-21 09:35:21.94987
33478,12620,96960,4140,6081,54255,174056,2022-03-21 09:35:25.695765
33480,18,65,5,68,62,218,2022-03-21 09:35:29.841291
33485,9,87,1,47,53,197,2022-03-21 09:35:33.611679
33486,119665,1897319,19094,16054,97236,2149368,2022-03-21 09:35:33.898434
33487,39396,528856,14226,28722,106965,718165,2022-03-21 09:35:34.334282
33489,47791,318460,30631,26203,136988,560073,2022-03-21 09:35:38.335903
43600,0,0,0,0,4877,4877,2022-03-21 11:30:56.51759
43601,0,0,0,0,0,0,2022-03-21 11:30:57.314185
33490,185,2108,105,153,1282,3833,2022-03-21 09:35:38.741806
33491,207,2930,113,104,2718,6072,2022-03-21 09:35:38.914685
33499,18,316,9,58,135,536,2022-03-21 09:35:44.523381
33500,11,142,3,47,77,280,2022-03-21 09:35:45.867588
33501,9,92,0,33,54,188,2022-03-21 09:35:46.560081
33506,32563,481755,15772,16959,112441,659490,2022-03-21 09:35:49.718229
33512,79,956,67,123,1237,2462,2022-03-21 09:36:01.234785
33520,1041,18969,487,542,19414,40453,2022-03-21 09:36:04.799687
33522,171,2551,73,116,1800,4711,2022-03-21 09:36:05.250311
33524,747,61750,401,361,13066,76325,2022-03-21 09:36:10.8287
33526,4,155,2,31,41,233,2022-03-21 09:36:15.143095
33527,16,167,2,32,63,280,2022-03-21 09:36:15.359024
33528,12,80,5,37,101,235,2022-03-21 09:36:17.804675
33529,9,135,2,29,50,225,2022-03-21 09:36:18.893877
33531,3961,11366,1849,4603,13898,35677,2022-03-21 09:36:21.445036
33532,958,3425,498,1795,5461,12137,2022-03-21 09:36:23.708242
33534,11,188,2,30,64,295,2022-03-21 09:36:26.149159
33536,14,280,0,28,118,440,2022-03-21 09:36:28.127898
33539,13,41,3,45,57,159,2022-03-21 09:36:33.422016
33540,84,61,25,108,503,781,2022-03-21 09:36:34.897213
33541,155,1579,95,350,968,3147,2022-03-21 09:36:36.734087
33542,62,188,29,62,254,595,2022-03-21 09:36:38.217022
33543,16,337,13,66,151,583,2022-03-21 09:36:39.957337
33544,15,451,16,68,215,765,2022-03-21 09:36:41.909325
33545,11,455,4,30,97,597,2022-03-21 09:36:42.086461
33546,152,1295,60,83,1194,2784,2022-03-21 09:36:44.67621
33547,16,169,15,63,163,426,2022-03-21 09:36:45.882991
33548,12,349,13,49,129,552,2022-03-21 09:36:47.739704
33549,11,261,11,42,118,443,2022-03-21 09:36:47.916395
33550,13,222,15,60,143,453,2022-03-21 09:36:48.087355
33551,14,192,21,51,139,417,2022-03-21 09:36:50.063987
33552,13,233,15,44,136,441,2022-03-21 09:36:51.140264
33558,1413,44435,475,370,11587,58280,2022-03-21 09:36:53.588184
33562,674,1454,238,346,4231,6943,2022-03-21 09:36:56.037306
33566,467,9469,159,187,4152,14434,2022-03-21 09:36:58.774051
33569,1912,32852,842,1090,10969,47665,2022-03-21 09:36:58.964593
33570,13,133,3,54,78,281,2022-03-21 09:37:00.311485
33571,13,118,4,55,72,262,2022-03-21 09:37:01.775581
33572,612,1702,305,931,4547,8097,2022-03-21 09:37:02.226739
33573,5230,37516,2736,3685,28805,77972,2022-03-21 09:37:04.575965
33578,28,322,14,39,227,630,2022-03-21 09:37:05.010018
33581,3090,113083,1083,611,34910,152777,2022-03-21 09:37:06.590005
33583,19,51,6,41,136,253,2022-03-21 09:37:10.815875
33601,11,45,1,53,69,179,2022-03-21 09:37:17.373051
33602,18,54,9,45,153,279,2022-03-21 09:37:18.690945
33603,12,50,3,45,92,202,2022-03-21 09:37:19.796482
33605,6312,35195,2538,5891,29556,79492,2022-03-21 09:37:23.613756
33606,345,15746,197,158,3252,19698,2022-03-21 09:37:26.897036
33607,18,46,9,50,142,265,2022-03-21 09:37:28.067603
33654,8647,91397,3078,5556,33851,142529,2022-03-21 09:37:33.611609
33658,130,1841,112,106,1829,4018,2022-03-21 09:37:33.799953
33659,41,447,33,41,579,1141,2022-03-21 09:37:38.226328
33661,98,1422,54,145,606,2325,2022-03-21 09:37:40.684763
33662,13,80,12,80,102,287,2022-03-21 09:37:42.736815
33663,31,194,4,26,153,408,2022-03-21 09:37:44.722256
33670,25,116,6,61,96,304,2022-03-21 09:37:50.273588
33671,20,61,7,41,85,214,2022-03-21 09:37:51.618902
33672,78,2991,75,111,740,3995,2022-03-21 09:37:51.806815
33674,18415,539517,5737,5487,181225,750381,2022-03-21 09:37:52.252832
33681,262,3529,157,129,3336,7413,2022-03-21 09:37:52.414525
33690,899,4455,403,2446,4337,12540,2022-03-21 09:37:57.858751
33691,8,88,4,43,62,205,2022-03-21 09:37:59.112955
33693,14,606,3,31,75,729,2022-03-21 09:38:02.386392
33694,12,401,2,30,88,533,2022-03-21 09:38:02.839689
33695,8,175,3,22,49,257,2022-03-21 09:38:04.064976
33696,22,2616,16,84,209,2947,2022-03-21 09:38:04.234485
33697,107,3388,41,66,921,4523,2022-03-21 09:38:06.836669
33698,16,255,2,21,84,378,2022-03-21 09:38:08.597957
33702,133,526,48,71,785,1563,2022-03-21 09:38:10.32218
33703,22,70,4,49,137,282,2022-03-21 09:38:11.474946
33704,61,173,31,86,440,791,2022-03-21 09:38:13.202678
33705,16,171,20,61,167,435,2022-03-21 09:38:13.386463
33706,4,30,2,21,26,83,2022-03-21 09:38:14.419117
33709,148,1394,67,97,1514,3220,2022-03-21 09:38:18.781398
33710,10,285,5,32,62,394,2022-03-21 09:38:20.181974
33712,1847,7070,692,483,4123,14215,2022-03-21 09:38:20.642066
33713,191,4051,85,66,1847,6240,2022-03-21 09:38:23.026986
33718,29,456,4,40,276,805,2022-03-21 09:38:27.525742
33720,184,2880,120,143,2545,5872,2022-03-21 09:38:29.811976
33723,42,130,16,61,363,612,2022-03-21 09:38:29.988399
33724,219,1211,123,122,2529,4204,2022-03-21 09:38:30.421105
33728,832,10260,350,432,9968,21842,2022-03-21 09:38:35.484343
33730,405,6663,184,226,6365,13843,2022-03-21 09:38:40.427196
33731,24702,255076,12976,16823,96415,405992,2022-03-21 09:38:46.0195
33733,2609,20673,969,1663,7465,33379,2022-03-21 09:38:46.183308
33734,32,1037,13,48,260,1390,2022-03-21 09:38:49.737175
33737,1206,1408,256,1209,7428,11507,2022-03-21 09:38:52.243514
33764,29,150,10,58,124,371,2022-03-21 09:39:27.831974
33743,16621,160795,6945,21024,58386,263771,2022-03-21 09:39:03.644052
33755,127,140,43,72,1223,1605,2022-03-21 09:39:10.988703
33756,78,73,25,48,669,893,2022-03-21 09:39:13.238334
33758,501,1927,128,237,1574,4367,2022-03-21 09:39:16.000889
33759,42,178,10,67,156,453,2022-03-21 09:39:19.881371
33761,72,254,32,67,667,1092,2022-03-21 09:39:24.160424
33762,57,97,20,52,385,611,2022-03-21 09:39:25.596928
33763,38,71,10,52,172,343,2022-03-21 09:39:26.702492
33772,13,58,5,40,62,178,2022-03-21 09:39:32.737239
33773,13,48,2,34,57,154,2022-03-21 09:39:33.751018
33776,117,428,70,94,1165,1874,2022-03-21 09:39:34.556908
33779,38,266,18,67,317,706,2022-03-21 09:39:34.961434
33803,488,2522,273,920,1699,5902,2022-03-21 09:39:37.268743
33822,7,21,2,43,37,110,2022-03-21 09:39:41.306524
33823,8,43,2,46,60,159,2022-03-21 09:39:42.836219
33827,7,34,2,39,35,117,2022-03-21 09:39:46.428059
33835,36,85,14,74,157,366,2022-03-21 09:39:51.278573
33836,17213,89384,6852,18889,73679,206017,2022-03-21 09:39:51.473474
33839,566,4092,200,370,12666,17894,2022-03-21 09:39:58.396069
33840,1253,5953,793,2566,7857,18422,2022-03-21 09:40:00.968865
33842,10,45,5,46,53,159,2022-03-21 09:40:02.046987
33843,12,88,0,31,53,184,2022-03-21 09:40:03.38661
33845,786,18061,533,388,20371,40139,2022-03-21 09:40:03.566983
33846,47,350,42,107,525,1071,2022-03-21 09:40:08.085743
33849,10,65,3,37,46,161,2022-03-21 09:40:09.674011
33850,3148,12219,1165,3514,15241,35287,2022-03-21 09:40:12.658896
33854,53,22,5,31,69,180,2022-03-21 09:40:17.756807
33857,15,39,3,42,67,166,2022-03-21 09:40:22.136074
33859,20,1607,7,37,176,1847,2022-03-21 09:40:25.902804
33860,10,131,1,26,51,219,2022-03-21 09:40:27.109185
33861,9,114,1,32,53,209,2022-03-21 09:40:27.730213
33863,21,125,5,43,109,303,2022-03-21 09:40:29.845758
33866,7,245,3,23,48,326,2022-03-21 09:40:31.378852
33870,10,106,2,33,57,208,2022-03-21 09:40:33.952787
33871,24,394,6,48,116,588,2022-03-21 09:40:35.305335
33872,15,222,3,26,87,353,2022-03-21 09:40:36.553577
33875,17,175,15,48,201,456,2022-03-21 09:40:38.29723
33876,16,194,12,46,193,461,2022-03-21 09:40:39.350628
33877,17,208,15,48,225,513,2022-03-21 09:40:41.577231
33878,16,180,14,48,197,455,2022-03-21 09:40:43.048099
33879,17,176,14,49,199,455,2022-03-21 09:40:43.218066
33880,16,189,14,50,200,469,2022-03-21 09:40:43.396862
33886,12,395,4,21,58,490,2022-03-21 09:40:44.942706
33904,348,1,170,126,443,1088,2022-03-21 09:40:47.057632
33911,28,845,20,70,374,1337,2022-03-21 09:40:50.537057
33914,45,308,9,42,122,526,2022-03-21 09:40:55.256482
33915,15,191,9,57,129,401,2022-03-21 09:40:56.350005
33916,11,57,0,42,59,169,2022-03-21 09:40:57.943432
33922,68,0,27,73,121,289,2022-03-21 09:40:58.117026
33925,106,195,34,74,373,782,2022-03-21 09:41:00.197953
33926,24849,198536,8388,11243,84026,327042,2022-03-21 09:41:00.653541
33927,9,125,2,36,54,226,2022-03-21 09:41:02.334978
33929,2931,120414,1012,619,31494,156470,2022-03-21 09:41:02.776131
33933,106,64,24,195,659,1048,2022-03-21 09:41:05.344399
33934,213,7591,87,69,3403,11363,2022-03-21 09:41:05.556611
33936,26,239,1,30,81,377,2022-03-21 09:41:05.82794
33937,18,332,7,25,123,505,2022-03-21 09:41:06.097773
33938,8,99,0,16,30,153,2022-03-21 09:41:09.361134
33940,8,114,0,32,66,220,2022-03-21 09:41:11.993819
33945,14,101,3,39,70,227,2022-03-21 09:41:14.511573
33946,35,39,14,116,143,347,2022-03-21 09:41:15.693157
33949,534,18786,221,136,7528,27205,2022-03-21 09:41:23.921882
33950,1128,25737,359,520,8742,36486,2022-03-21 09:41:24.121367
33957,33,399,22,65,251,770,2022-03-21 09:41:25.711364
33958,23,141,4,34,128,330,2022-03-21 09:41:27.39272
33964,459,23363,228,325,5114,29489,2022-03-21 09:41:27.563438
33966,1563,5094,648,2069,7444,16818,2022-03-21 09:41:32.435119
33969,1167,3062,497,504,7668,12898,2022-03-21 09:41:34.748601
33970,2321,22201,645,295,13356,38818,2022-03-21 09:41:34.947025
33972,294,400,48,59,1715,2516,2022-03-21 09:41:37.543626
33975,104,1054,57,372,607,2194,2022-03-21 09:41:40.285777
33978,12,143,11,63,108,337,2022-03-21 09:41:41.584777
33980,22,46,5,51,153,277,2022-03-21 09:41:42.970411
33982,13,54,2,30,86,185,2022-03-21 09:41:44.104033
33983,3117,15074,1789,3039,14193,37212,2022-03-21 09:41:44.279675
33985,8449,44965,3811,15373,24437,97035,2022-03-21 09:41:47.324161
33986,43,118,17,61,367,606,2022-03-21 09:41:51.51001
33988,19700,248000,7844,9308,88414,373266,2022-03-21 09:41:55.076672
33994,617,5713,327,242,10161,17060,2022-03-21 09:41:55.285895
33997,134,1926,78,116,1705,3959,2022-03-21 09:41:57.723162
33999,11,60,5,43,128,247,2022-03-21 09:42:00.349492
34000,10,60,6,40,119,235,2022-03-21 09:42:02.197388
34003,86,1104,32,33,658,1913,2022-03-21 09:42:02.372364
34005,20,107,9,55,93,284,2022-03-21 09:42:03.726139
34006,2582,1191,1032,744,20203,25752,2022-03-21 09:42:04.797248
34008,249,2533,142,179,4728,7831,2022-03-21 09:42:08.296422
34009,3299,31132,1547,4395,16253,56626,2022-03-21 09:42:08.476585
34012,17308,108752,7637,13454,56125,203276,2022-03-21 09:42:14.069377
34013,282,1817,142,365,2175,4781,2022-03-21 09:42:14.267896
34016,243,2235,169,249,4334,7230,2022-03-21 09:42:19.02027
34021,1286,16800,347,207,14430,33070,2022-03-21 09:42:21.73047
34032,124,1283,65,111,2457,4040,2022-03-21 09:42:24.890832
34034,15165,41255,9374,13393,11520,90707,2022-03-21 09:42:28.164284
34038,13,107,9,64,103,296,2022-03-21 09:42:33.259566
34039,16,499,8,24,94,641,2022-03-21 09:42:34.702777
34048,195,3769,88,143,2677,6872,2022-03-21 09:42:38.130293
34050,46,593,14,48,408,1109,2022-03-21 09:42:40.193063
34051,10549,64449,5846,15189,36710,132743,2022-03-21 09:42:43.169304
34052,265,833,155,678,591,2522,2022-03-21 09:42:45.460012
34055,6755,103760,2126,6061,31995,150697,2022-03-21 09:42:45.641949
34060,75,1266,30,76,439,1886,2022-03-21 09:42:48.086527
34077,805,4928,278,538,2401,8950,2022-03-21 09:42:53.98185
34078,10,54,3,62,45,174,2022-03-21 09:42:56.231504
34083,18,157,2,27,107,311,2022-03-21 09:42:57.944291
34085,72,4638,52,78,902,5742,2022-03-21 09:42:58.12667
34086,9696,93091,4592,4707,34275,146361,2022-03-21 09:43:02.754812
34088,407,3837,182,848,1997,7271,2022-03-21 09:43:05.3854
34091,11,45,3,37,70,166,2022-03-21 09:43:06.547796
34096,13646,149277,4171,2808,90573,260475,2022-03-21 09:43:08.491379
34100,2218,48753,869,525,29084,81449,2022-03-21 09:43:08.92841
34102,13367,37942,8690,16806,56341,133146,2022-03-21 09:43:09.100691
34104,15786,144701,5035,12656,40498,218676,2022-03-21 09:43:09.539999
34112,12,58,6,29,71,176,2022-03-21 09:43:18.166356
34114,10,30,1,24,40,105,2022-03-21 09:43:21.006425
34115,6,137,2,24,40,209,2022-03-21 09:43:22.300824
34116,10,105,0,24,33,172,2022-03-21 09:43:23.475611
34117,14,387,3,29,89,522,2022-03-21 09:43:25.225532
34118,10,289,1,24,67,391,2022-03-21 09:43:26.380887
34120,12,313,2,21,76,424,2022-03-21 09:43:28.663579
34121,12,309,1,27,61,410,2022-03-21 09:43:30.383611
34122,9,160,2,17,46,234,2022-03-21 09:43:31.775358
34124,9,111,1,29,64,214,2022-03-21 09:43:33.090385
34125,717,11537,415,147,5523,18339,2022-03-21 09:43:33.275256
34129,59,134,29,95,273,590,2022-03-21 09:43:35.803777
34134,65837,1008406,16979,25223,250807,1367252,2022-03-21 09:43:36.00232
34136,2435,59226,1294,758,53245,116958,2022-03-21 09:43:36.185787
34140,56,258,14,62,421,811,2022-03-21 09:43:41.442423
34148,3486,40533,1256,2182,17764,65221,2022-03-21 09:43:43.991785
34152,1655,67857,668,356,19343,89879,2022-03-21 09:43:46.215055
34153,20,265,6,35,131,457,2022-03-21 09:43:48.462475
34156,34,118,8,105,225,490,2022-03-21 09:43:50.280262
34161,1861,36380,753,980,30281,70255,2022-03-21 09:43:50.448275
34163,18,42,9,37,64,170,2022-03-21 09:43:52.701765
34165,124,2834,91,112,1365,4526,2022-03-21 09:43:54.469672
34166,61,119,31,78,966,1255,2022-03-21 09:43:56.055885
34173,81,1706,26,63,726,2602,2022-03-21 09:44:00.98681
34176,15845,140107,6365,11411,55466,229194,2022-03-21 09:44:03.718482
34177,4626,25197,1853,3942,21658,57276,2022-03-21 09:44:06.976283
34178,466,4071,195,215,1518,6465,2022-03-21 09:44:09.770939
34179,50,316,10,34,343,753,2022-03-21 09:44:09.946627
34184,13,33,5,34,76,161,2022-03-21 09:44:14.453995
34185,5,24,2,34,44,109,2022-03-21 09:44:15.619801
34187,8,24,1,38,39,110,2022-03-21 09:44:18.594145
34188,7,18,1,40,35,101,2022-03-21 09:44:20.161063
34190,9,81,10,66,65,231,2022-03-21 09:44:22.20297
34192,6,54,1,40,44,145,2022-03-21 09:44:23.819002
34194,9,61,6,51,86,213,2022-03-21 09:44:26.619822
34197,271,1440,152,188,4544,6595,2022-03-21 09:44:26.822122
34204,902,10166,583,277,6741,18669,2022-03-21 09:44:35.295758
34205,57,0,21,85,98,261,2022-03-21 09:44:36.43559
34207,22,39,8,69,78,216,2022-03-21 09:44:38.060099
34208,358,2364,124,165,4184,7195,2022-03-21 09:44:40.174039
34209,3253,21708,1208,2746,15644,44559,2022-03-21 09:44:42.60283
34213,9332,59674,2668,3459,48217,123350,2022-03-21 09:44:42.815691
34223,167,808,98,993,1060,3126,2022-03-21 09:44:45.397478
34224,4,71,3,32,43,153,2022-03-21 09:44:46.946914
34233,29,68,8,93,127,325,2022-03-21 09:44:51.786714
34234,25,38,3,90,73,229,2022-03-21 09:44:52.993514
34235,25,40,7,95,97,264,2022-03-21 09:44:54.065585
34236,30,104,13,65,237,449,2022-03-21 09:44:55.364763
34237,43,0,9,44,82,178,2022-03-21 09:44:56.543845
34240,4200,267279,639,518,30085,302721,2022-03-21 09:45:05.68753
34243,61,685,39,49,556,1390,2022-03-21 09:45:05.885059
34244,52,1583,43,85,642,2405,2022-03-21 09:45:08.997035
34249,15,87,10,64,78,254,2022-03-21 09:45:12.701715
34252,75,1898,22,61,668,2724,2022-03-21 09:45:12.905754
34257,1019,7032,459,743,7607,16860,2022-03-21 09:45:16.576934
34258,13,32,5,42,112,204,2022-03-21 09:45:17.007087
34261,33,109,20,40,334,536,2022-03-21 09:45:19.620799
34262,8934,71853,3957,7192,33017,124953,2022-03-21 09:45:19.840231
34277,1231,47490,482,266,18947,68416,2022-03-21 09:45:22.901346
34279,29623,130646,11176,21830,70145,263420,2022-03-21 09:45:29.456775
34280,31204,398201,12312,25313,103049,570079,2022-03-21 09:45:33.595475
34283,92,3320,28,53,737,4230,2022-03-21 09:45:36.98091
43603,1,38,3,11,14,67,2022-03-21 11:30:59.405505
34284,2113,17906,950,980,17347,39296,2022-03-21 09:45:40.397963
34286,8,127,1,29,77,242,2022-03-21 09:45:42.902058
34289,1718,5420,788,3389,7566,18881,2022-03-21 09:45:43.072116
34290,1413,3615,775,721,3561,10085,2022-03-21 09:45:48.557343
34295,576,5363,249,552,2605,9345,2022-03-21 09:45:49.726752
34299,774,41168,352,278,9827,52399,2022-03-21 09:45:55.529622
34300,6062,69087,1497,2647,28288,107581,2022-03-21 09:45:58.095489
34302,98,1577,58,119,1197,3049,2022-03-21 09:45:58.285317
34307,13,196,8,33,128,378,2022-03-21 09:46:04.001482
34309,45,101,13,105,374,638,2022-03-21 09:46:05.447109
34310,23,129,14,72,193,431,2022-03-21 09:46:06.587345
34314,69,889,38,99,367,1462,2022-03-21 09:46:06.758323
34318,158,3021,96,102,2022,5399,2022-03-21 09:46:08.475076
34321,3944,139045,1168,908,34828,179893,2022-03-21 09:46:12.976623
34323,47,246,17,50,477,837,2022-03-21 09:46:14.46563
34324,71,1548,27,48,473,2167,2022-03-21 09:46:16.828534
34325,172,7824,150,146,1558,9850,2022-03-21 09:46:19.693382
34337,512,4075,234,817,2491,8129,2022-03-21 09:46:24.770153
34338,1864,23447,903,1773,12510,40497,2022-03-21 09:46:27.186654
34340,7,68,3,32,40,150,2022-03-21 09:46:27.717902
34342,7,17,4,28,40,96,2022-03-21 09:46:27.896432
34350,8514,51033,5859,11350,31830,108586,2022-03-21 09:46:31.138274
34353,15,83,9,60,85,252,2022-03-21 09:46:32.504537
34354,14,120,8,46,83,271,2022-03-21 09:46:32.694532
34355,7,55,9,50,57,178,2022-03-21 09:46:33.950944
34356,7,58,8,52,57,182,2022-03-21 09:46:35.056937
34358,14,87,4,52,109,266,2022-03-21 09:46:36.606347
34363,16,76,3,45,110,250,2022-03-21 09:46:37.78176
34367,66,718,36,76,561,1457,2022-03-21 09:46:41.575739
34369,16,67,8,63,81,235,2022-03-21 09:46:45.657901
34372,8,92,6,34,65,205,2022-03-21 09:46:50.437563
34373,18,93,8,50,91,260,2022-03-21 09:46:51.687042
34374,435,6548,228,177,6047,13435,2022-03-21 09:46:51.864566
34375,463,6515,228,184,5591,12981,2022-03-21 09:46:54.480274
34376,440,6446,218,200,5807,13111,2022-03-21 09:46:54.923656
34382,32492,266129,13154,37194,93567,442536,2022-03-21 09:46:55.362472
34383,8515,73358,3214,13604,41617,140308,2022-03-21 09:46:55.796765
34410,53,188,34,107,431,813,2022-03-21 09:46:57.891052
34420,3802,14918,1309,1824,10304,32157,2022-03-21 09:46:59.051905
34422,9,227,3,17,51,307,2022-03-21 09:47:03.280233
34423,9,143,0,18,52,222,2022-03-21 09:47:03.44804
34424,5,109,1,10,23,148,2022-03-21 09:47:03.717101
34425,7,82,1,16,28,134,2022-03-21 09:47:05.32401
34427,2852,11433,1317,4082,11146,30830,2022-03-21 09:47:08.446523
34428,1933,32804,750,849,25767,62103,2022-03-21 09:47:12.364842
34430,456,20100,202,220,4951,25929,2022-03-21 09:47:12.813167
34432,7,287,3,23,34,354,2022-03-21 09:47:14.185002
34436,11,155,8,53,105,332,2022-03-21 09:47:15.994704
34437,4656,145834,1637,1089,117275,270491,2022-03-21 09:47:16.42653
34438,2251,48163,971,720,33607,85712,2022-03-21 09:47:16.855453
34439,1290,33820,722,523,26946,63301,2022-03-21 09:47:17.024416
34443,26430,194011,10725,15203,50321,296690,2022-03-21 09:47:17.710692
34453,418,4200,100,189,3333,8240,2022-03-21 09:47:21.115874
34454,1371,2,353,454,4679,6859,2022-03-21 09:47:21.32454
34455,581,1428,177,205,4915,7306,2022-03-21 09:47:24.031284
34458,10,65,1,36,55,167,2022-03-21 09:47:28.690769
34464,43,430,7,36,288,804,2022-03-21 09:47:30.630708
34465,3772,34437,1872,723,22777,63581,2022-03-21 09:47:30.818325
34472,17,171,4,33,65,290,2022-03-21 09:47:38.00589
34474,1256,4612,583,1571,8072,16094,2022-03-21 09:47:38.222675
34475,130,1063,60,92,1241,2586,2022-03-21 09:47:38.479038
34476,34,87,7,36,197,361,2022-03-21 09:47:39.914956
34480,4490,108943,1516,757,29245,144951,2022-03-21 09:47:42.680272
34481,1027,27023,329,212,8077,36668,2022-03-21 09:47:42.863493
34486,157,0,46,59,448,710,2022-03-21 09:47:44.662482
34488,17,76,13,80,153,339,2022-03-21 09:47:45.876202
34489,70,803,36,85,825,1819,2022-03-21 09:47:47.072263
34494,14354,42828,9788,13850,54110,134930,2022-03-21 09:47:50.305823
34497,24720,307622,5687,20093,59037,417159,2022-03-21 09:47:56.036197
34498,4821,111413,1503,1342,61787,180866,2022-03-21 09:47:56.230503
34500,18,169,6,31,68,292,2022-03-21 09:47:56.697843
34502,65,398,17,134,369,983,2022-03-21 09:47:59.070054
34503,90,690,30,121,382,1313,2022-03-21 09:48:01.501612
34504,1687,28771,702,312,20045,51517,2022-03-21 09:48:01.956605
34511,16,157,8,56,109,346,2022-03-21 09:48:05.413313
34513,557,8218,209,206,12307,21497,2022-03-21 09:48:08.989671
34514,1338,41152,789,561,5021,48861,2022-03-21 09:48:09.165671
34522,886,4381,439,754,5870,12330,2022-03-21 09:48:15.496487
34525,6146,41044,3036,9589,22813,82628,2022-03-21 09:48:15.697541
34528,7,76,2,33,68,186,2022-03-21 09:48:18.670028
34532,262,2474,198,163,6515,9612,2022-03-21 09:48:23.008088
34533,533,17630,260,226,9395,28044,2022-03-21 09:48:23.221997
34534,1159,25425,495,241,11649,38969,2022-03-21 09:48:25.909085
34535,810,758,369,239,4376,6552,2022-03-21 09:48:29.737209
34537,3134,49456,1095,558,47689,101932,2022-03-21 09:48:30.170855
34538,111,1370,46,70,905,2502,2022-03-21 09:48:30.348807
34539,897,4831,453,1336,4983,12500,2022-03-21 09:48:33.364108
34541,1355,58794,593,365,22590,83697,2022-03-21 09:48:36.784621
34542,32262,320947,13278,18489,161581,546557,2022-03-21 09:48:37.239584
34543,3673,18835,1978,6530,16513,47529,2022-03-21 09:48:41.670938
34547,6960,21835,3680,7276,27711,67462,2022-03-21 09:48:47.668438
34548,71,522,70,76,1735,2474,2022-03-21 09:48:50.100969
34549,1752,18854,621,412,16715,38354,2022-03-21 09:48:52.704715
34550,1438,6581,948,3936,4260,17163,2022-03-21 09:48:52.883377
43605,0,11,1,8,8,28,2022-03-21 11:31:00.389048
34552,289,2388,175,211,1643,4706,2022-03-21 09:48:55.589574
34561,45896,184354,25337,32547,138794,426928,2022-03-21 09:48:55.766137
34565,5805,23149,2566,8023,24473,64016,2022-03-21 09:48:56.018938
34566,392186,8,94312,158523,84453,729482,2022-03-21 09:48:56.257205
34591,8972,76373,2991,1822,70691,160849,2022-03-21 09:48:57.047746
34604,1945,11642,554,378,8619,23138,2022-03-21 09:48:58.1949
34620,15288,44902,5857,13611,48230,127888,2022-03-21 09:48:59.497393
34623,111,1463,63,73,1348,3058,2022-03-21 09:49:05.528304
34625,29,296,13,45,143,526,2022-03-21 09:49:07.059448
34626,4065,266433,1084,505,39365,311452,2022-03-21 09:49:09.972699
34629,16,111,3,29,78,237,2022-03-21 09:49:11.945909
34630,19,82,5,43,75,224,2022-03-21 09:49:13.189606
34632,23,255,12,28,162,480,2022-03-21 09:49:17.526255
34633,13,311,2,21,71,418,2022-03-21 09:49:19.383735
34634,9,279,4,16,72,380,2022-03-21 09:49:19.572581
34636,23967,148654,11928,12954,86003,283506,2022-03-21 09:49:20.975451
34642,855,14854,332,159,8152,24352,2022-03-21 09:49:25.339495
34643,10,53,5,47,52,167,2022-03-21 09:49:26.960491
34644,306,4737,139,126,4134,9442,2022-03-21 09:49:29.769015
34647,245,11352,164,268,2791,14820,2022-03-21 09:49:33.001022
34649,284,1034,117,120,4875,6430,2022-03-21 09:49:33.176028
34651,15,123,2,33,64,237,2022-03-21 09:49:35.670204
34655,13,733,4,23,94,867,2022-03-21 09:49:39.255221
34656,12,407,3,29,75,526,2022-03-21 09:49:40.642772
34657,10,201,3,15,77,306,2022-03-21 09:49:40.820836
34658,1978,47846,666,657,22551,73698,2022-03-21 09:49:43.307751
34661,142,1201,66,105,1297,2811,2022-03-21 09:49:43.494231
34662,37967,249537,16714,23767,89739,417724,2022-03-21 09:49:47.26586
34665,13,59,3,48,41,164,2022-03-21 09:49:50.408758
34666,10,51,4,45,48,158,2022-03-21 09:49:52.198603
34669,32,153,21,83,358,647,2022-03-21 09:49:54.366288
34670,624,1841,252,355,3411,6483,2022-03-21 09:49:54.637223
34673,8,31,3,23,56,121,2022-03-21 09:49:56.129709
34674,21,50,13,26,295,405,2022-03-21 09:49:58.153186
34675,2126,3850,860,1204,8032,16072,2022-03-21 09:50:00.631318
34676,9,92,7,60,39,207,2022-03-21 09:50:01.860264
34677,8,91,4,60,38,201,2022-03-21 09:50:03.460439
34678,47,1065,19,52,569,1752,2022-03-21 09:50:05.522309
34683,0,0,0,0,4907,4907,2022-03-21 09:50:08.07759
34685,8,130,0,16,28,182,2022-03-21 09:50:08.257458
34688,14,63,3,22,103,205,2022-03-21 09:50:09.567597
34689,14,68,2,26,75,185,2022-03-21 09:50:10.96217
34691,10,93,1,18,58,180,2022-03-21 09:50:14.432117
34692,9,63,2,29,72,175,2022-03-21 09:50:15.560191
34695,12,67,2,30,67,178,2022-03-21 09:50:19.488737
34697,13,57,1,27,58,156,2022-03-21 09:50:21.738697
34698,11,50,5,27,55,148,2022-03-21 09:50:22.817402
34699,12,126,0,17,82,237,2022-03-21 09:50:24.197628
34700,8,77,1,34,55,175,2022-03-21 09:50:25.375623
34701,10,42,3,45,57,157,2022-03-21 09:50:27.047001
34704,7,16,2,40,35,100,2022-03-21 09:50:28.08162
34705,9,18,3,43,65,138,2022-03-21 09:50:29.629438
34706,8,27,3,38,51,127,2022-03-21 09:50:29.806041
34707,12,20,1,48,45,126,2022-03-21 09:50:29.974303
34708,10,105,2,31,44,192,2022-03-21 09:50:31.100073
34710,28,546,24,56,273,927,2022-03-21 09:50:32.681753
34711,7,58,2,38,42,147,2022-03-21 09:50:33.790599
34716,13,313,6,29,74,435,2022-03-21 09:50:39.075485
34717,7,50,1,32,35,125,2022-03-21 09:50:40.17114
34718,9,32,3,38,44,126,2022-03-21 09:50:41.463326
34720,10,362,3,24,45,444,2022-03-21 09:50:43.511575
34721,12,346,4,23,70,455,2022-03-21 09:50:45.029046
34722,10,98,4,21,36,169,2022-03-21 09:50:46.990805
34724,49,77,29,44,341,540,2022-03-21 09:50:51.00079
34726,28,34,4,47,69,182,2022-03-21 09:50:52.896936
34733,382,12102,170,165,5039,17858,2022-03-21 09:50:53.099229
34734,68,2411,29,66,1051,3625,2022-03-21 09:50:55.202057
34738,152,1722,55,201,654,2784,2022-03-21 09:50:55.371907
34741,92,166,50,175,452,935,2022-03-21 09:50:59.107293
34742,891,15157,457,536,5573,22614,2022-03-21 09:50:59.285283
34743,10,93,3,34,57,197,2022-03-21 09:50:59.539498
34744,14,37,6,34,84,175,2022-03-21 09:51:00.847709
34745,3219,9436,2226,2259,13067,30207,2022-03-21 09:51:03.52148
34753,567,14981,223,222,5235,21228,2022-03-21 09:51:08.7979
34754,246,328,207,217,1281,2279,2022-03-21 09:51:11.180466
34755,8,80,10,48,93,239,2022-03-21 09:51:11.36087
34756,8,51,10,56,97,222,2022-03-21 09:51:12.935666
34757,34,208,10,25,319,596,2022-03-21 09:51:14.754044
34762,33,195,25,68,431,752,2022-03-21 09:51:15.013534
34763,36,146,19,58,321,580,2022-03-21 09:51:18.386242
34764,42,153,21,67,393,676,2022-03-21 09:51:19.758194
34765,40,219,24,63,481,827,2022-03-21 09:51:19.922325
34766,119,1323,42,64,1332,2880,2022-03-21 09:51:20.179431
34771,604,1621,324,1529,5006,9084,2022-03-21 09:51:22.770965
34776,312,3003,157,131,3901,7504,2022-03-21 09:51:22.96516
34777,667,35522,395,236,9698,46518,2022-03-21 09:51:27.472493
34779,7,38,5,12,967,1029,2022-03-21 09:51:29.307979
34784,363,8073,215,171,5312,14134,2022-03-21 09:51:33.311769
34787,568,1739,252,427,2512,5498,2022-03-21 09:51:36.356162
34790,16,58,3,39,65,181,2022-03-21 09:51:37.558282
34792,1263,19802,525,239,22381,44210,2022-03-21 09:51:37.731367
34798,33497,200315,14840,9921,144768,403341,2022-03-21 09:51:42.343829
34799,411,689,177,571,1153,3001,2022-03-21 09:51:44.884507
34800,942,4429,527,1611,5561,13070,2022-03-21 09:51:48.035909
34812,440,4367,226,136,3309,8478,2022-03-21 09:51:50.535907
34813,20,144,15,39,157,375,2022-03-21 09:51:52.712378
34817,19,184,2,56,130,391,2022-03-21 09:51:55.354476
34818,478,1767,240,227,2018,4730,2022-03-21 09:51:58.022715
34822,27104,254467,12168,12342,156909,462990,2022-03-21 09:52:03.340489
34825,13006,86538,5883,10323,49089,164839,2022-03-21 09:52:07.068095
34826,17,101,8,42,153,321,2022-03-21 09:52:08.296768
34830,569,4027,303,275,12217,17391,2022-03-21 09:52:08.572641
34831,12,59,4,53,78,206,2022-03-21 09:52:10.91994
34832,0,0,0,0,3938,3938,2022-03-21 09:52:13.280149
34835,48,908,27,93,519,1595,2022-03-21 09:52:18.371544
34836,296,1969,100,298,845,3508,2022-03-21 09:52:18.581684
34839,5710,20146,2722,4851,17925,51354,2022-03-21 09:52:20.884802
34840,8,427,6,23,105,569,2022-03-21 09:52:23.21246
34841,18,57,7,53,122,257,2022-03-21 09:52:24.498399
34843,20,90,10,52,110,282,2022-03-21 09:52:25.591201
34845,58,1,30,59,136,284,2022-03-21 09:52:27.220348
34847,50,0,27,58,135,270,2022-03-21 09:52:27.411175
34849,12,327,6,24,215,584,2022-03-21 09:52:28.816232
34850,8,26,4,34,110,182,2022-03-21 09:52:30.297165
34851,16,194,5,39,147,401,2022-03-21 09:52:31.520191
34852,35,138,14,68,229,484,2022-03-21 09:52:31.698987
34855,1585,50337,768,336,10774,63800,2022-03-21 09:52:34.937563
34856,5,238,2,19,35,299,2022-03-21 09:52:36.181688
34858,13,148,1,14,35,211,2022-03-21 09:52:38.655283
34859,8,132,2,10,31,183,2022-03-21 09:52:39.01618
34860,7,173,1,13,56,250,2022-03-21 09:52:40.804204
34862,37,325,17,43,391,813,2022-03-21 09:52:44.262619
34863,1630,9774,736,880,12894,25914,2022-03-21 09:52:44.431064
34864,33,384,23,54,340,834,2022-03-21 09:52:46.050372
34866,8200,11810,3586,5760,10256,39612,2022-03-21 09:52:48.666035
34870,234,7619,109,113,2373,10448,2022-03-21 09:52:51.614793
34871,12,59,8,46,118,243,2022-03-21 09:52:52.920647
34872,13,130,4,60,91,298,2022-03-21 09:52:53.9727
34877,22,139,11,44,229,445,2022-03-21 09:52:55.640145
34878,15,247,13,35,247,557,2022-03-21 09:52:56.846099
34881,22768,290438,9300,22492,82705,427703,2022-03-21 09:52:59.235696
34884,866,11037,376,247,9133,21659,2022-03-21 09:53:02.65436
34889,9,328,2,22,65,426,2022-03-21 09:53:06.799592
34891,29,53,10,126,136,354,2022-03-21 09:53:08.064325
34892,18,107,9,34,127,295,2022-03-21 09:53:09.736396
34893,123,1030,71,80,1703,3007,2022-03-21 09:53:12.481678
34900,0,0,0,0,4792,4792,2022-03-21 09:53:15.114457
34901,838,8971,336,588,2254,12987,2022-03-21 09:53:15.571681
34903,842,3078,416,936,6648,11920,2022-03-21 09:53:23.490737
34904,592,25259,259,433,4666,31209,2022-03-21 09:53:26.622834
34905,141,255,50,219,878,1543,2022-03-21 09:53:26.817172
34908,5,267,5,23,62,362,2022-03-21 09:53:30.742266
34911,17,83,8,52,61,221,2022-03-21 09:53:32.120216
34914,13561,149740,6525,5102,56879,231807,2022-03-21 09:53:32.299856
34915,1711,6984,899,1227,8730,19551,2022-03-21 09:53:35.412748
34918,12,81,2,37,50,182,2022-03-21 09:53:37.424926
34924,9,41,1,38,59,148,2022-03-21 09:53:39.848497
34927,141,209,60,158,1057,1625,2022-03-21 09:53:44.192647
34929,7,316,3,20,62,408,2022-03-21 09:53:46.13472
34930,17,645,7,30,97,796,2022-03-21 09:53:47.78235
34933,65681,927382,26675,50536,156959,1227233,2022-03-21 09:53:48.665828
34934,23573,203324,9621,20447,95551,352516,2022-03-21 09:53:49.02956
34939,251,1441,81,107,2553,4433,2022-03-21 09:53:50.469208
34949,19,23,3,34,67,146,2022-03-21 09:53:52.73824
43606,0,8,1,6,10,25,2022-03-21 11:31:01.773973
34952,2,271,2,10,33,318,2022-03-21 09:53:53.610176
34957,8,247,2,25,120,402,2022-03-21 09:53:55.306558
34958,9,285,5,27,52,378,2022-03-21 09:53:56.595267
34962,673,33615,336,253,10215,45092,2022-03-21 09:54:01.683337
34964,12822,88001,4382,12337,45013,162555,2022-03-21 09:54:01.879803
34966,3577,21772,1459,2145,23706,52659,2022-03-21 09:54:02.137564
34972,626,8842,289,183,13751,23691,2022-03-21 09:54:02.762087
34973,6085,62434,2837,2498,28187,102041,2022-03-21 09:54:06.110206
34974,156,982,76,105,2439,3758,2022-03-21 09:54:07.279301
34978,842,6083,392,410,2151,9878,2022-03-21 09:54:10.290753
34979,113,350,42,183,282,970,2022-03-21 09:54:12.447427
34980,19,158,4,53,102,336,2022-03-21 09:54:14.267757
34984,20158,120525,8343,9409,93991,252426,2022-03-21 09:54:15.85655
34985,68,101,28,76,369,642,2022-03-21 09:54:20.69375
34990,43,0,15,74,81,213,2022-03-21 09:54:21.846796
34993,7,209,5,29,54,304,2022-03-21 09:54:25.058087
34997,39,203,12,41,246,541,2022-03-21 09:54:26.641637
34999,207,1319,79,75,1852,3532,2022-03-21 09:54:29.159726
35000,1228,26533,499,261,11823,40344,2022-03-21 09:54:32.010443
35002,15,106,8,67,60,256,2022-03-21 09:54:33.357704
35006,103,6439,56,80,1710,8388,2022-03-21 09:54:37.513107
35007,15,121,3,38,78,255,2022-03-21 09:54:41.067477
35008,32,49,8,61,104,254,2022-03-21 09:54:42.191419
35009,333,8379,161,310,3018,12201,2022-03-21 09:54:44.649984
35015,4139,45050,1782,1762,27829,80562,2022-03-21 09:54:46.745071
35020,7,24,2,32,34,99,2022-03-21 09:54:52.175317
35022,8,57,2,37,55,159,2022-03-21 09:54:55.021691
35023,7,22,2,34,36,101,2022-03-21 09:54:56.137239
35024,7,16,2,33,36,94,2022-03-21 09:54:57.320685
35025,49,112,20,109,342,632,2022-03-21 09:54:59.206951
35027,7,18,1,36,36,98,2022-03-21 09:55:01.88935
35030,8,19,1,35,42,105,2022-03-21 09:55:02.071364
35034,10,46,2,41,52,151,2022-03-21 09:55:07.621536
35036,9,119,4,39,66,237,2022-03-21 09:55:09.012436
35038,9,61,5,50,49,174,2022-03-21 09:55:09.838239
35039,8,83,5,47,73,216,2022-03-21 09:55:11.735592
35040,6,29,2,41,35,113,2022-03-21 09:55:11.911001
35049,7,36,3,49,54,149,2022-03-21 09:55:12.9366
35057,9,25,2,39,41,116,2022-03-21 09:55:15.141093
35058,11,20,0,41,38,110,2022-03-21 09:55:16.227763
35060,12,41,4,43,59,159,2022-03-21 09:55:17.462565
35062,107250,343229,50263,39173,221656,761571,2022-03-21 09:55:21.433856
35063,125,1349,80,82,1374,3010,2022-03-21 09:55:24.286001
35067,6157,22743,3348,2946,14456,49650,2022-03-21 09:55:27.144541
35069,1605,7786,630,3458,7996,21475,2022-03-21 09:55:31.155978
35070,26,158,14,117,352,667,2022-03-21 09:55:31.341794
35072,383,8870,189,243,3730,13415,2022-03-21 09:55:34.737916
35073,40481,666438,10519,10871,97172,825481,2022-03-21 09:55:35.106874
35074,16,88,11,35,170,320,2022-03-21 09:55:35.280888
35076,17608,156653,5875,15246,64354,259736,2022-03-21 09:55:39.665707
35077,42,615,15,45,522,1239,2022-03-21 09:55:39.861405
35078,8207,33781,4075,5603,37131,88797,2022-03-21 09:55:42.580593
35079,13936,82004,7464,9403,61609,174416,2022-03-21 09:55:42.751797
35081,93,901,38,73,1005,2110,2022-03-21 09:55:43.012628
35082,626,8576,352,283,15041,24878,2022-03-21 09:55:48.257372
35085,6,17,1,38,31,93,2022-03-21 09:55:50.603574
35086,453,2765,267,125,10156,13766,2022-03-21 09:55:50.799245
35090,8,59,1,28,41,137,2022-03-21 09:55:55.896167
35092,5,20,3,31,28,87,2022-03-21 09:55:58.754496
35095,8,45,4,39,58,154,2022-03-21 09:55:59.593636
35100,7,55,1,42,39,144,2022-03-21 09:56:02.481382
35101,6,19,1,38,33,97,2022-03-21 09:56:04.334288
35102,69,539,26,105,943,1682,2022-03-21 09:56:04.517992
35103,8,20,1,39,50,118,2022-03-21 09:56:05.900663
35105,9,25,3,34,57,128,2022-03-21 09:56:07.283279
35106,11,42,2,47,49,151,2022-03-21 09:56:09.131126
35109,7,25,2,36,36,106,2022-03-21 09:56:13.420054
35110,1519,42086,573,502,19578,64258,2022-03-21 09:56:13.879102
35111,1520,39767,548,490,19337,61662,2022-03-21 09:56:14.313413
35113,112,501,73,190,970,1846,2022-03-21 09:56:16.673993
35114,815,4512,454,2248,5048,13077,2022-03-21 09:56:19.874655
35115,33,450,15,54,272,824,2022-03-21 09:56:21.249259
35116,35,171,35,63,239,543,2022-03-21 09:56:22.865008
35118,411,9021,250,223,5280,15185,2022-03-21 09:56:25.325926
35119,11,193,0,18,50,272,2022-03-21 09:56:26.852976
35120,40241,679637,19649,27455,159912,926894,2022-03-21 09:56:27.400029
35121,32,86,12,36,226,392,2022-03-21 09:56:28.723171
35122,933,9294,506,603,11576,22912,2022-03-21 09:56:29.167524
35123,7,32,4,43,41,127,2022-03-21 09:56:30.627575
35124,5,20,2,35,33,95,2022-03-21 09:56:31.587818
35125,7,72,8,49,84,220,2022-03-21 09:56:33.189385
35126,6,64,9,50,80,209,2022-03-21 09:56:34.887279
35127,6,17,0,40,32,95,2022-03-21 09:56:35.876268
35128,13,184,8,52,198,455,2022-03-21 09:56:36.051386
35129,16,198,11,50,212,487,2022-03-21 09:56:38.206572
35133,17,67,5,45,62,196,2022-03-21 09:56:41.396159
35134,471,3648,241,217,11627,16204,2022-03-21 09:56:44.470994
35135,281,1936,158,132,8535,11042,2022-03-21 09:56:46.827012
35136,102,142,87,42,10364,10737,2022-03-21 09:56:46.997927
35137,32,246,23,52,334,687,2022-03-21 09:56:47.170929
35138,25,62,8,52,181,328,2022-03-21 09:56:49.129093
35140,41,71,11,72,138,333,2022-03-21 09:56:50.8306
35142,33,78,13,77,136,337,2022-03-21 09:56:54.378487
35143,17,163,8,67,93,348,2022-03-21 09:56:55.376418
35145,4372,63385,1874,1073,19952,90656,2022-03-21 09:56:55.811883
35149,9,50,1,44,38,142,2022-03-21 09:56:58.996944
35150,4,27,2,55,38,126,2022-03-21 09:57:00.655626
35151,6,46,0,42,35,129,2022-03-21 09:57:02.725936
35154,5,18,1,36,30,90,2022-03-21 09:57:05.737724
35156,33,302,10,66,292,703,2022-03-21 09:57:08.584564
35158,31,281,18,69,322,721,2022-03-21 09:57:09.901862
35160,5,46,3,39,42,135,2022-03-21 09:57:13.981712
35162,5,21,1,43,34,104,2022-03-21 09:57:16.281205
35163,7,27,3,38,35,110,2022-03-21 09:57:17.322688
35167,4,19,4,37,33,97,2022-03-21 09:57:22.133423
35170,7,58,0,43,38,146,2022-03-21 09:57:25.433807
35171,7,38,1,48,48,142,2022-03-21 09:57:27.009137
35173,6,23,0,41,35,105,2022-03-21 09:57:28.571789
35174,6,20,0,34,33,93,2022-03-21 09:57:29.604317
35176,8,38,5,42,47,140,2022-03-21 09:57:32.14512
35177,8,63,4,38,55,168,2022-03-21 09:57:33.2368
35180,23006,194854,9015,4268,111179,342322,2022-03-21 09:57:33.756381
35183,989,4483,463,2407,2675,11017,2022-03-21 09:57:40.305856
35191,679,15881,471,351,15970,33352,2022-03-21 09:57:42.847863
35198,1451,37544,786,480,27833,68094,2022-03-21 09:57:43.301256
35202,289,3101,133,150,2874,6547,2022-03-21 09:57:47.661787
35203,20619,340481,5201,28394,52671,447366,2022-03-21 09:57:47.841946
35204,428,1752,162,260,1526,4128,2022-03-21 09:57:48.101129
35206,69,1250,48,86,1117,2570,2022-03-21 09:57:51.093887
35212,10,79,10,93,113,305,2022-03-21 09:57:52.372517
35213,0,0,0,0,342,342,2022-03-21 09:57:53.683067
35219,36,169,30,111,770,1116,2022-03-21 09:57:55.791022
35220,8062,26242,3649,7040,17372,62365,2022-03-21 09:57:56.052429
35224,503,4580,201,400,4214,9898,2022-03-21 09:58:00.437221
35226,53,26,21,155,136,391,2022-03-21 09:58:02.318229
35229,41,0,10,40,69,160,2022-03-21 09:58:05.854134
35230,176,350,60,98,1350,2034,2022-03-21 09:58:08.40577
35231,114,1541,56,82,2730,4523,2022-03-21 09:58:10.810998
35234,15,47,7,48,114,231,2022-03-21 09:58:12.36481
35235,220,1437,93,163,1758,3671,2022-03-21 09:58:13.370942
35239,27,95,15,61,386,584,2022-03-21 09:58:16.269603
35240,13503,82246,6925,7850,71051,181575,2022-03-21 09:58:18.92557
35241,11368,51528,5395,7920,56620,132831,2022-03-21 09:58:19.119315
35242,8,61,6,56,59,190,2022-03-21 09:58:23.818757
35243,9,28,2,35,79,153,2022-03-21 09:58:25.502398
35247,13530,203302,4579,2130,116284,339825,2022-03-21 09:58:25.684153
35249,11277,48727,4131,6734,39956,110825,2022-03-21 09:58:26.322815
35250,2745,6810,1765,7093,14672,33085,2022-03-21 09:58:29.507425
35251,4134,12937,1541,5482,15587,39681,2022-03-21 09:58:36.313255
35252,3642,13339,1427,6938,12102,37448,2022-03-21 09:58:40.291619
35254,170,486,72,236,729,1693,2022-03-21 09:58:40.469708
35255,623,2686,305,309,3742,7665,2022-03-21 09:58:40.730776
35262,3904,135931,1068,1618,23909,166430,2022-03-21 09:58:41.171455
43607,0,13,1,8,10,32,2022-03-21 11:31:02.626503
35267,766,5783,632,608,10038,17827,2022-03-21 09:58:43.982526
35274,5,32,2,39,27,105,2022-03-21 09:58:47.49262
35281,9,24,1,38,34,106,2022-03-21 09:58:52.807763
35294,7,238,4,17,41,307,2022-03-21 09:58:54.925556
35295,16,49,8,84,66,223,2022-03-21 09:58:56.122391
35297,24,87,10,24,187,332,2022-03-21 09:58:57.301625
35298,5715,23888,2396,6680,18621,57300,2022-03-21 09:59:00.481637
35300,1579,0,613,457,8731,11380,2022-03-21 09:59:00.653494
35301,28,301,29,53,509,920,2022-03-21 09:59:00.917064
35302,48,201,21,85,276,631,2022-03-21 09:59:01.185952
35309,26,51,10,58,87,232,2022-03-21 09:59:03.540881
35310,13,120,11,44,83,271,2022-03-21 09:59:04.838533
35311,53,0,26,52,103,234,2022-03-21 09:59:05.404734
35314,806,31352,330,191,10481,43160,2022-03-21 09:59:10.847537
35315,710,10148,327,208,8824,20217,2022-03-21 09:59:13.259421
35317,18,71,8,69,92,258,2022-03-21 09:59:13.429458
35319,33,53,16,111,219,432,2022-03-21 09:59:14.880451
35320,822,25460,375,273,10594,37524,2022-03-21 09:59:15.227712
35321,616,14997,454,326,14535,30928,2022-03-21 09:59:15.39436
35327,138,6878,95,150,2194,9455,2022-03-21 09:59:15.950107
35334,469,2111,328,498,3216,6622,2022-03-21 09:59:19.681797
35335,0,0,0,0,4481,4481,2022-03-21 09:59:19.884692
35338,2521,83247,789,500,19777,106834,2022-03-21 09:59:20.143619
35345,16,115,11,43,140,325,2022-03-21 09:59:26.925369
35346,167,2955,74,117,1262,4575,2022-03-21 09:59:28.447303
35347,156,3160,57,82,1710,5165,2022-03-21 09:59:30.61023
35349,65,0,31,51,152,299,2022-03-21 09:59:31.899349
35350,13,66,2,22,31,134,2022-03-21 09:59:32.956173
35353,30,161,5,34,124,354,2022-03-21 09:59:34.806591
35363,3098,153698,871,462,25908,184037,2022-03-21 09:59:34.970921
35364,10,56,5,38,46,155,2022-03-21 09:59:36.270489
35366,9,240,2,37,61,349,2022-03-21 09:59:37.646454
35370,496,8025,212,246,3518,12497,2022-03-21 09:59:43.775996
35372,56,0,13,82,90,241,2022-03-21 09:59:48.009321
35376,13260,145012,6653,6928,52794,224647,2022-03-21 09:59:48.915979
35379,22,153,6,56,105,342,2022-03-21 09:59:50.839534
35382,1247,48181,505,526,21353,71812,2022-03-21 09:59:51.010765
35383,49,333,22,110,236,750,2022-03-21 09:59:54.011253
35386,10,310,3,30,49,402,2022-03-21 09:59:57.850598
35387,11,232,3,27,52,325,2022-03-21 09:59:59.090486
35389,9,248,1,28,49,335,2022-03-21 10:00:01.957642
35390,15,313,5,39,58,430,2022-03-21 10:00:03.142165
35395,14,263,2,29,44,352,2022-03-21 10:00:07.850871
35399,12,298,5,28,91,434,2022-03-21 10:00:10.800993
35400,18,272,5,30,120,445,2022-03-21 10:00:12.186663
35401,8,247,2,33,67,357,2022-03-21 10:00:13.955014
35404,9,326,6,38,78,457,2022-03-21 10:00:19.081368
35405,10,478,4,27,70,589,2022-03-21 10:00:19.361079
35407,11,324,6,33,54,428,2022-03-21 10:00:24.012439
35408,11,351,2,30,61,455,2022-03-21 10:00:25.391057
35410,13,364,3,49,91,520,2022-03-21 10:00:28.040832
35411,213,293,41,110,1009,1666,2022-03-21 10:00:30.080999
35416,56,338,28,46,1243,1711,2022-03-21 10:00:32.286143
35417,836,4990,314,436,5444,12020,2022-03-21 10:00:34.847018
35418,423,2788,167,161,3217,6756,2022-03-21 10:00:37.770001
35423,12,340,4,21,65,442,2022-03-21 10:00:41.695386
35424,354,2287,214,123,7726,10704,2022-03-21 10:00:41.895085
35425,243,1912,178,107,6472,8912,2022-03-21 10:00:47.521211
35433,36,264,13,60,270,643,2022-03-21 10:00:51.705152
35443,34,114,13,57,311,529,2022-03-21 10:00:56.839904
35447,27,278,17,88,170,580,2022-03-21 10:00:57.684992
35448,347,4811,158,519,1195,7030,2022-03-21 10:01:00.06675
35452,10,50,3,36,51,150,2022-03-21 10:01:03.100384
35453,18,93,5,36,115,267,2022-03-21 10:01:04.253879
35456,4,125,1,13,31,174,2022-03-21 10:01:06.758783
35458,153,1536,53,51,1277,3070,2022-03-21 10:01:06.954766
35459,2817,137084,991,559,32142,173593,2022-03-21 10:01:07.387003
35480,199,220,86,142,3885,4532,2022-03-21 10:01:13.965912
35484,10639,112386,3588,6867,48108,181588,2022-03-21 10:01:16.795691
35489,8,35,4,34,48,129,2022-03-21 10:01:20.399589
35490,16,71,12,84,77,260,2022-03-21 10:01:21.825931
35491,13,77,14,87,74,265,2022-03-21 10:01:23.058771
35492,24,497,5,46,81,653,2022-03-21 10:01:23.900968
35493,5,34,7,58,44,148,2022-03-21 10:01:25.005436
35494,7,113,7,40,125,292,2022-03-21 10:01:26.15846
35495,8,47,1,26,60,142,2022-03-21 10:01:27.396978
35496,8,82,2,28,57,177,2022-03-21 10:01:28.478402
35497,19,143,11,51,191,415,2022-03-21 10:01:30.024668
35500,1,1,1,0,79538,79541,2022-03-21 10:01:30.298021
35501,61,356,30,48,599,1094,2022-03-21 10:01:30.474382
35502,20,145,2,22,97,286,2022-03-21 10:01:33.025361
35503,5702,27456,2959,3557,29960,69634,2022-03-21 10:01:33.376619
35504,23,112,10,29,279,453,2022-03-21 10:01:33.546472
35508,10,35,4,43,49,141,2022-03-21 10:01:35.060554
35510,174,534,100,181,1136,2125,2022-03-21 10:01:36.995944
35513,13,94,2,42,59,210,2022-03-21 10:01:40.269546
35514,10,147,1,11,35,204,2022-03-21 10:01:40.443642
35516,107,160,33,183,523,1006,2022-03-21 10:01:42.59072
35517,37,79,18,121,191,446,2022-03-21 10:01:43.945244
35519,17,92,13,53,172,347,2022-03-21 10:01:45.118789
35520,15,58,4,43,95,215,2022-03-21 10:01:46.934153
35521,12,59,4,41,93,209,2022-03-21 10:01:48.161518
35525,9,126,2,28,29,194,2022-03-21 10:01:49.191945
35526,16,106,4,16,79,221,2022-03-21 10:01:50.331018
35528,15,66,5,40,65,191,2022-03-21 10:01:53.301941
35529,12,63,5,37,52,169,2022-03-21 10:01:54.423121
35530,7,107,1,18,27,160,2022-03-21 10:01:54.589678
35533,12,102,1,16,41,172,2022-03-21 10:01:57.204732
35538,14,89,4,46,110,263,2022-03-21 10:01:59.011211
35542,37,148,9,65,134,393,2022-03-21 10:02:02.615051
35543,37,127,9,69,128,370,2022-03-21 10:02:04.819115
35545,21,86,7,57,99,270,2022-03-21 10:02:06.691292
35551,42,1815,34,72,543,2506,2022-03-21 10:02:07.129725
35552,423,0,308,173,546,1450,2022-03-21 10:02:07.553968
35554,10,417,3,14,51,495,2022-03-21 10:02:11.726005
35557,21345,191322,9144,8326,148215,378352,2022-03-21 10:02:11.933118
35559,480,5260,165,284,3196,9385,2022-03-21 10:02:12.195447
35560,9,121,1,14,28,173,2022-03-21 10:02:12.853186
35566,826,8086,386,249,11414,20961,2022-03-21 10:02:13.298519
35586,58,86,20,45,385,594,2022-03-21 10:02:17.443251
35588,4,105,1,16,23,149,2022-03-21 10:02:19.797657
35589,9417,22222,3842,9012,27504,71997,2022-03-21 10:02:22.769758
35590,49,0,26,73,67,215,2022-03-21 10:02:24.048984
35593,12,116,6,41,93,268,2022-03-21 10:02:26.050909
35594,45,77,19,50,504,695,2022-03-21 10:02:27.479632
35602,362,12752,181,186,3542,17023,2022-03-21 10:02:27.659829
35605,24,58,11,60,108,261,2022-03-21 10:02:33.45093
35609,142,256,87,52,3958,4495,2022-03-21 10:02:39.154211
35610,19,230,1,30,127,407,2022-03-21 10:02:40.55173
35612,15,155,7,42,128,347,2022-03-21 10:02:43.413589
35616,10,77,2,29,54,172,2022-03-21 10:02:44.568901
35621,46,0,15,63,100,224,2022-03-21 10:02:49.520861
35623,28,127,6,29,112,302,2022-03-21 10:02:50.699058
35624,73,351,17,45,642,1128,2022-03-21 10:02:53.039153
35626,1105,7824,261,685,3393,13268,2022-03-21 10:02:53.839221
35627,15,72,9,35,122,253,2022-03-21 10:02:55.178499
35628,21,202,10,52,152,437,2022-03-21 10:02:56.665201
35629,3530,24891,1117,4871,12870,47279,2022-03-21 10:02:59.45069
35631,167,1875,106,235,1972,4355,2022-03-21 10:03:02.254495
35632,10,204,15,46,135,410,2022-03-21 10:03:03.436157
35633,4,20,5,28,51,108,2022-03-21 10:03:04.490925
35635,176,761,66,117,1082,2202,2022-03-21 10:03:06.544486
35639,17859,128539,7712,11866,97753,263729,2022-03-21 10:03:10.05061
35641,7,42,2,41,70,162,2022-03-21 10:03:11.736962
35642,16,184,9,49,77,335,2022-03-21 10:03:13.703078
35643,26,133,12,50,91,312,2022-03-21 10:03:15.926137
35645,294,2803,170,146,7510,10923,2022-03-21 10:03:16.110752
35650,132,196,48,89,413,878,2022-03-21 10:03:21.552061
35652,38,434,18,74,378,942,2022-03-21 10:03:23.772131
35654,58,1967,19,59,460,2563,2022-03-21 10:03:23.993759
35656,41,71,17,81,471,681,2022-03-21 10:03:27.328383
35658,739,21522,249,248,5097,27855,2022-03-21 10:03:30.545679
35663,7,121,1,12,32,173,2022-03-21 10:03:30.727464
35667,9,241,1,28,56,335,2022-03-21 10:03:34.374439
35669,7,89,1,20,33,150,2022-03-21 10:03:35.709078
35671,6,100,2,25,31,164,2022-03-21 10:03:37.990733
35674,8,61,3,25,61,158,2022-03-21 10:03:44.896936
35677,3390,49857,1210,529,55126,110112,2022-03-21 10:03:48.054239
35678,1085,25527,486,211,24734,52043,2022-03-21 10:03:48.576071
35682,7,45,12,38,279,381,2022-03-21 10:03:50.778511
35684,18,154,5,24,144,345,2022-03-21 10:03:55.006901
35686,389,0,91,138,305,923,2022-03-21 10:03:55.21321
35694,121,0,41,149,140,451,2022-03-21 10:03:57.151314
35696,48,0,21,73,111,253,2022-03-21 10:03:59.935133
35697,50,0,15,84,95,244,2022-03-21 10:04:00.980102
35698,51,0,12,76,78,217,2022-03-21 10:04:02.338163
35700,25,33,7,39,50,154,2022-03-21 10:04:03.84845
35701,71,0,41,38,51,201,2022-03-21 10:04:05.152855
35702,8,105,1,27,52,193,2022-03-21 10:04:07.265233
35704,15,248,7,59,129,458,2022-03-21 10:04:07.699446
35710,12,74,3,68,76,233,2022-03-21 10:04:09.622849
35712,17821,129980,7527,20365,59749,235442,2022-03-21 10:04:10.599963
35716,0,0,0,0,12911,12911,2022-03-21 10:04:11.082872
35732,7,143,1,12,33,196,2022-03-21 10:04:13.768402
35734,10,209,5,17,38,279,2022-03-21 10:04:14.06382
35739,288,2836,146,701,1080,5051,2022-03-21 10:04:17.807543
35740,72,3505,68,88,850,4583,2022-03-21 10:04:22.920682
35745,32,167,18,76,356,649,2022-03-21 10:04:24.23472
35749,6,191,1,24,46,268,2022-03-21 10:04:28.769455
35752,113,2932,38,64,1074,4221,2022-03-21 10:04:31.030736
35756,10936,63337,3952,5868,45370,129463,2022-03-21 10:04:31.205116
35757,2985,32055,878,1387,14645,51950,2022-03-21 10:04:33.794674
35759,467,607,229,70,19450,20823,2022-03-21 10:04:38.708752
35760,70414,1639177,11983,7720,151426,1880720,2022-03-21 10:04:38.888446
35770,1017,827,634,428,3527,6433,2022-03-21 10:04:39.333912
35774,87,706,48,72,1448,2361,2022-03-21 10:04:44.541806
35776,89,3066,45,33,972,4205,2022-03-21 10:04:47.219368
35777,792,8345,506,508,2652,12803,2022-03-21 10:04:51.000889
35778,81,1240,48,65,663,2097,2022-03-21 10:04:53.859649
35783,7,81,1,19,32,140,2022-03-21 10:04:57.593599
35785,7,168,4,20,61,260,2022-03-21 10:05:01.179314
35786,6,181,2,29,33,251,2022-03-21 10:05:03.948486
35788,39634,686195,10709,9015,98479,844032,2022-03-21 10:05:06.72054
35789,4362,30887,1347,1044,13063,50703,2022-03-21 10:05:06.899431
35790,110691,935595,20918,34412,169076,1270692,2022-03-21 10:05:07.979175
35798,477,18566,175,189,4973,24380,2022-03-21 10:05:08.405516
35800,12,553,11,24,136,736,2022-03-21 10:05:12.539648
35806,1050,62363,469,268,14344,78494,2022-03-21 10:05:13.010184
35809,11,493,15,22,113,654,2022-03-21 10:05:13.274502
35814,427,8591,200,179,6531,15928,2022-03-21 10:05:19.728529
35817,17,62,7,52,89,227,2022-03-21 10:05:21.598583
35821,7617,53664,3514,6325,33764,104884,2022-03-21 10:05:23.538173
35828,10758,55576,4768,6140,38401,115643,2022-03-21 10:05:27.934931
35834,3590,27651,1764,3689,16944,53638,2022-03-21 10:05:28.143498
35835,3209,12026,1389,5359,15854,37837,2022-03-21 10:05:33.860334
35838,23374,117633,12543,9825,118449,281824,2022-03-21 10:05:34.314207
35839,31181,207013,13951,8775,165406,426326,2022-03-21 10:05:34.496187
43608,25,3,11,1,278997,279037,2022-03-21 11:31:02.79919
35840,1029,11134,376,505,6420,19464,2022-03-21 10:05:38.136304
35842,4721,28741,1879,1836,47828,85005,2022-03-21 10:05:38.569507
35843,8795,105243,2622,1490,49370,167520,2022-03-21 10:05:39.007561
35848,5600,136190,1567,1031,87226,231614,2022-03-21 10:05:41.865701
35849,113773,961930,34102,74970,191110,1375885,2022-03-21 10:05:42.344925
35851,11497,179276,3345,1185,148319,343622,2022-03-21 10:05:42.684288
35855,0,0,0,0,1219,1219,2022-03-21 10:05:43.179825
35883,442,4485,186,245,2875,8233,2022-03-21 10:05:44.325523
35889,11118,66670,4658,8330,47920,138696,2022-03-21 10:05:49.636219
35890,15,64,6,49,98,232,2022-03-21 10:05:52.484129
35909,62,237,37,76,491,903,2022-03-21 10:05:57.457101
35910,9,46,4,41,42,142,2022-03-21 10:05:58.524574
35914,17,50,8,108,83,266,2022-03-21 10:06:02.687792
35920,40,120,20,68,100,348,2022-03-21 10:06:04.925416
35921,10,126,8,48,119,311,2022-03-21 10:06:06.289884
35923,227,2395,130,507,1711,4970,2022-03-21 10:06:08.4682
35928,17266,116147,6078,16250,71756,227497,2022-03-21 10:06:08.922691
35932,264,2723,88,54,2776,5905,2022-03-21 10:06:12.23622
35935,8,170,2,9,34,223,2022-03-21 10:06:14.733097
35946,3081,208496,1007,901,44556,258041,2022-03-21 10:06:17.440616
35949,262,6605,100,116,3423,10506,2022-03-21 10:06:17.61521
35952,67,481,48,77,996,1669,2022-03-21 10:06:20.358932
35956,12,49,3,40,54,158,2022-03-21 10:06:23.875613
35957,28,73,12,93,225,431,2022-03-21 10:06:25.271034
35960,371,3761,202,105,13122,17561,2022-03-21 10:06:26.53184
35964,3414,9105,1461,4495,14933,33408,2022-03-21 10:06:32.056873
35968,56408,517794,19772,16256,174197,784427,2022-03-21 10:06:32.953545
35972,51118,244118,15182,14582,97401,422401,2022-03-21 10:06:33.942959
43611,3,10,1,15,21,50,2022-03-21 11:31:04.465688
35980,12,127,1,22,53,215,2022-03-21 10:06:35.89241
35992,16,342,7,24,167,556,2022-03-21 10:06:38.654011
35994,46571,297844,21890,43785,136932,547022,2022-03-21 10:06:38.865425
35997,3634,13618,1594,6644,12524,38014,2022-03-21 10:06:45.287512
35999,77,284,66,790,3755,4972,2022-03-21 10:06:47.884329
36000,1458,5456,673,4275,7703,19565,2022-03-21 10:06:51.069002
36002,19,57,4,61,73,214,2022-03-21 10:06:56.116819
43613,1,8,0,10,11,30,2022-03-21 11:31:05.739124
36006,0,0,0,0,6533,6533,2022-03-21 10:07:03.118969
36009,1635,7454,887,4358,7097,21431,2022-03-21 10:07:03.326339
36015,5,25,2,24,54,110,2022-03-21 10:07:04.791138
36016,14,73,11,42,74,214,2022-03-21 10:07:05.949208
36021,110,222,48,55,806,1241,2022-03-21 10:07:09.411807
36022,465,3913,161,313,1873,6725,2022-03-21 10:07:12.673016
36023,28109,80751,12581,28732,70809,220982,2022-03-21 10:07:15.163419
36027,13339,122327,4503,27933,44421,212523,2022-03-21 10:07:16.191956
36028,25005,146677,10573,9279,104191,295725,2022-03-21 10:07:16.594413
36030,10,387,10,30,173,610,2022-03-21 10:07:21.51787
36032,156,3991,97,116,1864,6224,2022-03-21 10:07:23.932654
36036,23,47,6,35,44,155,2022-03-21 10:07:26.352166
36038,23354,268272,8150,9705,92703,402184,2022-03-21 10:07:29.776765
36039,4602,56902,2401,5713,27382,97000,2022-03-21 10:07:30.239051
36040,1011,6157,501,1522,6426,15617,2022-03-21 10:07:30.404666
36043,1148,81031,381,231,10287,93078,2022-03-21 10:07:38.105231
36049,7990,78642,3581,5094,47512,142819,2022-03-21 10:07:38.275316
36050,8,492,3,14,81,598,2022-03-21 10:07:38.533398
36055,8,97,2,31,32,170,2022-03-21 10:07:39.975283
36056,6,160,3,29,50,248,2022-03-21 10:07:41.510488
36062,11,331,2,21,40,405,2022-03-21 10:07:44.768289
36063,8,154,3,15,36,216,2022-03-21 10:07:45.062319
36066,9,145,2,11,51,218,2022-03-21 10:07:46.490035
36074,7,265,4,18,41,335,2022-03-21 10:07:48.061969
36084,10,139,2,12,40,203,2022-03-21 10:07:51.840778
36085,7,137,4,8,32,188,2022-03-21 10:07:52.050057
36086,9,130,2,9,32,182,2022-03-21 10:07:54.639547
36087,7,140,0,10,27,184,2022-03-21 10:07:54.823965
36089,8,368,3,30,54,463,2022-03-21 10:07:56.653379
36093,6,176,0,13,37,232,2022-03-21 10:08:01.516108
36094,4589,17628,2515,4017,27166,55915,2022-03-21 10:08:04.236711
36095,8,210,3,15,40,276,2022-03-21 10:08:05.528295
36096,7,284,6,16,39,352,2022-03-21 10:08:05.696223
36097,13,251,1,22,69,356,2022-03-21 10:08:07.094396
36098,16790,530948,3864,1522,179452,732576,2022-03-21 10:08:07.532419
36099,9,134,2,30,45,220,2022-03-21 10:08:09.626248
36102,6,213,6,15,48,288,2022-03-21 10:08:12.292668
36104,13,276,0,36,72,397,2022-03-21 10:08:13.594019
36106,12721,173393,4504,1605,64519,256742,2022-03-21 10:08:13.861147
36111,4,89,0,8,16,117,2022-03-21 10:08:14.443401
36119,150,2276,53,85,1300,3864,2022-03-21 10:08:17.875617
36124,12792,64664,4873,13218,36704,132251,2022-03-21 10:08:20.015688
36125,322,14787,96,126,2603,17934,2022-03-21 10:08:22.925016
36127,63,62,27,57,166,375,2022-03-21 10:08:24.171215
36129,8,81,2,18,23,132,2022-03-21 10:08:24.359174
36130,31,56,9,48,153,297,2022-03-21 10:08:25.948947
36132,10,142,9,54,93,308,2022-03-21 10:08:26.126309
36135,112,172,58,188,1182,1712,2022-03-21 10:08:28.715517
36144,7787,23218,3578,6299,27142,68024,2022-03-21 10:08:31.628818
36145,35,383,13,44,338,813,2022-03-21 10:08:35.316525
36148,459,1707,149,212,2121,4648,2022-03-21 10:08:35.493878
36151,12,44,4,46,68,174,2022-03-21 10:08:37.940525
36152,36,92,13,46,472,659,2022-03-21 10:08:40.028328
36155,36,1050,10,35,258,1389,2022-03-21 10:08:41.968252
36156,65,2031,18,42,530,2686,2022-03-21 10:08:42.150533
36157,20,1131,6,40,114,1311,2022-03-21 10:08:42.405974
36160,709,2764,223,209,4196,8101,2022-03-21 10:08:48.519631
36161,10,48,6,51,60,175,2022-03-21 10:08:49.556989
36162,159,1609,80,67,1445,3360,2022-03-21 10:08:49.726915
36163,10,126,4,39,78,257,2022-03-21 10:08:52.636599
36166,220,1269,136,280,1143,3048,2022-03-21 10:08:55.324938
36169,13,574,6,17,98,708,2022-03-21 10:08:58.248748
36170,10,364,4,16,68,462,2022-03-21 10:08:58.448596
36172,9,240,0,11,46,306,2022-03-21 10:09:00.700575
36173,28,2465,7,20,184,2704,2022-03-21 10:09:01.348542
36180,6,238,1,12,42,299,2022-03-21 10:09:03.928996
36182,15,412,12,47,149,635,2022-03-21 10:09:05.691301
36183,7,152,1,12,34,206,2022-03-21 10:09:05.898273
36185,333,2065,109,168,2079,4754,2022-03-21 10:09:08.559654
36186,130,4047,43,113,1252,5585,2022-03-21 10:09:09.03379
36220,9766,100309,3679,3139,73521,190414,2022-03-21 10:09:10.755466
36223,120,1169,53,68,1191,2601,2022-03-21 10:09:13.994688
36226,73,177,40,66,404,760,2022-03-21 10:09:15.960287
36231,55,59,17,118,295,544,2022-03-21 10:09:19.06568
36233,9,66,1,24,42,142,2022-03-21 10:09:21.074465
36234,7,45,11,46,72,181,2022-03-21 10:09:22.196749
36239,175,2436,89,131,1845,4676,2022-03-21 10:09:24.40212
36240,175,4145,95,122,2151,6688,2022-03-21 10:09:24.582319
36241,155,3725,89,111,1951,6031,2022-03-21 10:09:28.911989
36242,92,2220,68,104,1394,3878,2022-03-21 10:09:31.151568
36245,4851,34805,1939,8967,21772,72334,2022-03-21 10:09:32.111263
36246,360,1450,138,178,2276,4402,2022-03-21 10:09:32.282779
36248,16,103,4,32,103,258,2022-03-21 10:09:34.178815
36249,10,133,1,13,24,181,2022-03-21 10:09:35.418512
36252,0,0,0,0,2020,2020,2022-03-21 10:09:40.363336
36258,10,525,3,10,51,599,2022-03-21 10:09:42.013522
36259,6039,15738,2143,5114,11433,40467,2022-03-21 10:09:44.933792
36264,7,205,3,16,29,260,2022-03-21 10:09:46.726485
36265,16,87,8,60,103,274,2022-03-21 10:09:47.977039
36266,17399,93769,6378,15091,65904,198541,2022-03-21 10:09:48.414686
36267,2697,10491,979,3204,8445,25816,2022-03-21 10:09:51.13648
36269,84,714,77,117,1078,2070,2022-03-21 10:09:51.316887
36270,7,12,2,35,37,93,2022-03-21 10:09:51.581238
36271,8,52,2,38,31,131,2022-03-21 10:09:52.795672
36272,8,22,3,31,36,100,2022-03-21 10:09:54.082779
36273,5,13,2,37,31,88,2022-03-21 10:09:54.516148
36274,5,40,3,38,42,128,2022-03-21 10:09:56.054332
36275,1583,24399,596,278,12354,39210,2022-03-21 10:09:59.317409
36279,8,203,1,22,45,279,2022-03-21 10:10:02.648975
36280,12,348,2,29,60,451,2022-03-21 10:10:03.827624
36286,4810,167054,1624,818,76164,250470,2022-03-21 10:10:07.983016
36287,16,432,13,42,178,681,2022-03-21 10:10:09.967496
36288,405,669,142,363,2961,4540,2022-03-21 10:10:12.164535
36289,48,1685,16,52,368,2169,2022-03-21 10:10:14.52171
36290,203,719,73,99,953,2047,2022-03-21 10:10:17.050233
36292,8,112,1,28,31,180,2022-03-21 10:10:18.819556
36293,7,166,2,19,37,231,2022-03-21 10:10:19.643096
36294,6,69,2,24,30,131,2022-03-21 10:10:20.662875
36296,30938,256959,11531,9568,122357,431353,2022-03-21 10:10:21.07943
36297,89,870,30,47,640,1676,2022-03-21 10:10:23.370402
36298,53,244,23,39,535,894,2022-03-21 10:10:23.544402
36300,6,80,3,22,23,134,2022-03-21 10:10:27.491271
36302,6,126,2,25,36,195,2022-03-21 10:10:30.323886
36305,650,10709,273,168,7312,19112,2022-03-21 10:10:30.523868
36308,794,21016,206,126,8895,31037,2022-03-21 10:10:31.547554
36309,2076,6344,895,3057,10525,22897,2022-03-21 10:10:31.715999
36311,5,15,2,36,25,83,2022-03-21 10:10:35.948533
36312,6,19,1,37,29,92,2022-03-21 10:10:37.232934
36314,6,21,2,32,34,95,2022-03-21 10:10:39.01206
36316,10893,55874,4003,12037,35490,118297,2022-03-21 10:10:39.632206
36317,9733,47685,5243,7417,30620,100698,2022-03-21 10:10:41.913491
36318,4419,41666,1434,1968,7704,57191,2022-03-21 10:10:44.773976
36321,6,18,2,36,28,90,2022-03-21 10:10:45.670054
36322,7,19,3,35,38,102,2022-03-21 10:10:46.858996
36324,6,18,2,38,28,92,2022-03-21 10:10:49.699865
36325,6,14,3,37,29,89,2022-03-21 10:10:50.72806
36326,8,25,3,28,36,100,2022-03-21 10:10:51.910446
36339,130,1569,59,75,938,2771,2022-03-21 10:10:52.088155
36342,290,1552,164,134,4118,6258,2022-03-21 10:10:52.35428
36343,271,1352,166,134,3888,5811,2022-03-21 10:10:56.77137
36344,269,1333,165,134,3901,5802,2022-03-21 10:10:59.633629
36347,6,108,5,19,30,168,2022-03-21 10:11:02.283825
36348,8,107,3,22,41,181,2022-03-21 10:11:03.518826
36349,5,96,1,19,26,147,2022-03-21 10:11:03.689833
36354,7,93,3,23,34,160,2022-03-21 10:11:07.926157
36355,8,66,2,20,28,124,2022-03-21 10:11:08.144138
36373,7,94,1,15,52,169,2022-03-21 10:11:12.638063
36383,6,98,0,19,27,150,2022-03-21 10:11:16.296674
36384,6,86,0,17,22,131,2022-03-21 10:11:16.688363
36390,32,80,2,26,65,205,2022-03-21 10:11:18.880753
36391,7,85,3,22,27,144,2022-03-21 10:11:20.049288
36395,9,164,0,16,34,223,2022-03-21 10:11:22.528735
36402,5,91,3,27,43,169,2022-03-21 10:11:24.66964
36403,8,152,0,15,27,202,2022-03-21 10:11:25.765493
36407,29337,339734,6270,25042,64686,465069,2022-03-21 10:11:26.389934
36424,290,1822,149,154,3661,6076,2022-03-21 10:11:32.304157
36427,40,264,11,61,129,505,2022-03-21 10:11:37.266712
36429,46,105,18,66,268,503,2022-03-21 10:11:39.423754
36431,2246,24388,798,1206,15519,44157,2022-03-21 10:11:42.706191
36432,20186,101434,8059,9029,77172,215880,2022-03-21 10:11:46.01274
36436,108,1371,54,96,1756,3385,2022-03-21 10:11:46.191978
36439,516,15834,369,393,6019,23131,2022-03-21 10:11:52.164011
36440,427,451,191,400,1987,3456,2022-03-21 10:11:52.344457
36443,12,77,4,27,79,199,2022-03-21 10:11:54.194509
36444,149,774,79,132,3896,5030,2022-03-21 10:11:56.559841
36447,158,235,50,130,813,1386,2022-03-21 10:11:58.961392
36451,25,785,8,14,173,1005,2022-03-21 10:11:59.144842
36455,2896,9798,919,1267,13797,28677,2022-03-21 10:11:59.40768
36456,130071,1558353,19631,16565,117403,1842023,2022-03-21 10:11:59.84472
36468,479,6449,242,248,2531,9949,2022-03-21 10:12:00.458999
36470,20215,130832,7105,9472,79678,247302,2022-03-21 10:12:03.995316
36473,215,3383,105,131,2377,6211,2022-03-21 10:12:08.092894
36474,71929,629259,19405,27101,123248,870942,2022-03-21 10:12:10.576978
36480,1601,32980,760,496,33331,69168,2022-03-21 10:12:14.749643
36483,877,5498,431,594,5815,13215,2022-03-21 10:12:23.268981
36485,399,3381,224,201,3045,7250,2022-03-21 10:12:26.228599
36489,4,187,2,13,39,245,2022-03-21 10:12:27.989908
36491,718,5362,145,261,2151,8637,2022-03-21 10:12:28.183988
36492,1662,2518,485,254,5636,10555,2022-03-21 10:12:31.589849
36493,42,717,21,38,440,1258,2022-03-21 10:12:34.743834
36494,241,4837,109,144,2233,7564,2022-03-21 10:12:34.918122
36497,546,11378,262,286,5393,17865,2022-03-21 10:12:39.526462
36498,183,1556,146,151,2319,4355,2022-03-21 10:12:41.689357
36500,192,2280,72,112,1097,3753,2022-03-21 10:12:44.046419
36501,263,5413,96,161,2575,8508,2022-03-21 10:12:46.95425
36502,561,4609,261,324,3554,9309,2022-03-21 10:12:49.943717
36506,45,0,16,80,98,239,2022-03-21 10:12:51.107809
36511,64240,717906,19241,52398,122257,976042,2022-03-21 10:12:52.029781
36513,2520,12247,904,1497,10337,27505,2022-03-21 10:12:52.22173
36515,788,9530,354,534,8426,19632,2022-03-21 10:12:53.461161
36517,750,33791,268,640,13486,48935,2022-03-21 10:12:56.270963
36521,209,699,101,176,1708,2893,2022-03-21 10:12:59.005436
36522,3039,22062,1069,1049,12611,39830,2022-03-21 10:12:59.21757
36524,531,17975,175,353,3856,22890,2022-03-21 10:13:01.913285
36528,52,328,30,30,308,748,2022-03-21 10:13:05.303171
36529,53,468,48,86,2043,2698,2022-03-21 10:13:06.665693
36531,447,445,205,399,1694,3190,2022-03-21 10:13:11.104412
36536,545,3494,239,368,4260,8906,2022-03-21 10:13:13.02413
36537,75,1031,40,75,2048,3269,2022-03-21 10:13:15.869226
36538,1726,26465,629,301,29364,58485,2022-03-21 10:13:16.044943
36539,664,20670,294,163,7669,29460,2022-03-21 10:13:18.69588
36542,218,1402,69,70,2426,4185,2022-03-21 10:13:21.355371
36544,226,801,78,100,1437,2642,2022-03-21 10:13:24.028656
36545,409,3314,161,153,2562,6599,2022-03-21 10:13:24.223549
36548,13675,73554,6233,11413,59997,164872,2022-03-21 10:13:26.312754
36549,11,66,6,43,66,192,2022-03-21 10:13:27.875554
36552,43,66,15,88,182,394,2022-03-21 10:13:30.792772
36553,229,3830,98,151,2664,6972,2022-03-21 10:13:33.37418
36560,1225,23734,606,435,11886,37886,2022-03-21 10:13:37.261775
36561,147,2516,34,74,484,3255,2022-03-21 10:13:37.479137
36563,35342,278721,11944,11154,107266,444427,2022-03-21 10:13:39.254093
36564,224,3341,167,239,2993,6964,2022-03-21 10:13:39.514843
36565,2977,16512,1011,1229,8053,29782,2022-03-21 10:13:42.338353
36569,334,1962,164,177,2934,5571,2022-03-21 10:13:43.153121
36571,43,98,16,40,225,422,2022-03-21 10:13:47.913047
36573,10,116,2,27,62,217,2022-03-21 10:13:50.797037
36575,14,129,3,21,79,246,2022-03-21 10:13:53.512333
36580,10,152,4,35,55,256,2022-03-21 10:13:59.204278
36581,9,51,2,28,39,129,2022-03-21 10:14:00.370719
36582,8,133,0,25,50,216,2022-03-21 10:14:01.517935
36583,10,96,0,24,40,170,2022-03-21 10:14:02.595331
36584,9,129,1,23,45,207,2022-03-21 10:14:03.69579
36587,4674,23137,1880,2263,25158,57112,2022-03-21 10:14:06.96046
36588,123,168,36,62,318,707,2022-03-21 10:14:07.504574
36591,8,49,4,20,58,139,2022-03-21 10:14:10.374634
36592,9,82,10,34,128,263,2022-03-21 10:14:11.61072
36593,1803,4239,852,815,5815,13524,2022-03-21 10:14:11.781675
36594,34,932,7,19,216,1208,2022-03-21 10:14:12.035747
36595,24,785,9,15,114,947,2022-03-21 10:14:15.018171
36596,25,742,11,19,187,984,2022-03-21 10:14:16.605912
36597,28,854,5,16,137,1040,2022-03-21 10:14:18.834503
36598,21,743,4,17,125,910,2022-03-21 10:14:19.053106
36599,119,870,29,28,439,1485,2022-03-21 10:14:19.323444
36600,22,781,6,16,159,984,2022-03-21 10:14:21.301714
36601,16,726,5,14,116,877,2022-03-21 10:14:22.260231
36602,21,774,6,16,155,972,2022-03-21 10:14:23.295622
36603,50,1034,14,23,247,1368,2022-03-21 10:14:24.238973
36604,833,2736,151,158,2549,6427,2022-03-21 10:14:28.22032
36605,38,806,16,15,193,1068,2022-03-21 10:14:28.677595
36606,61,851,24,28,479,1443,2022-03-21 10:14:28.853455
36607,33,750,5,19,204,1011,2022-03-21 10:14:30.153173
36608,26,758,6,18,190,998,2022-03-21 10:14:30.408386
36611,16,50,7,57,74,204,2022-03-21 10:14:32.464524
36613,37,0,18,43,51,149,2022-03-21 10:14:32.643969
36621,14,174,1,21,72,282,2022-03-21 10:14:34.864477
36626,29,107,10,47,228,421,2022-03-21 10:14:36.829442
36629,158,1980,115,81,2405,4739,2022-03-21 10:14:37.035198
36637,170,1698,44,125,1057,3094,2022-03-21 10:14:40.026462
36638,13,162,2,20,86,283,2022-03-21 10:14:40.224906
36639,213,0,60,155,576,1004,2022-03-21 10:14:41.65487
36640,16,174,3,16,111,320,2022-03-21 10:14:42.856681
36641,8,129,2,19,67,225,2022-03-21 10:14:44.663702
36642,51,384,13,47,339,834,2022-03-21 10:14:46.137729
36643,48,324,11,46,311,740,2022-03-21 10:14:47.210844
36644,131,235,45,66,386,863,2022-03-21 10:14:48.762826
36646,53,509,27,66,555,1210,2022-03-21 10:14:49.22291
36649,63845,328503,31184,27586,232724,683842,2022-03-21 10:14:49.662326
36654,1301,5152,662,1812,7159,16086,2022-03-21 10:14:54.413328
36655,860,2793,307,1878,4454,10292,2022-03-21 10:14:56.974353
36656,11,35,5,72,53,176,2022-03-21 10:14:58.132331
36657,20,66,8,58,75,227,2022-03-21 10:14:59.818874
36661,35,236,16,40,413,740,2022-03-21 10:15:01.958069
36662,18,56,8,39,162,283,2022-03-21 10:15:03.288624
36664,102,367,35,81,1023,1608,2022-03-21 10:15:05.738279
36666,34,249,28,66,462,839,2022-03-21 10:15:05.915206
36668,9,121,2,18,34,184,2022-03-21 10:15:09.410925
36670,10,188,0,21,43,262,2022-03-21 10:15:11.048259
36672,10,199,2,19,51,281,2022-03-21 10:15:12.654188
36673,10,106,1,20,39,176,2022-03-21 10:15:13.652436
36674,12,131,1,20,35,199,2022-03-21 10:15:14.701222
36675,8,121,1,18,43,191,2022-03-21 10:15:14.94753
36712,11,184,2,43,89,329,2022-03-21 10:15:19.521972
36714,56,476,28,58,752,1370,2022-03-21 10:15:21.364137
36716,7,251,1,14,38,311,2022-03-21 10:15:23.295443
36718,12,167,1,25,62,267,2022-03-21 10:15:24.91494
36719,10,133,1,20,59,223,2022-03-21 10:15:26.596606
36724,64,0,36,69,132,301,2022-03-21 10:15:29.693172
36725,139,3112,81,106,1635,5073,2022-03-21 10:15:29.8832
36726,17206,135599,6867,10600,80114,250386,2022-03-21 10:15:32.327123
36728,95,394,59,161,661,1370,2022-03-21 10:15:35.991026
36729,602,7164,290,411,7363,15830,2022-03-21 10:15:38.433484
36730,18,498,22,52,228,818,2022-03-21 10:15:38.609782
36734,6,78,6,37,49,176,2022-03-21 10:15:42.004478
36736,10,45,4,33,43,135,2022-03-21 10:15:45.044547
36743,6,217,0,24,49,296,2022-03-21 10:15:48.490507
36744,8,192,0,22,47,269,2022-03-21 10:15:49.651364
36745,10,647,3,46,104,810,2022-03-21 10:15:51.024488
36746,11,620,5,39,94,769,2022-03-21 10:15:52.469225
36747,9,630,6,45,98,788,2022-03-21 10:15:53.586981
36749,67,95,31,53,1496,1742,2022-03-21 10:15:54.371629
36750,14,541,5,18,80,658,2022-03-21 10:15:54.634277
36757,19,220,6,31,151,427,2022-03-21 10:15:55.502804
36765,9,170,1,8,43,231,2022-03-21 10:15:57.608655
36771,34,82,14,61,243,434,2022-03-21 10:16:00.308531
36774,15,469,6,42,181,713,2022-03-21 10:16:01.865756
36775,598,1671,230,322,4252,7073,2022-03-21 10:16:02.039623
36782,113,529,36,45,895,1618,2022-03-21 10:16:03.89965
36793,20852,169213,8465,19814,65631,283975,2022-03-21 10:16:05.07634
36805,299,114,98,116,2418,3045,2022-03-21 10:16:06.34428
36812,7,80,1,14,20,122,2022-03-21 10:16:08.604449
36816,469,27398,208,218,7211,35504,2022-03-21 10:16:13.067868
36817,10185,59955,3621,6872,46080,126713,2022-03-21 10:16:14.050941
36819,7,109,1,16,27,160,2022-03-21 10:16:16.352968
36821,7,79,3,19,31,139,2022-03-21 10:16:18.195726
36822,6,138,0,10,39,193,2022-03-21 10:16:19.401288
36823,377,4604,114,146,2444,7685,2022-03-21 10:16:19.59139
36824,805,2284,244,195,3096,6624,2022-03-21 10:16:21.990869
36825,98,1943,73,121,1089,3324,2022-03-21 10:16:24.276811
36827,71,921,37,56,874,1959,2022-03-21 10:16:26.929431
36828,7318,25818,3084,11843,23644,71707,2022-03-21 10:16:27.099672
36833,505,9720,307,194,8409,19135,2022-03-21 10:16:27.622397
36834,114,568,52,63,1184,1981,2022-03-21 10:16:29.920334
36835,13,302,9,39,120,483,2022-03-21 10:16:31.113168
36836,50,1562,46,93,741,2492,2022-03-21 10:16:31.283951
36838,9085,103824,2637,1564,53997,171107,2022-03-21 10:16:33.663689
36841,21,665,7,14,127,834,2022-03-21 10:16:34.468075
36843,13,64,3,44,81,205,2022-03-21 10:16:35.803206
36846,6,112,3,18,34,173,2022-03-21 10:16:37.344221
36855,533,8157,402,380,7151,16623,2022-03-21 10:16:40.824312
36856,30,89,14,57,177,367,2022-03-21 10:16:42.075217
36857,18,95,14,53,344,524,2022-03-21 10:16:43.321749
36858,168,747,86,110,3642,4753,2022-03-21 10:16:43.490274
36861,183,2183,66,95,1686,4213,2022-03-21 10:16:45.659994
36862,5849,170044,1702,531,132547,310673,2022-03-21 10:16:46.089843
36864,11807,81251,4297,7135,45385,149875,2022-03-21 10:16:46.798954
36865,38,203,16,51,367,675,2022-03-21 10:16:48.317638
36866,61,59,25,55,335,535,2022-03-21 10:16:49.703528
36868,14,193,3,31,69,310,2022-03-21 10:16:50.945595
36873,8472,72787,4526,12264,26045,124094,2022-03-21 10:16:51.791514
36881,12,56,3,47,58,176,2022-03-21 10:16:58.045373
36882,32111,370858,6505,32760,90252,532486,2022-03-21 10:16:58.511142
36883,17,150,2,37,124,330,2022-03-21 10:16:59.910887
36884,5431,37881,3312,4292,23153,74069,2022-03-21 10:17:00.107981
36885,5032,73947,1594,703,62747,144023,2022-03-21 10:17:00.824175
36890,98,254,46,100,1357,1855,2022-03-21 10:17:04.007887
36894,48,264,16,106,197,631,2022-03-21 10:17:04.207029
36921,30,1334,16,48,282,1710,2022-03-21 10:17:22.433834
36896,8164,526390,1832,1312,85189,622887,2022-03-21 10:17:04.740602
36902,8787,24615,3600,9550,29539,76091,2022-03-21 10:17:05.012269
36910,260,1511,53,124,764,2712,2022-03-21 10:17:07.974328
36913,56,1223,29,65,663,2036,2022-03-21 10:17:11.588876
36914,519,8586,304,222,7549,17180,2022-03-21 10:17:14.55474
36918,34,1298,25,49,353,1759,2022-03-21 10:17:17.17286
36919,29,1387,20,49,385,1870,2022-03-21 10:17:17.637484
36920,56,2005,12,51,485,2609,2022-03-21 10:17:20.183747
36923,1650,40239,517,667,17353,60426,2022-03-21 10:17:23.0589
36927,345,23347,209,180,6784,30865,2022-03-21 10:17:25.703066
36934,12201,25350,5614,7911,12726,63802,2022-03-21 10:17:28.484386
36936,2507,69931,1023,581,42301,116343,2022-03-21 10:17:31.383505
36937,35,189,4,31,306,565,2022-03-21 10:17:31.564229
36943,4903,28559,1370,4648,19492,58972,2022-03-21 10:17:34.590452
36945,1020,3955,412,2857,7689,15933,2022-03-21 10:17:37.273142
36946,4435,270222,589,496,27694,303436,2022-03-21 10:17:37.703263
36947,11,64,5,44,73,197,2022-03-21 10:17:39.835808
36949,32434,498889,6879,5093,74638,617933,2022-03-21 10:17:43.303047
36950,11630,21950,3131,1646,12423,50780,2022-03-21 10:17:43.484032
36951,374,8940,206,135,8405,18060,2022-03-21 10:17:46.48505
36952,303,0,106,98,2359,2866,2022-03-21 10:17:51.482663
36954,16,144,2,34,72,268,2022-03-21 10:17:52.962641
36955,42,366,23,71,845,1347,2022-03-21 10:17:54.884888
36962,1225,44378,609,330,24190,70732,2022-03-21 10:17:55.06913
36963,934,6093,432,345,4561,12365,2022-03-21 10:18:01.508091
36964,13,53,8,63,123,260,2022-03-21 10:18:01.931576
36967,78,2313,58,62,1706,4217,2022-03-21 10:18:04.63555
36969,9,119,7,37,71,243,2022-03-21 10:18:06.105407
36973,18,110,8,42,127,305,2022-03-21 10:18:07.677091
36976,1470,4070,761,3356,7597,17254,2022-03-21 10:18:07.843949
36982,889,3452,451,770,2247,7809,2022-03-21 10:18:11.763511
36983,14,243,5,29,67,358,2022-03-21 10:18:13.417012
36990,1611,36509,646,264,25713,64743,2022-03-21 10:18:13.874216
36991,56,968,27,39,754,1844,2022-03-21 10:18:16.394487
36992,622,15302,224,205,11422,27775,2022-03-21 10:18:16.56343
36993,65,671,40,124,305,1205,2022-03-21 10:18:21.219975
36995,93,1180,52,90,1205,2620,2022-03-21 10:18:23.990503
36999,6063,109110,2238,709,73716,191836,2022-03-21 10:18:26.318135
37000,51,882,29,37,404,1403,2022-03-21 10:18:28.724936
37007,11151,54386,4509,7417,26087,103550,2022-03-21 10:18:29.329692
37008,490,613,138,221,4820,6282,2022-03-21 10:18:32.458659
37010,7,99,1,22,29,158,2022-03-21 10:18:35.663819
37011,7,117,1,17,31,173,2022-03-21 10:18:35.885903
37013,48,89,29,55,1429,1650,2022-03-21 10:18:39.064148
37017,7,84,5,34,45,175,2022-03-21 10:18:40.299816
37020,33,0,10,52,81,176,2022-03-21 10:18:42.075128
37023,2345,2437,1421,1694,7352,15249,2022-03-21 10:18:45.535291
37024,27,72,9,54,98,260,2022-03-21 10:18:46.918145
37027,705,20616,354,252,15078,37005,2022-03-21 10:18:50.181515
37029,1928,13884,566,355,8474,25207,2022-03-21 10:18:53.438634
37031,618,7058,270,328,4949,13223,2022-03-21 10:18:56.319618
37033,13390,53973,5160,3514,34082,110119,2022-03-21 10:18:56.501712
37034,227,1695,137,147,2617,4823,2022-03-21 10:18:59.356132
37037,48,491,47,50,473,1109,2022-03-21 10:19:02.907792
37044,340,2309,133,149,2358,5289,2022-03-21 10:19:05.71498
37045,583,6272,226,213,5078,12372,2022-03-21 10:19:09.602974
37046,291,2756,172,135,3145,6499,2022-03-21 10:19:11.757784
37047,532,5579,236,155,5698,12200,2022-03-21 10:19:14.549638
37050,5,73,7,37,129,251,2022-03-21 10:19:15.920346
37051,18,372,18,52,218,678,2022-03-21 10:19:16.101427
37054,19,52,9,88,116,284,2022-03-21 10:19:18.593779
37055,5014,147168,1640,735,65028,219585,2022-03-21 10:19:19.397992
37064,7,92,2,14,22,137,2022-03-21 10:19:24.339587
37065,9,281,1,40,49,380,2022-03-21 10:19:25.671938
37066,8,75,1,16,25,125,2022-03-21 10:19:25.844383
37067,8,122,0,21,45,196,2022-03-21 10:19:27.362986
37070,8,81,3,20,29,141,2022-03-21 10:19:28.675531
37074,7,128,3,29,36,203,2022-03-21 10:19:32.197349
37075,7,156,0,22,30,215,2022-03-21 10:19:32.390305
37097,8,82,4,47,44,185,2022-03-21 10:19:35.737817
37098,8,91,4,48,43,194,2022-03-21 10:19:37.181867
37101,8,89,7,64,50,218,2022-03-21 10:19:42.38591
37103,763,12616,397,268,10631,24675,2022-03-21 10:19:43.047839
37104,166,735,85,97,1716,2799,2022-03-21 10:19:43.310741
37105,37931,386497,15558,17548,155514,613048,2022-03-21 10:19:46.114398
37106,1271,9936,445,1300,6932,19884,2022-03-21 10:19:46.283701
37112,12,554,15,41,189,811,2022-03-21 10:19:51.013415
37133,16,63,5,20,109,213,2022-03-21 10:19:59.575759
37135,3,112,0,8,22,145,2022-03-21 10:20:00.76776
37136,3,80,0,8,21,112,2022-03-21 10:20:00.937995
37138,1,107,0,11,25,144,2022-03-21 10:20:02.112766
37139,498,9178,218,107,6582,16583,2022-03-21 10:20:02.314687
37140,9177,4142,4597,8238,18951,45105,2022-03-21 10:20:04.839719
37141,57962,310871,37113,34004,126109,566059,2022-03-21 10:20:05.87183
37144,11,81,6,47,71,216,2022-03-21 10:20:11.205893
37145,7,135,4,30,58,234,2022-03-21 10:20:12.609682
37148,248,1607,86,131,2231,4303,2022-03-21 10:20:14.461031
37150,2446,10734,494,807,6968,21449,2022-03-21 10:20:18.289459
37151,59,464,32,67,773,1395,2022-03-21 10:20:20.740938
37152,61,139,13,41,186,440,2022-03-21 10:20:23.883175
37153,7,109,0,28,31,175,2022-03-21 10:20:24.056971
37154,3665,11675,1570,6823,15862,39595,2022-03-21 10:20:26.461545
37155,7,95,0,31,31,164,2022-03-21 10:20:26.904827
37164,422,5540,86,192,1168,7408,2022-03-21 10:20:29.458982
37167,28,50,10,29,214,331,2022-03-21 10:20:30.080142
37168,6,47,2,28,53,136,2022-03-21 10:20:31.179101
37171,30321,212255,14374,14035,116395,387380,2022-03-21 10:20:34.874221
37172,365,4791,148,123,3428,8855,2022-03-21 10:20:35.071608
37175,1371,5969,476,516,7683,16015,2022-03-21 10:20:41.562544
37176,403,4581,87,150,1014,6235,2022-03-21 10:20:41.777743
37177,35,201,15,39,437,727,2022-03-21 10:20:44.210313
37178,711,940,288,436,2466,4841,2022-03-21 10:20:44.383904
37179,39,113,10,45,584,791,2022-03-21 10:20:49.300365
37180,11,104,7,58,105,285,2022-03-21 10:20:50.872173
37184,203,1835,61,93,744,2936,2022-03-21 10:20:55.320329
37186,182,410,47,139,519,1297,2022-03-21 10:20:57.662259
37187,29,56,7,34,208,334,2022-03-21 10:21:00.396962
37188,2919,21616,844,2019,10581,37979,2022-03-21 10:21:00.584669
37189,63,583,34,63,774,1517,2022-03-21 10:21:03.017656
37192,7,100,2,22,33,164,2022-03-21 10:21:04.940906
37193,6,83,1,21,23,134,2022-03-21 10:21:06.136197
37195,5,110,2,27,31,175,2022-03-21 10:21:08.359771
37196,7,144,2,17,47,217,2022-03-21 10:21:09.88632
37197,8,166,0,16,58,248,2022-03-21 10:21:10.07236
37206,2571,17096,1396,2897,14632,38592,2022-03-21 10:21:14.795551
37207,283,2587,143,134,6564,9711,2022-03-21 10:21:17.466336
37208,15895,73304,5562,5326,85883,185970,2022-03-21 10:21:17.650307
37209,510,1353,176,308,2250,4597,2022-03-21 10:21:21.550333
37212,5,120,1,11,35,172,2022-03-21 10:21:24.808128
37215,28,181,17,35,410,671,2022-03-21 10:21:26.942173
37217,3,117,2,15,78,215,2022-03-21 10:21:28.700695
37219,4,61,4,42,39,150,2022-03-21 10:21:30.12263
37221,5042,24996,2462,5665,25268,63433,2022-03-21 10:21:30.298023
37225,17,90,8,48,174,337,2022-03-21 10:21:33.049645
37228,7,40,6,20,48,121,2022-03-21 10:21:34.178958
37232,2772,8945,1259,4128,10298,27402,2022-03-21 10:21:34.34736
37242,42,197,11,34,422,706,2022-03-21 10:21:38.839409
37243,26,331,6,35,145,543,2022-03-21 10:21:39.043121
37245,3038,13149,986,2563,6100,25836,2022-03-21 10:21:45.281438
37249,16,287,13,66,221,603,2022-03-21 10:21:49.346308
37254,3366,10705,1328,4118,15470,34987,2022-03-21 10:21:50.385953
37256,21,571,5,48,168,813,2022-03-21 10:21:52.704429
37262,452,2810,154,156,6173,9745,2022-03-21 10:21:58.895485
37264,407,5440,199,252,4226,10524,2022-03-21 10:22:02.46894
37265,259,1061,124,222,2823,4489,2022-03-21 10:22:04.694549
37266,31,2611,4,26,157,2829,2022-03-21 10:22:04.865381
37267,6,47,10,33,70,166,2022-03-21 10:22:08.711889
37272,612,2278,246,169,5842,9147,2022-03-21 10:22:09.430117
37273,7,187,4,12,46,256,2022-03-21 10:22:10.844764
37278,420,6499,311,313,5480,13023,2022-03-21 10:22:14.06042
37280,46,66,15,41,306,474,2022-03-21 10:22:18.386145
37281,4618,24731,1290,2494,15265,48398,2022-03-21 10:22:18.588064
37284,5,56,6,46,180,293,2022-03-21 10:22:22.210175
37285,34,407,22,83,401,947,2022-03-21 10:22:22.419537
37292,447,622,228,172,1641,3110,2022-03-21 10:22:33.709337
37293,507,837,171,229,1660,3404,2022-03-21 10:22:36.129107
37300,11,156,5,46,64,282,2022-03-21 10:22:39.519397
37302,1939,9254,968,3089,12128,27378,2022-03-21 10:22:39.722811
37303,546,8664,342,147,11846,21545,2022-03-21 10:22:44.352875
37304,476,7720,312,139,9580,18227,2022-03-21 10:22:47.189965
37305,555,7666,300,142,9262,17925,2022-03-21 10:22:47.362785
37307,475,6748,295,134,9609,17261,2022-03-21 10:22:50.182512
37308,225,2573,144,147,2678,5767,2022-03-21 10:22:55.719877
37311,85,810,31,74,789,1789,2022-03-21 10:22:55.923947
37316,14,309,6,22,159,510,2022-03-21 10:22:56.18694
37318,224,684,69,87,1262,2326,2022-03-21 10:22:57.979884
37320,1959,14746,615,1541,9242,28103,2022-03-21 10:22:59.822352
37325,29,47,15,87,359,537,2022-03-21 10:23:04.583801
37326,6,94,4,20,57,181,2022-03-21 10:23:05.925679
37336,8,134,0,18,48,208,2022-03-21 10:23:10.820757
37337,9,95,0,21,42,167,2022-03-21 10:23:12.002035
37338,3177,11642,1853,4317,15098,36087,2022-03-21 10:23:12.441131
37341,2185,29393,999,259,13500,46336,2022-03-21 10:23:12.625636
37344,8,222,0,10,54,294,2022-03-21 10:23:17.313105
37345,43183,145814,13383,37592,83921,323893,2022-03-21 10:23:17.758065
37346,134,963,64,56,7200,8417,2022-03-21 10:23:17.940534
37347,38728,493360,10073,11984,114442,668587,2022-03-21 10:23:18.460565
43637,1,24,1,5,7,38,2022-03-21 11:31:22.372398
37352,25,461,9,25,168,688,2022-03-21 10:23:22.355943
37356,15,670,8,14,147,854,2022-03-21 10:23:24.290559
37358,14,72,5,40,92,223,2022-03-21 10:23:27.303937
37359,33,32,14,106,191,376,2022-03-21 10:23:28.606531
37362,430,8277,348,331,5773,15159,2022-03-21 10:23:31.045742
37364,483,13734,308,140,9158,23823,2022-03-21 10:23:31.48373
37365,68,74,52,50,2111,2355,2022-03-21 10:23:31.64873
37370,297,6755,82,152,2189,9475,2022-03-21 10:23:34.142715
37374,1466,4155,686,3983,7915,18205,2022-03-21 10:23:39.308207
37379,9992,57979,3274,1634,42936,115815,2022-03-21 10:23:42.248045
37384,6,351,5,19,71,452,2022-03-21 10:23:43.632598
37385,6,187,1,14,37,245,2022-03-21 10:23:45.144853
37386,4,106,0,22,35,167,2022-03-21 10:23:47.267608
37387,16,290,4,27,151,488,2022-03-21 10:23:47.44702
37388,226,1677,90,213,1979,4185,2022-03-21 10:23:48.717824
37390,7,121,3,42,57,230,2022-03-21 10:23:52.022562
37392,8,127,3,41,50,229,2022-03-21 10:23:54.503483
37395,657,733,315,901,3047,5653,2022-03-21 10:23:55.33303
37398,65,467,28,70,712,1342,2022-03-21 10:24:00.405485
37402,800,15727,397,377,9911,27212,2022-03-21 10:24:02.728576
37403,37555,62634,13323,18097,37242,168851,2022-03-21 10:24:06.027749
37404,11,213,1,14,46,285,2022-03-21 10:24:07.286522
37406,38,1078,10,33,324,1483,2022-03-21 10:24:07.481554
37408,130,1512,50,111,1178,2981,2022-03-21 10:24:10.274524
37413,15,618,7,14,114,768,2022-03-21 10:24:12.340517
37418,151,1767,80,89,2042,4129,2022-03-21 10:24:12.957645
37421,6,146,1,14,51,218,2022-03-21 10:24:15.04606
37422,296,2969,119,195,2308,5887,2022-03-21 10:24:17.982705
37424,156,1765,56,131,1214,3322,2022-03-21 10:24:21.238556
37430,102055,821195,22929,25602,146821,1118602,2022-03-21 10:24:25.53354
37431,18,317,11,48,210,604,2022-03-21 10:24:25.708426
37433,643,1467,271,707,3124,6212,2022-03-21 10:24:26.859191
37436,2899,19755,1308,4478,29051,57491,2022-03-21 10:24:34.356643
37437,0,0,0,0,3008,3008,2022-03-21 10:24:36.622616
37438,1165,9045,661,1894,12862,25627,2022-03-21 10:24:39.068231
37440,1823,45400,870,348,39844,88285,2022-03-21 10:24:42.664337
37441,1581,40875,754,302,31067,74579,2022-03-21 10:24:45.132959
37442,1734,40935,798,303,32103,75873,2022-03-21 10:24:45.553354
37446,12362,92887,4000,18097,33498,160844,2022-03-21 10:24:45.907708
37447,14603,29947,7068,10978,45051,107647,2022-03-21 10:24:46.090422
37449,8864,51340,2965,2221,36451,101841,2022-03-21 10:24:46.511543
37460,25,95,1,23,141,285,2022-03-21 10:24:48.011939
37466,6,128,0,14,25,173,2022-03-21 10:24:50.900105
37467,44,33,19,123,425,644,2022-03-21 10:24:52.349915
37468,9,226,4,48,67,354,2022-03-21 10:24:54.098514
37472,10,51,8,55,123,247,2022-03-21 10:24:57.040149
37475,20545,181225,7571,10249,82300,301890,2022-03-21 10:24:57.216634
37481,1128,4595,576,2018,6266,14583,2022-03-21 10:25:03.278113
37482,11,34,8,32,85,170,2022-03-21 10:25:04.474892
37483,57,240,38,45,3454,3834,2022-03-21 10:25:04.718379
37484,102,236,31,185,580,1134,2022-03-21 10:25:08.802806
37485,14,42,7,25,113,201,2022-03-21 10:25:09.970838
37487,3676,14784,1735,4036,23006,47237,2022-03-21 10:25:14.109444
37490,2721,16212,1470,1453,11690,33546,2022-03-21 10:25:15.202649
37491,7296,95057,2221,1360,51883,157817,2022-03-21 10:25:15.378375
37492,1078,58060,563,318,26292,86311,2022-03-21 10:25:18.567149
37496,3079,13463,1449,3522,12293,33806,2022-03-21 10:25:23.21913
37497,25971,126942,11227,14638,104957,283735,2022-03-21 10:25:23.415726
37501,78,1641,51,97,1370,3237,2022-03-21 10:25:26.578031
37504,1021,14348,550,698,11004,27621,2022-03-21 10:25:26.79362
37505,456,6631,148,195,3356,10786,2022-03-21 10:25:29.327576
37506,21,327,3,23,187,561,2022-03-21 10:25:32.763674
37507,82,2053,36,69,915,3155,2022-03-21 10:25:32.995122
37509,2041,6555,930,4185,9784,23495,2022-03-21 10:25:38.279669
37510,68360,909560,15752,6049,188808,1188529,2022-03-21 10:25:38.550899
37514,2174,41035,794,901,42397,87301,2022-03-21 10:25:39.74782
37516,235,3714,134,105,5557,9745,2022-03-21 10:25:46.308518
37517,16771,129617,8047,14934,78263,247632,2022-03-21 10:25:46.953098
37520,110697,550369,44026,31748,232196,969036,2022-03-21 10:25:47.122174
37521,105328,634323,31253,16726,258760,1046390,2022-03-21 10:25:47.558341
37528,7,282,2,20,115,426,2022-03-21 10:25:49.366382
37529,7,127,1,18,53,206,2022-03-21 10:25:51.974855
37530,14,246,1,19,129,409,2022-03-21 10:25:53.426662
37531,11,368,1,13,83,476,2022-03-21 10:25:53.619742
37532,4,184,1,13,36,238,2022-03-21 10:25:55.173226
37533,4,142,1,9,30,186,2022-03-21 10:25:56.168337
37535,11,177,3,21,74,286,2022-03-21 10:25:58.534274
37536,5,98,1,15,28,147,2022-03-21 10:25:58.72641
37537,50,1131,22,45,533,1781,2022-03-21 10:26:02.19083
37538,6,151,1,10,59,227,2022-03-21 10:26:03.30129
37539,13,122,1,19,69,224,2022-03-21 10:26:04.425477
37541,12,341,4,14,98,469,2022-03-21 10:26:05.642084
37542,10,191,2,9,49,261,2022-03-21 10:26:05.909252
37546,6,187,0,19,54,266,2022-03-21 10:26:09.571423
37547,7,290,0,18,47,362,2022-03-21 10:26:11.160072
37548,13,419,1,13,119,565,2022-03-21 10:26:12.704395
37550,10,273,0,16,78,377,2022-03-21 10:26:15.339326
37552,11,177,4,19,83,294,2022-03-21 10:26:16.994893
37554,10,57,8,48,68,191,2022-03-21 10:26:19.782601
37555,2810,7669,1102,2427,18323,32331,2022-03-21 10:26:22.473379
37560,26,32,7,106,218,389,2022-03-21 10:26:25.287057
37561,2609,11898,1355,4787,12504,33153,2022-03-21 10:26:25.73698
37562,65,195,28,57,1108,1453,2022-03-21 10:26:25.907165
37563,1072,1716,450,478,5136,8852,2022-03-21 10:26:30.328111
37564,1357,3185,391,658,5877,11468,2022-03-21 10:26:30.537131
37566,28,99,11,43,188,369,2022-03-21 10:26:34.292434
37569,15664,121545,7004,9646,62654,216513,2022-03-21 10:26:37.157702
37571,966,2360,422,2777,6083,12608,2022-03-21 10:26:39.605153
37576,6605,22398,2116,9101,19283,59503,2022-03-21 10:26:42.715016
37577,122,897,102,79,1917,3117,2022-03-21 10:26:45.116609
37578,3964,25502,2042,3953,17842,53303,2022-03-21 10:26:45.552714
37579,8174,43832,3542,6351,29754,91653,2022-03-21 10:26:47.816972
37584,1795,4933,807,3184,11178,21897,2022-03-21 10:26:48.804268
37585,5253,67538,992,1625,13402,88810,2022-03-21 10:26:49.262178
37587,3995,14302,1353,3887,14538,38075,2022-03-21 10:26:54.5169
37589,488,1860,224,189,2667,5428,2022-03-21 10:26:58.633656
37590,215,3415,110,211,3898,7849,2022-03-21 10:27:03.092527
37591,7,45,7,33,100,192,2022-03-21 10:27:05.099841
37594,6,195,1,14,35,251,2022-03-21 10:27:06.899386
37595,242,2776,99,128,2259,5504,2022-03-21 10:27:07.07692
37597,9875,81763,3361,6097,26384,127480,2022-03-21 10:27:10.132627
37599,3383,11450,1228,3338,12946,32345,2022-03-21 10:27:13.995835
37600,98,682,76,113,3405,4374,2022-03-21 10:27:16.708027
37601,3671,12512,1504,6473,15228,39388,2022-03-21 10:27:20.182761
37602,6,145,1,11,32,195,2022-03-21 10:27:20.358452
37603,7,116,2,12,27,164,2022-03-21 10:27:22.192837
37605,5,142,0,14,38,199,2022-03-21 10:27:23.508414
37606,3,137,0,12,40,192,2022-03-21 10:27:24.71741
37607,6,196,3,13,50,268,2022-03-21 10:27:24.893284
37620,129,101,49,75,1178,1532,2022-03-21 10:27:33.37895
37622,134,2876,67,110,2126,5313,2022-03-21 10:27:36.755285
37623,448,14293,232,197,6833,22003,2022-03-21 10:27:39.428728
37626,5,334,8,26,97,470,2022-03-21 10:27:39.607633
37630,16,33,5,63,56,173,2022-03-21 10:27:42.118486
37640,19,43,8,45,60,175,2022-03-21 10:27:45.904845
37642,29,114,7,40,150,340,2022-03-21 10:27:50.694301
37643,199,192,78,128,475,1072,2022-03-21 10:27:54.446789
37646,160,1968,75,186,821,3210,2022-03-21 10:27:54.6221
37647,20,73,14,48,132,287,2022-03-21 10:27:57.818738
37651,1690,40543,815,647,16826,60521,2022-03-21 10:28:00.856479
37653,24,55,14,92,99,284,2022-03-21 10:28:01.968692
37657,1446,3877,627,2352,8477,16779,2022-03-21 10:28:03.311156
37661,13,109,7,45,188,362,2022-03-21 10:28:05.706406
37662,217,1038,170,780,884,3089,2022-03-21 10:28:09.366997
37663,303,1396,108,178,3542,5527,2022-03-21 10:28:10.935289
37665,14,117,7,60,107,305,2022-03-21 10:28:11.377652
37666,15,146,10,69,101,341,2022-03-21 10:28:11.911352
37669,6,103,1,17,29,156,2022-03-21 10:28:13.325488
37670,8,122,1,15,28,174,2022-03-21 10:28:14.464031
37672,170,2118,51,91,830,3260,2022-03-21 10:28:14.866593
37684,34,1372,11,29,607,2053,2022-03-21 10:28:19.132177
37687,7,37,2,37,35,118,2022-03-21 10:28:22.946464
37688,6,74,1,16,20,117,2022-03-21 10:28:24.090171
37689,6,70,2,17,24,119,2022-03-21 10:28:25.108725
37690,4,123,1,18,26,172,2022-03-21 10:28:26.136494
37691,4,95,0,19,25,143,2022-03-21 10:28:27.230687
37692,8,134,0,17,33,192,2022-03-21 10:28:28.730112
37695,12,144,0,22,34,212,2022-03-21 10:28:31.348003
37696,6,105,3,18,25,157,2022-03-21 10:28:31.533282
37698,5,44,5,40,50,144,2022-03-21 10:28:32.935013
37703,305,2009,207,176,8171,10868,2022-03-21 10:28:35.58442
37704,394,5055,227,99,7907,13682,2022-03-21 10:28:36.041715
37706,600,1,249,165,538,1553,2022-03-21 10:28:36.216745
37710,111,883,44,106,1317,2461,2022-03-21 10:28:38.333259
37711,987,15886,639,346,14937,32795,2022-03-21 10:28:38.506885
37716,6731,37983,3117,5402,28595,81828,2022-03-21 10:28:42.714086
37717,69,319,27,40,560,1015,2022-03-21 10:28:44.253781
37719,2327,60393,678,678,13374,77450,2022-03-21 10:28:46.90368
37720,3,100,1,16,26,146,2022-03-21 10:28:48.293064
37721,6,118,1,20,39,184,2022-03-21 10:28:49.469325
37722,8913,54358,3321,7094,32089,105775,2022-03-21 10:28:49.651425
37729,6,216,1,18,41,282,2022-03-21 10:28:55.216439
37731,3,97,0,8,24,132,2022-03-21 10:28:57.309577
37732,7,100,3,8,30,148,2022-03-21 10:28:58.393193
37734,1,102,0,8,28,139,2022-03-21 10:28:59.971816
37735,581,6993,181,448,4204,12407,2022-03-21 10:29:00.426521
37737,141,192,37,79,379,828,2022-03-21 10:29:07.533223
37739,249,1287,115,258,562,2471,2022-03-21 10:29:09.75483
37740,392,682,146,258,2241,3719,2022-03-21 10:29:11.752002
37742,16,1291,7,33,170,1517,2022-03-21 10:29:13.460324
37744,19425,161391,5015,32327,40269,258427,2022-03-21 10:29:13.715417
37747,603,3285,188,798,3518,8392,2022-03-21 10:29:16.407028
37749,17,88,5,60,88,258,2022-03-21 10:29:17.952038
37751,13,80,7,50,92,242,2022-03-21 10:29:19.774017
37752,39,90,10,60,142,341,2022-03-21 10:29:21.553004
37753,14,139,1,36,91,281,2022-03-21 10:29:22.619745
37755,672,1284,263,190,2611,5020,2022-03-21 10:29:22.791546
37760,769,8108,182,141,6020,15220,2022-03-21 10:29:25.749805
37764,413,9358,147,132,5249,15299,2022-03-21 10:29:30.816687
37765,673,13290,167,84,8929,23143,2022-03-21 10:29:32.087534
37769,411,2035,254,1147,2678,6525,2022-03-21 10:29:34.132565
37773,524,12775,215,151,12457,26122,2022-03-21 10:29:36.635016
37775,12,200,1,24,72,309,2022-03-21 10:29:36.818918
37776,11,188,2,25,72,298,2022-03-21 10:29:38.058097
37777,9,258,3,27,65,362,2022-03-21 10:29:39.759315
37778,268,3860,72,141,1095,5436,2022-03-21 10:29:42.706262
37779,88675,1293761,24138,22266,202985,1631825,2022-03-21 10:29:42.965876
37781,974,17667,410,401,5335,24787,2022-03-21 10:29:48.80777
37784,69,878,6,33,568,1554,2022-03-21 10:29:50.656243
37786,21270,130030,9138,8732,103534,272704,2022-03-21 10:29:50.844822
37787,68,112,34,195,254,663,2022-03-21 10:29:51.026618
37789,53,392,40,47,528,1060,2022-03-21 10:29:51.299942
37801,7,75,3,24,46,155,2022-03-21 10:29:53.42293
37802,20,248,5,34,141,448,2022-03-21 10:29:55.846672
37804,1050,10885,585,160,29889,42569,2022-03-21 10:29:56.314854
37806,11870,69950,4774,17895,26400,130889,2022-03-21 10:29:59.676862
37807,667,6369,345,109,27611,35101,2022-03-21 10:29:59.84738
37814,124,3960,59,93,1203,5439,2022-03-21 10:30:03.60569
37816,12,41,8,41,173,275,2022-03-21 10:30:05.214224
37818,103,66,44,74,670,957,2022-03-21 10:30:06.817811
37822,3240,6209,389,463,3272,13573,2022-03-21 10:30:09.517378
37823,8856,40581,3197,22911,28939,104484,2022-03-21 10:30:09.70184
37826,584,18922,224,130,7975,27835,2022-03-21 10:30:14.052104
37827,10,24,6,40,186,266,2022-03-21 10:30:16.793236
37828,691,8632,359,208,14122,24012,2022-03-21 10:30:16.965338
37831,803,24287,421,579,9111,35201,2022-03-21 10:30:19.613449
37839,0,0,0,0,8312,8312,2022-03-21 10:30:22.622698
37842,62,785,69,76,890,1882,2022-03-21 10:30:24.81237
37843,3,310,8,51,111,483,2022-03-21 10:30:26.009025
37845,10,605,6,18,94,733,2022-03-21 10:30:26.186581
37850,53,0,27,78,99,257,2022-03-21 10:30:26.431878
37851,19,41,13,52,90,215,2022-03-21 10:30:27.445126
37852,18,64,4,45,71,202,2022-03-21 10:30:28.587784
37859,132,2217,157,135,2879,5520,2022-03-21 10:30:34.326893
37863,62,1626,20,48,466,2222,2022-03-21 10:30:38.766888
37864,187,3645,85,126,1638,5681,2022-03-21 10:30:38.986218
37865,39,971,47,86,506,1649,2022-03-21 10:30:39.409291
37866,71,2247,43,71,883,3315,2022-03-21 10:30:43.281999
37867,4,153,1,13,38,209,2022-03-21 10:30:45.132052
37869,2501,21298,1050,1297,10044,36190,2022-03-21 10:30:45.308902
37873,1174,12669,407,413,4228,18891,2022-03-21 10:30:50.89624
37881,32,534,8,31,281,886,2022-03-21 10:31:01.624106
37884,363,13069,211,102,7334,21079,2022-03-21 10:31:04.433325
37885,27116,4,7049,14074,14462,62705,2022-03-21 10:31:04.613773
37887,485,1201,131,172,1466,3455,2022-03-21 10:31:10.142005
37890,2807,17606,1033,1891,12333,35670,2022-03-21 10:31:10.778559
37892,6,21,2,38,44,111,2022-03-21 10:31:14.818519
37893,790,11339,295,397,5633,18454,2022-03-21 10:31:15.001934
37896,190,416,55,77,498,1236,2022-03-21 10:31:21.007803
37902,420,15330,258,230,7957,24195,2022-03-21 10:31:24.018071
37904,51,38,25,63,488,665,2022-03-21 10:31:25.606825
37905,0,0,0,0,8595,8595,2022-03-21 10:31:28.201281
37910,219,4313,99,116,2368,7115,2022-03-21 10:31:31.674128
37914,1945,8102,269,315,11099,21730,2022-03-21 10:31:32.363218
37915,80,266,36,72,1190,1644,2022-03-21 10:31:34.205794
37916,369,4791,212,136,5112,10620,2022-03-21 10:31:34.388994
37920,8048,55016,3066,8271,29064,103465,2022-03-21 10:31:37.213537
37921,525,12390,261,173,6810,20159,2022-03-21 10:31:39.887929
37922,116,864,57,79,1247,2363,2022-03-21 10:31:42.454857
37923,14,642,3,25,145,829,2022-03-21 10:31:44.182052
37926,8807,56091,3451,8325,34633,111307,2022-03-21 10:31:47.157072
37927,10,41,7,40,93,191,2022-03-21 10:31:48.672583
37928,65,136,17,41,245,504,2022-03-21 10:31:50.458159
37929,8,28,3,31,56,126,2022-03-21 10:31:51.510953
37930,11,192,0,17,59,279,2022-03-21 10:31:51.688419
37931,28,81,11,58,122,300,2022-03-21 10:31:51.945877
37932,8146,43461,1775,1113,43774,98269,2022-03-21 10:31:55.223478
37933,60,386,35,57,605,1143,2022-03-21 10:31:55.416866
37934,54,344,33,48,576,1055,2022-03-21 10:31:55.666759
37936,3041,15479,626,390,20000,39536,2022-03-21 10:31:55.911303
37942,4,63,5,38,39,149,2022-03-21 10:31:57.931201
37943,4,56,4,40,35,139,2022-03-21 10:31:58.136146
37944,3,54,4,37,35,133,2022-03-21 10:32:00.298904
37947,7,147,1,13,38,206,2022-03-21 10:32:03.507515
37950,4,25,5,43,46,123,2022-03-21 10:32:05.300558
37951,15,26,7,52,79,179,2022-03-21 10:32:06.699182
37952,5186,15794,2279,13153,23299,59711,2022-03-21 10:32:06.870453
37958,3283,25025,1386,1249,13229,44172,2022-03-21 10:32:07.615982
37962,2957,8740,919,654,9997,23267,2022-03-21 10:32:16.535478
37963,663,5274,187,332,5998,12454,2022-03-21 10:32:16.816723
37964,5138,25920,2110,6294,18213,57675,2022-03-21 10:32:16.981365
37966,197,15048,152,225,4679,20301,2022-03-21 10:32:23.330127
37967,302,7348,223,220,4749,12842,2022-03-21 10:32:26.923171
37969,26,497,24,57,768,1372,2022-03-21 10:32:30.00365
37972,11421,82603,4467,4829,62860,166180,2022-03-21 10:32:34.139434
37973,124,3286,60,75,2016,5561,2022-03-21 10:32:36.647794
37976,36781,230087,19318,30540,105836,422562,2022-03-21 10:32:40.226594
37979,6739,27797,2390,7005,29351,73282,2022-03-21 10:32:41.967239
43640,0,27,1,5,9,42,2022-03-21 11:31:23.674948
37980,571,685,258,415,2023,3952,2022-03-21 10:32:47.813865
37981,2497,31678,899,407,43857,79338,2022-03-21 10:32:51.041313
37982,32407,432964,10380,26249,105625,607625,2022-03-21 10:32:51.303385
37983,962,18497,344,198,9538,29539,2022-03-21 10:32:51.482402
37984,60419,170243,7721,14491,65519,318393,2022-03-21 10:32:55.296693
37986,1836,59432,731,367,28177,90543,2022-03-21 10:32:55.919173
37987,11019,189520,3528,865,201449,406381,2022-03-21 10:32:59.783589
37988,574,5052,218,412,2602,8858,2022-03-21 10:33:03.542647
37989,9048,104669,3904,1910,35574,155105,2022-03-21 10:33:06.636921
37990,209,2926,92,266,831,4324,2022-03-21 10:33:09.303605
37991,73083,605817,13757,7874,101939,802470,2022-03-21 10:33:09.585756
37994,3016,26400,1140,1493,46041,78090,2022-03-21 10:33:13.468514
37996,505,29938,272,141,10192,41048,2022-03-21 10:33:15.836693
37998,5725,31546,2131,6653,23885,69940,2022-03-21 10:33:19.098395
43643,0,8,1,6,12,27,2022-03-21 11:31:24.039724
37999,85679,1012796,26877,23267,199129,1347748,2022-03-21 10:33:21.41317
38000,191910,1900854,33840,28992,168479,2324075,2022-03-21 10:33:21.849289
38001,17,83,9,52,185,346,2022-03-21 10:33:22.283993
38003,26717,317366,9903,4437,113042,471465,2022-03-21 10:33:22.980178
38009,762,3726,360,1059,3701,9608,2022-03-21 10:33:23.932756
38015,178,191,114,39,17914,18436,2022-03-21 10:33:26.83852
38019,116,173,47,91,1051,1478,2022-03-21 10:33:29.490099
38022,733,781,230,325,2681,4750,2022-03-21 10:33:38.857766
38024,62,594,30,54,510,1250,2022-03-21 10:33:41.582084
38025,53,0,26,73,151,303,2022-03-21 10:33:41.781598
38026,396,2151,240,215,11148,14150,2022-03-21 10:33:44.636741
38027,403,11336,247,164,5913,18063,2022-03-21 10:33:44.829023
38028,44,981,33,75,537,1670,2022-03-21 10:33:46.829115
38029,5,112,4,30,52,203,2022-03-21 10:33:47.006928
38040,12661,487815,3175,2271,109161,615083,2022-03-21 10:33:47.45917
38045,8,392,9,32,94,535,2022-03-21 10:33:49.846718
38046,116,1583,72,80,2614,4465,2022-03-21 10:33:52.838432
38048,8,70,0,34,65,177,2022-03-21 10:33:54.388615
38050,329,3730,150,138,2284,6631,2022-03-21 10:33:55.722527
38051,27,1045,11,32,307,1422,2022-03-21 10:33:58.206686
38054,21,327,4,21,217,590,2022-03-21 10:33:58.822981
38055,536,5048,223,262,7847,13916,2022-03-21 10:34:04.054885
38056,57,238,42,76,950,1363,2022-03-21 10:34:05.941268
38057,64,76,35,52,951,1178,2022-03-21 10:34:08.496335
38059,17,713,6,44,213,993,2022-03-21 10:34:10.57613
38061,240,7669,117,119,2398,10543,2022-03-21 10:34:14.388934
38066,5,161,3,44,66,279,2022-03-21 10:34:21.443845
38067,165,917,82,126,1629,2919,2022-03-21 10:34:23.472704
38072,5,114,6,41,42,208,2022-03-21 10:34:30.884158
38073,6,96,6,37,48,193,2022-03-21 10:34:33.079094
38074,5,102,7,44,42,200,2022-03-21 10:34:34.178133
38075,8,83,6,47,49,193,2022-03-21 10:34:35.204389
38080,15613,110590,6243,6876,89638,228960,2022-03-21 10:34:38.266785
38081,705,15531,256,156,9957,26605,2022-03-21 10:34:38.476497
38082,0,0,0,0,12910,12910,2022-03-21 10:34:41.606968
38084,24218,119017,8610,7231,66901,225977,2022-03-21 10:34:44.886164
38085,1412,25958,692,264,36810,65136,2022-03-21 10:34:48.687804
38087,44,130,29,79,686,968,2022-03-21 10:34:53.656842
38088,919,16948,315,262,15360,33804,2022-03-21 10:34:54.110089
38091,2077,9066,1100,3873,8372,24488,2022-03-21 10:35:01.886853
38092,4,43,4,31,37,119,2022-03-21 10:35:03.19275
38094,2,31,2,33,29,97,2022-03-21 10:35:07.733888
38096,21,316,6,23,231,597,2022-03-21 10:35:07.946462
38098,2166,8583,1032,1629,6681,20091,2022-03-21 10:35:13.176432
38099,38,0,12,68,77,195,2022-03-21 10:35:14.32417
38100,97,78,38,65,831,1109,2022-03-21 10:35:16.712028
38101,34924,582635,10483,15355,101109,744506,2022-03-21 10:35:16.90377
38104,230,1991,124,152,2163,4660,2022-03-21 10:35:17.161777
38110,157,173,82,82,637,1131,2022-03-21 10:35:22.08165
38114,12,108,7,44,131,302,2022-03-21 10:35:25.603066
38117,2,92,1,42,38,175,2022-03-21 10:35:26.909284
38118,5,99,4,49,38,195,2022-03-21 10:35:28.06702
38119,3,99,3,48,37,190,2022-03-21 10:35:29.600764
38120,4,96,1,52,40,193,2022-03-21 10:35:31.203431
38121,5,97,1,61,47,211,2022-03-21 10:35:32.278506
38122,4,100,1,54,39,198,2022-03-21 10:35:33.374417
38125,4,99,1,57,32,193,2022-03-21 10:35:37.051734
38127,5,97,1,53,36,192,2022-03-21 10:35:39.520036
38128,5,92,2,57,36,192,2022-03-21 10:35:41.163805
38130,10,164,4,20,161,359,2022-03-21 10:35:44.827253
38131,6,100,2,62,37,207,2022-03-21 10:35:46.318077
38132,3,87,2,44,31,167,2022-03-21 10:35:47.747861
38134,3,85,3,45,35,171,2022-03-21 10:35:50.143026
38135,6,80,2,52,34,174,2022-03-21 10:35:51.436104
38138,15,83,3,73,51,225,2022-03-21 10:35:54.876314
38140,4,79,2,52,36,173,2022-03-21 10:35:56.299445
38142,7,335,4,13,54,413,2022-03-21 10:35:57.638063
38145,12674,91913,5344,6303,48275,164509,2022-03-21 10:36:00.136345
38147,23,45,10,115,191,384,2022-03-21 10:36:00.489795
38149,220,2843,109,153,2238,5563,2022-03-21 10:36:00.660302
38150,1288,3230,494,2078,6291,13381,2022-03-21 10:36:02.820308
38153,6,139,2,21,77,245,2022-03-21 10:36:07.713659
38154,93,1796,102,167,1217,3375,2022-03-21 10:36:10.439814
38157,1415,4606,649,2088,7109,15867,2022-03-21 10:36:13.355561
38158,6,162,4,28,62,262,2022-03-21 10:36:13.591488
38161,7849,21169,3773,10122,33393,76306,2022-03-21 10:36:16.487903
38162,677,3261,337,1993,3683,9951,2022-03-21 10:36:16.681544
38163,1204,13643,397,406,11921,27571,2022-03-21 10:36:19.110032
38164,65,70,24,44,674,877,2022-03-21 10:36:21.179919
38167,3,27,4,19,32,85,2022-03-21 10:36:23.191867
38175,42,133,27,68,369,639,2022-03-21 10:36:25.625466
38177,94,873,61,70,1050,2148,2022-03-21 10:36:26.677928
38179,197,662,93,112,2759,3823,2022-03-21 10:36:29.136706
38180,137,1040,74,86,1457,2794,2022-03-21 10:36:29.315924
38181,39,2107,10,57,393,2606,2022-03-21 10:36:29.574177
38186,22469,238035,7637,12704,85279,366124,2022-03-21 10:36:30.092522
38195,4,17,3,33,34,91,2022-03-21 10:36:34.435503
38198,1493,43305,637,489,21770,67694,2022-03-21 10:36:37.38614
38199,549,2160,266,1571,3014,7560,2022-03-21 10:36:37.651722
38201,243,6830,116,125,5185,12499,2022-03-21 10:36:40.630362
38206,62,100,33,51,587,833,2022-03-21 10:36:43.184402
38211,61,382,36,75,631,1185,2022-03-21 10:36:43.387875
38212,1240,8162,420,919,7067,17808,2022-03-21 10:36:46.125514
38217,862,9593,311,468,4617,15851,2022-03-21 10:36:46.299143
38219,45,51,20,48,460,624,2022-03-21 10:36:48.6217
38220,143,1058,35,75,725,2036,2022-03-21 10:36:51.091837
38226,1106,7661,505,2282,3838,15392,2022-03-21 10:36:53.552224
38234,2268,101684,566,330,21743,126591,2022-03-21 10:36:53.769298
38249,3542,145052,812,535,23994,173935,2022-03-21 10:36:58.292084
38250,927,1365,508,435,4338,7573,2022-03-21 10:37:01.73358
38254,691,5257,265,462,4588,11263,2022-03-21 10:37:07.258986
38256,12798,50827,5703,9660,55950,134938,2022-03-21 10:37:07.46556
38262,1081,3879,282,684,3545,9471,2022-03-21 10:37:10.087323
38267,7,179,2,11,37,236,2022-03-21 10:37:10.359755
38268,1157,4879,391,691,8620,15738,2022-03-21 10:37:12.90955
38271,20,576,19,33,350,998,2022-03-21 10:37:13.094515
38272,52,48,21,37,474,632,2022-03-21 10:37:15.167876
38273,0,0,0,0,4573,4573,2022-03-21 10:37:15.347735
38274,0,0,0,0,1166,1166,2022-03-21 10:37:17.687504
38276,3642,19298,1878,4797,13155,42770,2022-03-21 10:37:20.235907
38279,0,0,0,0,1449,1449,2022-03-21 10:37:22.176252
38284,256,360,128,376,1392,2512,2022-03-21 10:37:22.364852
38287,5,64,4,19,30,122,2022-03-21 10:37:26.332573
38291,62,899,53,82,1390,2486,2022-03-21 10:37:29.714488
38295,4055,25002,1459,5758,18319,54593,2022-03-21 10:37:33.401215
38297,13463,131227,3323,15294,32212,195519,2022-03-21 10:37:33.756154
38301,2553,10095,1171,3646,12450,29915,2022-03-21 10:37:35.896042
38302,4333,19078,1977,5909,19296,50593,2022-03-21 10:37:38.551249
43652,0,19,1,8,8,36,2022-03-21 11:31:26.581574
38304,4,82,3,15,28,132,2022-03-21 10:37:40.912639
38305,3,98,1,13,23,138,2022-03-21 10:37:41.167325
38306,4,81,1,17,22,125,2022-03-21 10:37:43.485924
38310,6,101,3,23,30,163,2022-03-21 10:37:44.528331
38323,3,112,0,15,22,152,2022-03-21 10:37:46.676615
38325,547,1647,196,120,4041,6551,2022-03-21 10:37:50.047161
38326,3,97,0,16,40,156,2022-03-21 10:37:51.318167
38327,1,79,2,20,22,124,2022-03-21 10:37:52.709403
38328,15946,49994,6582,16133,52292,140947,2022-03-21 10:37:52.884355
38329,12069,433016,3087,1481,111212,560865,2022-03-21 10:37:53.143798
38331,1973,6187,770,3257,10585,22772,2022-03-21 10:37:53.320631
38346,20,201,8,38,199,466,2022-03-21 10:37:54.190406
38352,4,72,0,21,43,140,2022-03-21 10:38:03.063998
38353,6,244,1,30,60,341,2022-03-21 10:38:05.761572
38354,19,135,2,18,70,244,2022-03-21 10:38:06.997304
38357,232,4851,95,106,2660,7944,2022-03-21 10:38:09.67429
38360,804,9888,371,166,9107,20336,2022-03-21 10:38:12.133
38361,144,447,49,59,843,1542,2022-03-21 10:38:14.192146
38363,10,114,8,63,137,332,2022-03-21 10:38:15.49598
38365,35,51,13,143,153,395,2022-03-21 10:38:17.934709
38368,14,127,8,52,152,353,2022-03-21 10:38:21.604247
38372,28,385,19,32,372,836,2022-03-21 10:38:23.616006
38375,4,139,0,10,43,196,2022-03-21 10:38:25.771042
38376,8,156,1,19,46,230,2022-03-21 10:38:27.432318
38378,24,234,5,43,59,365,2022-03-21 10:38:29.460584
38379,11,128,4,47,46,236,2022-03-21 10:38:30.746204
38383,507,17758,176,164,4087,22692,2022-03-21 10:38:30.950655
38384,16,55,8,37,92,208,2022-03-21 10:38:34.062833
38385,6,339,3,16,99,463,2022-03-21 10:38:35.389743
38387,2,103,2,12,28,147,2022-03-21 10:38:38.133979
38389,612,6197,293,434,4836,12372,2022-03-21 10:38:38.336291
38390,3383,16201,1631,4799,15198,41212,2022-03-21 10:38:41.502148
38392,7,609,8,23,104,751,2022-03-21 10:38:41.683016
38393,39,189,24,67,776,1095,2022-03-21 10:38:44.162511
38395,3339,15520,997,2306,13682,35844,2022-03-21 10:38:46.793772
38397,20287,180015,5970,14094,63343,283709,2022-03-21 10:38:47.237278
38400,490,2621,360,96,44365,47932,2022-03-21 10:38:51.658412
38403,126,56,35,68,917,1202,2022-03-21 10:38:53.528265
38407,6,140,2,28,55,231,2022-03-21 10:38:54.587984
38408,132637,1075111,26646,21205,150253,1405852,2022-03-21 10:38:54.765584
38409,3135,36028,1087,1003,16869,58122,2022-03-21 10:38:57.58778
38410,366,11308,115,94,2225,14108,2022-03-21 10:39:01.013029
38411,43,406,15,35,496,995,2022-03-21 10:39:01.187129
38412,23,346,17,56,232,674,2022-03-21 10:39:04.32095
38413,163,252,47,86,1114,1662,2022-03-21 10:39:04.734907
38414,4290,133571,1514,658,64776,204809,2022-03-21 10:39:07.848009
38419,252,1925,130,115,3388,5810,2022-03-21 10:39:12.890252
38422,1288,51587,444,322,9806,63447,2022-03-21 10:39:15.762136
38424,10,211,1,24,62,308,2022-03-21 10:39:17.246041
38425,853,3147,278,274,5943,10495,2022-03-21 10:39:19.591508
38426,249,3697,127,137,2907,7117,2022-03-21 10:39:19.779167
38429,110,946,80,77,1974,3187,2022-03-21 10:39:25.021355
38431,1375,19638,597,347,7207,29164,2022-03-21 10:39:27.811286
38433,76,755,62,104,954,1951,2022-03-21 10:39:27.986784
38435,469,4852,118,162,1237,6838,2022-03-21 10:39:29.881236
38436,335,3557,71,125,1321,5409,2022-03-21 10:39:30.055448
38440,1388,2203,287,1634,8498,14010,2022-03-21 10:39:32.103465
38444,156,1271,63,85,1721,3296,2022-03-21 10:39:34.007008
38445,4,212,2,15,29,262,2022-03-21 10:39:35.163686
38446,13,309,11,50,82,465,2022-03-21 10:39:36.537575
38449,562,1810,291,2550,3839,9052,2022-03-21 10:39:39.401852
38450,5358,46452,1296,873,27239,81218,2022-03-21 10:39:39.585213
38461,56,203,29,34,632,954,2022-03-21 10:39:42.885166
38467,298,708,51,91,877,2025,2022-03-21 10:39:44.048358
38474,21290,71975,4634,1531,72417,171847,2022-03-21 10:39:45.73549
38483,27903,243901,7687,13059,82838,375388,2022-03-21 10:39:46.905591
38490,185,447,58,88,557,1335,2022-03-21 10:39:50.671025
38491,573,3249,103,190,1550,5665,2022-03-21 10:39:53.114053
38493,11,124,1,29,70,235,2022-03-21 10:39:54.304062
38495,5,116,2,10,31,164,2022-03-21 10:39:55.417526
38496,8,127,1,36,51,223,2022-03-21 10:39:55.590523
38500,7,150,1,10,30,198,2022-03-21 10:39:59.693991
38501,2,166,1,12,36,217,2022-03-21 10:40:01.05972
38502,7,117,1,9,25,159,2022-03-21 10:40:01.226995
38503,5,108,1,10,21,145,2022-03-21 10:40:03.246093
38504,4,116,0,9,20,149,2022-03-21 10:40:03.672152
38506,6,132,2,18,53,211,2022-03-21 10:40:05.523892
38507,3,133,1,8,23,168,2022-03-21 10:40:05.740573
38508,9,176,2,19,52,258,2022-03-21 10:40:07.911632
38520,25,843,4,25,175,1072,2022-03-21 10:40:10.604054
38524,67389,1555995,7418,4734,119167,1754703,2022-03-21 10:40:11.42574
38527,145,3738,108,76,4368,8435,2022-03-21 10:40:15.021445
38528,2223,30614,537,573,7506,41453,2022-03-21 10:40:15.2362
38529,2851,9848,1159,4830,14608,33296,2022-03-21 10:40:17.410539
38533,344,1439,108,109,2392,4392,2022-03-21 10:40:20.070774
38534,22,159,12,32,76,301,2022-03-21 10:40:24.113761
38535,13,134,8,29,61,245,2022-03-21 10:40:25.442068
38536,2594,8393,817,702,18960,31466,2022-03-21 10:40:25.88025
38537,8,58,2,38,49,155,2022-03-21 10:40:26.995126
38538,10,59,3,32,53,157,2022-03-21 10:40:29.564696
38539,12,124,7,17,132,292,2022-03-21 10:40:30.881671
38540,46,704,28,52,673,1503,2022-03-21 10:40:31.062596
38544,3179,13084,1330,5258,11740,34591,2022-03-21 10:40:33.980387
38545,11,398,12,37,158,616,2022-03-21 10:40:35.408484
38551,3,297,3,17,59,379,2022-03-21 10:40:38.897047
38552,12,49,1,30,42,134,2022-03-21 10:40:40.066191
38555,31552,228001,8226,11417,76168,355364,2022-03-21 10:40:42.080842
38556,149,210,59,82,1285,1785,2022-03-21 10:40:47.044818
38557,61,0,19,66,301,447,2022-03-21 10:40:48.383298
38558,157,1276,75,105,2983,4596,2022-03-21 10:40:50.524862
38560,7,62,6,44,65,184,2022-03-21 10:40:52.295426
38561,59,33,30,48,594,764,2022-03-21 10:40:53.849254
38562,29,190,24,67,667,977,2022-03-21 10:40:55.613001
38569,4,41,3,39,48,135,2022-03-21 10:40:58.428518
38570,5,40,3,40,49,137,2022-03-21 10:40:59.511226
38572,23112,166208,8119,33393,58653,289485,2022-03-21 10:41:00.158771
38573,21942,107083,8004,38008,60967,236004,2022-03-21 10:41:02.64899
38578,1429,2890,643,677,3451,9090,2022-03-21 10:41:08.336869
38579,39,30,13,43,329,454,2022-03-21 10:41:09.799524
38585,0,0,0,0,5619,5619,2022-03-21 10:41:13.717478
38587,6,160,7,23,67,263,2022-03-21 10:41:13.91171
38594,4139,78531,1578,653,72781,157682,2022-03-21 10:41:15.084752
38600,103,407,85,101,1536,2232,2022-03-21 10:41:17.295514
38603,63,44,15,45,209,376,2022-03-21 10:41:19.421881
38606,76,394,36,50,696,1252,2022-03-21 10:41:21.427537
38609,18,14,7,36,41,116,2022-03-21 10:41:23.041163
38611,10,86,7,45,53,201,2022-03-21 10:41:28.105744
38613,7,41,3,37,47,135,2022-03-21 10:41:29.842325
38614,5,49,4,36,46,140,2022-03-21 10:41:30.93317
38618,3,40,6,36,94,179,2022-03-21 10:41:34.785678
38623,33,0,18,54,51,156,2022-03-21 10:41:40.908923
38624,8,106,2,42,87,245,2022-03-21 10:41:42.461332
38626,42,33,22,64,179,340,2022-03-21 10:41:43.851518
38628,2013,11660,1090,2589,9517,26869,2022-03-21 10:41:45.358146
38629,67,770,34,69,715,1655,2022-03-21 10:41:47.610787
38631,14,73,8,55,55,205,2022-03-21 10:41:50.491198
38640,2,114,3,14,30,163,2022-03-21 10:41:54.315191
38641,6,61,2,16,51,136,2022-03-21 10:41:55.436612
38643,3,46,4,15,38,106,2022-03-21 10:41:56.564372
38644,4,185,1,19,60,269,2022-03-21 10:41:57.698417
38646,29,142,15,70,545,801,2022-03-21 10:41:57.870467
38647,25,133,15,69,482,724,2022-03-21 10:42:00.835231
38648,27,122,14,64,474,701,2022-03-21 10:42:02.220121
38650,51,528,26,60,545,1210,2022-03-21 10:42:04.027061
38653,315,10243,153,231,3607,14549,2022-03-21 10:42:04.458389
38656,33414,285966,9271,20208,93380,442239,2022-03-21 10:42:07.057693
38658,4,326,0,13,39,382,2022-03-21 10:42:08.441576
38659,32347,358353,9113,13905,77066,490784,2022-03-21 10:42:08.730966
38663,1907,16645,704,1724,9976,30956,2022-03-21 10:42:11.250003
38664,238,5350,84,74,3225,8971,2022-03-21 10:42:14.504917
38667,82,1099,43,91,1125,2440,2022-03-21 10:42:14.694052
38669,538,1727,191,349,3753,6558,2022-03-21 10:42:18.093007
38670,1294,5403,648,1699,6521,15565,2022-03-21 10:42:23.060846
38671,128498,628229,47292,61016,177562,1042597,2022-03-21 10:42:23.493026
38673,323,2933,118,402,1896,5672,2022-03-21 10:42:26.861958
38674,17,251,4,32,100,404,2022-03-21 10:42:30.068599
38676,48,251,25,44,479,847,2022-03-21 10:42:30.243621
38677,280,791,101,137,2217,3526,2022-03-21 10:42:35.794848
38678,45,1018,22,42,341,1468,2022-03-21 10:42:37.588337
38680,69533,342036,29205,24017,170718,635509,2022-03-21 10:42:37.762578
38681,224,1971,86,113,2529,4923,2022-03-21 10:42:39.821257
38683,8,114,9,53,111,295,2022-03-21 10:42:41.714241
38685,30,94,8,46,128,306,2022-03-21 10:42:43.831112
38710,818,9211,466,142,7229,17866,2022-03-21 10:43:05.840997
38691,138655,970001,40745,41622,197923,1388946,2022-03-21 10:42:49.138141
38693,406,9293,211,248,5508,15666,2022-03-21 10:42:51.377362
38700,12,217,1,16,60,306,2022-03-21 10:42:56.635238
38701,10,438,2,23,81,554,2022-03-21 10:42:58.872532
38702,6,312,3,19,92,432,2022-03-21 10:43:00.10987
38703,8,142,1,12,114,277,2022-03-21 10:43:00.740922
38705,17,70,13,64,250,414,2022-03-21 10:43:03.35793
38707,2702,10063,1341,4995,11357,30458,2022-03-21 10:43:03.531547
38711,49,55,22,60,180,366,2022-03-21 10:43:09.868913
38712,6,593,4,36,70,709,2022-03-21 10:43:11.314918
38715,224,396,100,262,1072,2054,2022-03-21 10:43:14.06124
38716,0,0,0,0,4994,4994,2022-03-21 10:43:16.875324
38717,0,0,0,0,4085,4085,2022-03-21 10:43:17.104234
38719,461,955,158,450,1699,3723,2022-03-21 10:43:20.885918
38720,122,2670,72,73,2355,5292,2022-03-21 10:43:23.807305
38722,19,135,10,20,224,408,2022-03-21 10:43:25.325188
38727,11,559,0,35,77,682,2022-03-21 10:43:26.723849
38728,3,244,1,14,49,311,2022-03-21 10:43:26.910986
38729,13,48,1,29,142,233,2022-03-21 10:43:28.272326
38731,11236,40838,2546,1387,16866,72873,2022-03-21 10:43:28.708814
38733,551,35012,278,123,6577,42541,2022-03-21 10:43:31.483308
38735,4826,63615,2558,7296,31999,110294,2022-03-21 10:43:31.905518
38739,67,854,41,59,1135,2156,2022-03-21 10:43:35.135509
38740,243,3642,93,103,2274,6355,2022-03-21 10:43:37.677972
38741,455,1320,96,177,1065,3113,2022-03-21 10:43:39.341391
38742,378,889,108,188,2587,4150,2022-03-21 10:43:39.556103
38743,6,23,5,37,137,208,2022-03-21 10:43:41.474819
38744,183,599,39,94,1115,2030,2022-03-21 10:43:41.652427
38748,6,447,3,25,91,572,2022-03-21 10:43:45.558518
38749,1996,2194,304,1114,14082,19690,2022-03-21 10:43:46.016935
38752,4,104,2,8,28,146,2022-03-21 10:43:47.159917
38753,19174,149282,7726,9369,91151,276702,2022-03-21 10:43:47.321376
38766,12,250,1,24,46,333,2022-03-21 10:43:52.167309
38767,177,2007,88,160,1438,3870,2022-03-21 10:43:55.227083
38768,447,19883,221,218,5505,26274,2022-03-21 10:43:55.586793
38770,469,16717,153,167,5089,22595,2022-03-21 10:43:59.882498
38771,10,142,0,20,46,218,2022-03-21 10:44:00.103841
38772,10,154,1,17,42,224,2022-03-21 10:44:01.856422
38773,7,213,0,18,48,286,2022-03-21 10:44:03.08888
38774,60,74,16,51,76,277,2022-03-21 10:44:03.26699
38776,61,0,21,152,126,360,2022-03-21 10:44:04.717195
38777,4630,15190,728,778,19632,40958,2022-03-21 10:44:04.897928
38778,15314,136843,5180,11836,55679,224852,2022-03-21 10:44:05.331685
38787,12494,84296,4446,6627,54375,162238,2022-03-21 10:44:08.634531
38789,317,4988,146,125,2857,8433,2022-03-21 10:44:09.506501
38790,32276,274600,9667,15942,67469,399954,2022-03-21 10:44:15.037119
38793,23885,108068,6767,2346,41052,182118,2022-03-21 10:44:15.233625
38794,5,126,1,8,30,170,2022-03-21 10:44:16.584225
38795,7,200,1,14,38,260,2022-03-21 10:44:16.849153
38797,1739,18470,419,1052,6527,28207,2022-03-21 10:44:21.631727
38799,1173,9081,528,1340,16635,28757,2022-03-21 10:44:22.119134
38800,7,134,0,17,45,203,2022-03-21 10:44:23.535486
38803,85,690,59,89,1037,1960,2022-03-21 10:44:25.460672
38804,234,630,67,175,1150,2256,2022-03-21 10:44:27.93108
38805,6,120,3,31,54,214,2022-03-21 10:44:29.102057
38807,804,33432,284,602,8302,43424,2022-03-21 10:44:29.573648
38808,8,535,8,11,89,651,2022-03-21 10:44:30.061096
38809,8,566,4,12,110,700,2022-03-21 10:44:31.909743
38811,1,140,0,9,22,172,2022-03-21 10:44:33.616837
38812,1,169,2,12,35,219,2022-03-21 10:44:34.92571
38813,7,200,2,14,44,267,2022-03-21 10:44:35.991157
38815,373,41724,133,115,3637,45982,2022-03-21 10:44:42.673123
38816,5771,102042,1895,1182,75763,186653,2022-03-21 10:44:45.507223
38821,27,50,10,50,128,265,2022-03-21 10:44:49.99979
38824,188,5811,52,51,1882,7984,2022-03-21 10:44:50.21914
38826,17677,554655,4118,1310,184141,761901,2022-03-21 10:44:52.565496
38827,57,21,14,46,81,219,2022-03-21 10:44:53.798009
38830,14749,126746,2508,10070,27059,181132,2022-03-21 10:44:55.470467
38835,1096,7167,318,914,4751,14246,2022-03-21 10:44:57.026845
38837,77,437,25,89,567,1195,2022-03-21 10:44:59.745122
38848,3,45,5,28,43,124,2022-03-21 10:45:03.603174
38850,70,1420,52,99,1259,2900,2022-03-21 10:45:06.27435
38851,763,1732,345,1814,2969,7623,2022-03-21 10:45:06.809151
38853,8869,11109,1463,27590,22908,71939,2022-03-21 10:45:08.957292
38854,32,304,23,36,560,955,2022-03-21 10:45:10.879046
38855,3,163,4,11,26,207,2022-03-21 10:45:11.130448
38856,3,116,1,7,23,150,2022-03-21 10:45:12.882803
38860,775,2406,310,995,6715,11201,2022-03-21 10:45:15.065961
38862,3,34,4,31,41,113,2022-03-21 10:45:15.980476
38872,4,57,5,42,93,201,2022-03-21 10:45:18.533287
38877,5,25,5,36,42,113,2022-03-21 10:45:21.092456
38883,51547,576234,10679,4011,96934,739405,2022-03-21 10:45:21.9239
38895,280,3651,144,103,2032,6210,2022-03-21 10:45:23.104593
38896,5,142,2,6,32,187,2022-03-21 10:45:26.611185
38897,577,7066,343,174,8929,17089,2022-03-21 10:45:26.820577
38898,5,165,1,11,27,209,2022-03-21 10:45:27.099241
38906,15,662,6,22,194,899,2022-03-21 10:45:32.253094
38907,10,149,6,38,56,259,2022-03-21 10:45:33.752362
38909,15569,76522,4685,16798,32686,146260,2022-03-21 10:45:34.685474
38910,0,0,0,0,483,483,2022-03-21 10:45:36.42805
38913,3,200,2,7,40,252,2022-03-21 10:45:37.896066
38914,5,122,2,7,25,161,2022-03-21 10:45:39.022285
38915,646,8400,185,281,6257,15769,2022-03-21 10:45:39.969726
38916,92,398,27,72,402,991,2022-03-21 10:45:41.184223
38917,2140,16843,571,716,10168,30438,2022-03-21 10:45:41.374809
38918,270,472,66,109,675,1592,2022-03-21 10:45:43.952475
38920,2410,8826,849,2792,10544,25421,2022-03-21 10:45:45.596057
38921,288,13796,154,96,6267,20601,2022-03-21 10:45:45.858227
38924,14379,58249,6520,11661,55890,146699,2022-03-21 10:45:46.451948
38925,38,1,33,47,94,213,2022-03-21 10:45:49.708747
38931,25,42,6,28,70,171,2022-03-21 10:45:54.440429
38933,7,122,3,14,57,203,2022-03-21 10:45:57.140319
38934,23,638,8,15,195,879,2022-03-21 10:45:58.544101
38935,7381,51924,2185,4644,33444,99578,2022-03-21 10:46:00.961488
38938,4573,31671,1486,1521,30189,69440,2022-03-21 10:46:06.454647
38939,750,15849,413,400,10105,27517,2022-03-21 10:46:11.130156
38940,10298,50626,4633,11485,27523,104565,2022-03-21 10:46:12.105798
38954,13,243,9,61,195,521,2022-03-21 10:46:13.64155
38955,5,207,3,18,47,280,2022-03-21 10:46:13.836654
38957,20,968,9,18,192,1207,2022-03-21 10:46:14.78286
38959,12065,61600,5056,6755,46181,131657,2022-03-21 10:46:17.051081
38961,5,337,1,15,32,390,2022-03-21 10:46:21.344344
38963,619,11258,359,232,9111,21579,2022-03-21 10:46:24.318087
38964,4,202,2,14,38,260,2022-03-21 10:46:24.506543
38968,4,138,2,9,33,186,2022-03-21 10:46:24.764928
38969,6,135,3,10,36,190,2022-03-21 10:46:26.100534
38970,10,227,5,21,85,348,2022-03-21 10:46:27.96763
38971,283,5994,174,178,3363,9992,2022-03-21 10:46:28.143333
38972,1010,24671,341,647,7712,34381,2022-03-21 10:46:30.240827
38974,4,382,3,13,49,451,2022-03-21 10:46:33.55636
38976,12,183,5,21,73,294,2022-03-21 10:46:34.693927
38977,10,205,2,18,81,316,2022-03-21 10:46:35.011718
38980,12,711,2,31,59,815,2022-03-21 10:46:36.013775
38981,52,1165,26,66,336,1645,2022-03-21 10:46:37.384171
38982,0,0,0,0,9331,9331,2022-03-21 10:46:39.042531
38985,466,5969,224,229,10022,16910,2022-03-21 10:46:41.885447
38986,7,616,7,26,106,762,2022-03-21 10:46:43.30567
38987,46,549,28,55,500,1178,2022-03-21 10:46:43.502094
38990,1072,7892,166,234,3411,12775,2022-03-21 10:46:44.901264
38992,24896,122656,10286,13641,83879,255358,2022-03-21 10:46:45.432442
38993,15933,175381,6021,4062,66680,268077,2022-03-21 10:46:45.906693
39002,6,43,7,36,138,230,2022-03-21 10:46:48.656042
39003,31,43,15,111,262,462,2022-03-21 10:46:51.06702
39007,35,37,8,92,671,843,2022-03-21 10:46:52.758183
39012,11,27,6,51,52,147,2022-03-21 10:46:56.947103
39013,27,52,8,42,88,217,2022-03-21 10:46:58.104365
39014,498,8347,357,225,13569,22996,2022-03-21 10:46:58.284882
39017,35267,184764,12847,22134,99549,354561,2022-03-21 10:46:58.543701
39024,606,2920,98,180,1392,5196,2022-03-21 10:46:59.674622
39027,13,209,3,46,83,354,2022-03-21 10:47:05.905702
39028,5,51,2,23,56,137,2022-03-21 10:47:07.205854
39029,19,59,9,87,129,303,2022-03-21 10:47:08.440812
39030,15400,97514,4640,14342,36676,168572,2022-03-21 10:47:09.367675
39031,52,69,16,147,291,575,2022-03-21 10:47:09.540699
39032,9,66,8,36,101,220,2022-03-21 10:47:10.937263
39034,5,29,2,34,58,128,2022-03-21 10:47:13.788597
39037,12,75,7,28,132,254,2022-03-21 10:47:17.010564
39039,77,145,19,155,537,933,2022-03-21 10:47:17.671122
39040,48,57,13,137,213,468,2022-03-21 10:47:20.067364
39046,51,175,32,55,514,827,2022-03-21 10:47:21.57805
39048,42,0,23,25,30,120,2022-03-21 10:47:23.3923
39049,1779,16202,824,674,11009,30488,2022-03-21 10:47:23.597668
39057,52,1633,15,54,252,2006,2022-03-21 10:47:29.482275
39063,16230,43059,7581,34461,51238,152569,2022-03-21 10:47:30.007793
39065,49,3258,9,31,416,3763,2022-03-21 10:47:34.211477
39066,180,1218,78,119,1316,2911,2022-03-21 10:47:37.696069
39067,26,252,17,52,691,1038,2022-03-21 10:47:40.007977
39071,10848,55882,4076,4371,48968,124145,2022-03-21 10:47:40.183696
39075,4,107,1,18,24,154,2022-03-21 10:47:42.056976
39077,8,103,0,19,46,176,2022-03-21 10:47:43.410573
39078,510,1755,135,241,1763,4404,2022-03-21 10:47:43.593609
39080,448,1711,71,164,796,3190,2022-03-21 10:47:44.054077
39082,2,39,1,35,30,107,2022-03-21 10:47:47.48331
39083,5,56,12,73,61,207,2022-03-21 10:47:48.666857
39086,2,292,1,28,52,375,2022-03-21 10:47:49.926779
39087,7,112,1,13,24,157,2022-03-21 10:47:50.975784
39088,5,139,3,15,42,204,2022-03-21 10:47:52.254497
39089,7,150,2,11,59,229,2022-03-21 10:47:53.401248
39090,5,18,3,34,35,95,2022-03-21 10:47:54.40418
39093,126,3538,42,67,1216,4989,2022-03-21 10:47:57.755295
39094,515,3842,268,172,4913,9710,2022-03-21 10:47:57.952793
39095,2,236,2,19,44,303,2022-03-21 10:47:59.353709
39096,2,179,1,20,24,226,2022-03-21 10:48:00.505784
39098,3,126,2,15,29,175,2022-03-21 10:48:02.843732
39099,6,76,2,18,27,129,2022-03-21 10:48:03.280754
39102,11,106,12,29,121,279,2022-03-21 10:48:05.886942
39103,1,10,2,29,23,65,2022-03-21 10:48:06.851759
39104,2,18,2,29,27,78,2022-03-21 10:48:07.814582
39105,11,140,8,34,169,362,2022-03-21 10:48:09.162945
39106,13,139,10,32,178,372,2022-03-21 10:48:09.346988
39107,17,174,10,30,196,427,2022-03-21 10:48:11.464702
39108,11,158,9,25,148,351,2022-03-21 10:48:11.646607
39109,6,58,7,41,100,212,2022-03-21 10:48:13.481042
39110,0,0,0,0,220,220,2022-03-21 10:48:14.675241
39112,520,20109,117,170,2879,23795,2022-03-21 10:48:14.85615
39114,32,3592,12,28,302,3966,2022-03-21 10:48:17.822681
39115,73,1181,39,60,683,2036,2022-03-21 10:48:19.738556
39116,31,239,12,30,180,492,2022-03-21 10:48:21.299643
39117,17,75,9,36,157,294,2022-03-21 10:48:22.600535
39119,7,33,6,44,76,166,2022-03-21 10:48:23.68446
39121,3,24,1,28,30,86,2022-03-21 10:48:24.673277
39122,4,30,1,28,29,92,2022-03-21 10:48:25.685929
39123,2,23,2,30,31,88,2022-03-21 10:48:26.722718
39124,2,24,1,29,31,87,2022-03-21 10:48:27.655857
39125,3,26,1,32,32,94,2022-03-21 10:48:28.624993
39128,2,21,1,29,31,84,2022-03-21 10:48:32.018449
39130,4,27,2,30,34,97,2022-03-21 10:48:33.688751
39132,3,35,2,34,32,106,2022-03-21 10:48:34.054299
39141,70,128,22,59,251,530,2022-03-21 10:48:36.547073
39148,1,19,2,28,34,84,2022-03-21 10:48:38.550861
39150,22,1174,10,23,127,1356,2022-03-21 10:48:40.956795
39151,2,35,1,19,30,87,2022-03-21 10:48:42.555074
39154,4,38,4,21,57,124,2022-03-21 10:48:44.959978
39158,2,15,4,32,37,90,2022-03-21 10:48:50.539805
39159,3,25,5,29,34,96,2022-03-21 10:48:51.604388
39161,2,23,3,29,30,87,2022-03-21 10:48:53.781152
39162,15,97,12,27,114,265,2022-03-21 10:48:54.87418
39163,11,1346,3,16,73,1449,2022-03-21 10:48:55.045321
39164,57,3944,7,31,204,4243,2022-03-21 10:48:59.118237
39165,17,1676,3,19,105,1820,2022-03-21 10:48:59.403471
39166,453,5674,183,54,9794,16158,2022-03-21 10:49:01.274722
39171,6,136,0,9,26,177,2022-03-21 10:49:08.802013
39172,4,202,1,13,35,255,2022-03-21 10:49:10.098497
39173,3,227,2,13,37,282,2022-03-21 10:49:11.31456
39174,10,396,3,11,49,469,2022-03-21 10:49:11.515785
39175,3007,98609,840,527,43066,146049,2022-03-21 10:49:11.998138
39178,142,1606,30,79,578,2435,2022-03-21 10:49:12.174943
39180,10,158,1,13,52,234,2022-03-21 10:49:14.234284
39181,5,132,0,11,29,177,2022-03-21 10:49:14.442036
39187,2,215,1,11,34,263,2022-03-21 10:49:16.304336
39188,1746,8390,449,587,6852,18024,2022-03-21 10:49:19.254032
39189,2,12,2,21,31,68,2022-03-21 10:49:20.446604
39191,456,783,85,177,607,2108,2022-03-21 10:49:21.812416
39194,1034,4000,427,1488,3400,10349,2022-03-21 10:49:25.759561
39195,35394,523375,14027,20168,111645,704609,2022-03-21 10:49:26.21072
39196,34534,223834,10314,10879,64002,343563,2022-03-21 10:49:26.659268
39197,7,138,3,29,65,242,2022-03-21 10:49:29.698394
39198,15852,145033,5824,7795,79781,254285,2022-03-21 10:49:30.656871
39200,3,125,1,10,26,165,2022-03-21 10:49:35.217664
39201,4,114,0,9,25,152,2022-03-21 10:49:36.561061
39202,4,107,1,10,25,147,2022-03-21 10:49:36.733956
39203,3,151,1,10,30,195,2022-03-21 10:49:38.431812
39205,30,0,16,38,55,139,2022-03-21 10:49:41.217058
39206,3,104,2,16,43,168,2022-03-21 10:49:42.510366
39207,7,143,1,15,49,215,2022-03-21 10:49:42.69054
39208,7,354,4,27,68,460,2022-03-21 10:49:42.951076
39211,10,522,5,14,112,663,2022-03-21 10:49:47.282527
39212,1,142,0,18,30,191,2022-03-21 10:49:48.507266
39214,3,171,2,20,24,220,2022-03-21 10:49:50.984812
39215,4,126,1,9,28,168,2022-03-21 10:49:51.177794
39217,43,2405,43,49,730,3270,2022-03-21 10:49:54.592823
39220,7,107,1,17,44,176,2022-03-21 10:49:56.068337
39221,5453,19450,2687,9489,25043,62122,2022-03-21 10:49:58.531393
39222,128,0,74,58,266,526,2022-03-21 10:49:58.974237
39223,322,417,47,73,1419,2278,2022-03-21 10:50:01.383262
39224,6,188,4,19,82,299,2022-03-21 10:50:01.566588
39225,3,34,4,43,31,115,2022-03-21 10:50:04.143275
39227,16,283,16,41,260,616,2022-03-21 10:50:06.079428
39229,2,13,3,27,23,68,2022-03-21 10:50:08.638031
39230,15,67,7,59,108,256,2022-03-21 10:50:09.702775
39231,126,442,42,97,661,1368,2022-03-21 10:50:11.391389
39235,837,29885,344,444,15094,46604,2022-03-21 10:50:14.217244
39239,769,28102,328,460,7739,37398,2022-03-21 10:50:16.894632
39242,2,155,1,9,36,203,2022-03-21 10:50:18.006846
39243,8,331,4,15,50,408,2022-03-21 10:50:19.36413
39245,3,116,2,13,25,159,2022-03-21 10:50:20.174058
39247,57793,209534,7048,3842,141571,419788,2022-03-21 10:50:20.687091
39249,124,631,63,78,2072,2968,2022-03-21 10:50:20.854575
39250,47,516,15,64,622,1264,2022-03-21 10:50:24.475006
39252,9,269,6,17,79,380,2022-03-21 10:50:25.119846
39255,3,18,4,32,28,85,2022-03-21 10:50:26.696234
39261,1,13,2,26,38,80,2022-03-21 10:50:30.712196
39263,1,13,3,27,28,72,2022-03-21 10:50:32.353617
39271,7,111,6,28,81,233,2022-03-21 10:50:33.428293
39275,8,152,3,9,34,206,2022-03-21 10:50:35.185506
39277,163,1109,94,171,871,2408,2022-03-21 10:50:35.407316
39281,11,395,2,13,45,466,2022-03-21 10:50:39.992158
39282,681,3587,237,500,1839,6844,2022-03-21 10:50:40.203238
39284,11,436,5,21,124,597,2022-03-21 10:50:40.478188
39290,32,1915,9,25,384,2365,2022-03-21 10:50:43.030797
39292,27302,106625,9125,15079,65287,223418,2022-03-21 10:50:46.132898
39293,3,134,3,10,22,172,2022-03-21 10:50:47.816456
39294,4,144,0,8,30,186,2022-03-21 10:50:48.000336
39296,3,146,1,9,21,180,2022-03-21 10:50:51.781968
39308,2,13,2,32,28,77,2022-03-21 10:50:58.656904
39309,2,34,5,34,63,138,2022-03-21 10:50:59.816794
39310,15,51,4,27,129,226,2022-03-21 10:51:01.545923
39314,15,481,7,13,112,628,2022-03-21 10:51:04.022018
39315,34,294,16,39,263,646,2022-03-21 10:51:05.99201
39316,50,523,37,63,608,1281,2022-03-21 10:51:06.229596
39320,3,202,5,10,34,254,2022-03-21 10:51:06.486917
39323,19,341,13,22,225,620,2022-03-21 10:51:11.445141
39324,16521,102492,6116,13622,38003,176754,2022-03-21 10:51:14.190161
39325,403,4560,121,146,2372,7602,2022-03-21 10:51:14.365391
39326,19001,158047,5852,12500,67038,262438,2022-03-21 10:51:14.887917
39328,13,97,5,29,137,281,2022-03-21 10:51:16.784783
39329,57,354,39,63,754,1267,2022-03-21 10:51:16.960469
39330,4,122,1,9,21,157,2022-03-21 10:51:17.233404
39331,4,193,1,15,32,245,2022-03-21 10:51:18.182544
39339,55,325,26,53,656,1115,2022-03-21 10:51:21.539962
39345,4,48,3,23,38,116,2022-03-21 10:51:26.209641
39349,5,135,3,11,34,188,2022-03-21 10:51:27.607762
39351,10,56,11,39,169,285,2022-03-21 10:51:28.835625
39352,9,78,8,45,173,313,2022-03-21 10:51:30.697003
39354,2,45,8,35,62,152,2022-03-21 10:51:32.523883
39355,8458,48887,2351,2259,28204,90159,2022-03-21 10:51:32.721877
39358,5,64,8,38,123,238,2022-03-21 10:51:34.69586
39359,5,39,8,33,103,188,2022-03-21 10:51:36.00764
39363,28,425,19,46,313,831,2022-03-21 10:51:40.003199
39364,26,32,16,13,268,355,2022-03-21 10:51:42.072881
39367,2,17,3,30,34,86,2022-03-21 10:51:43.708242
39368,6,72,10,35,169,292,2022-03-21 10:51:45.025111
39370,5,81,4,30,66,186,2022-03-21 10:51:48.045496
39371,6,46,7,32,52,143,2022-03-21 10:51:49.642223
39373,2,17,4,28,35,86,2022-03-21 10:51:51.113257
39374,4,37,8,37,75,161,2022-03-21 10:51:51.303432
39375,3,20,6,24,34,87,2022-03-21 10:51:53.31885
39376,5,32,5,28,46,116,2022-03-21 10:51:54.469772
39377,2,26,4,43,30,105,2022-03-21 10:51:55.54053
39380,429,5830,142,131,1925,8457,2022-03-21 10:51:56.407745
39381,1,15,6,39,30,91,2022-03-21 10:51:59.621681
39382,106,2791,53,73,2106,5129,2022-03-21 10:52:01.953477
39384,3,17,2,31,29,82,2022-03-21 10:52:03.010527
39388,7374,28947,3629,8310,26452,74712,2022-03-21 10:52:04.636421
39393,3,185,3,12,28,231,2022-03-21 10:52:05.972856
39394,3,203,3,10,28,247,2022-03-21 10:52:07.24648
39395,3,201,5,11,24,244,2022-03-21 10:52:08.667105
39396,4,211,3,7,30,255,2022-03-21 10:52:09.759119
39397,527,8670,169,180,3574,13120,2022-03-21 10:52:12.265973
39401,11,83,12,27,140,273,2022-03-21 10:52:13.775389
39403,2,10,3,31,23,69,2022-03-21 10:52:15.269888
39409,2,13,2,34,32,83,2022-03-21 10:52:22.29442
39410,39,51,18,47,131,286,2022-03-21 10:52:23.55115
39412,6,32,7,34,64,143,2022-03-21 10:52:23.741028
39413,9,102,5,44,95,255,2022-03-21 10:52:24.366388
39414,58,118,40,47,645,908,2022-03-21 10:52:27.298425
39415,75,588,25,65,440,1193,2022-03-21 10:52:28.783017
39416,94,836,51,57,860,1898,2022-03-21 10:52:30.404377
39419,188,548,56,119,907,1818,2022-03-21 10:52:32.86019
39421,1137,2276,365,656,4335,8769,2022-03-21 10:52:35.122057
39426,2,18,3,30,29,82,2022-03-21 10:52:36.768987
39427,1,10,3,31,32,77,2022-03-21 10:52:37.771607
39428,3,10,2,39,30,84,2022-03-21 10:52:38.803524
39429,96,761,75,64,1342,2338,2022-03-21 10:52:38.976167
39431,7,238,10,38,70,363,2022-03-21 10:52:43.201302
39435,3,28,4,37,67,139,2022-03-21 10:52:44.406134
39436,3,21,5,32,55,116,2022-03-21 10:52:45.398686
39449,121,138,4,14,91,368,2022-03-21 10:52:48.965461
39450,7,63,5,49,58,182,2022-03-21 10:52:49.975741
39452,26,2211,4,19,80,2340,2022-03-21 10:52:52.879338
39453,2,11,4,36,31,84,2022-03-21 10:52:53.918383
39455,3,40,3,38,30,114,2022-03-21 10:52:56.149775
39456,10908,76897,3526,9979,34248,135558,2022-03-21 10:52:56.603244
39461,0,0,0,0,0,0,2022-03-21 10:52:58.808224
39463,39628,208149,11837,26545,106984,393143,2022-03-21 10:52:59.289614
39464,14,196,8,27,174,419,2022-03-21 10:52:59.465061
39465,21,302,12,29,309,673,2022-03-21 10:53:02.463415
39468,13317,137930,4102,5403,52397,213149,2022-03-21 10:53:02.648966
39473,0,0,1,0,2225,2226,2022-03-21 10:53:10.250933
39474,0,0,0,0,183,183,2022-03-21 10:53:13.009435
39476,7,294,0,9,36,346,2022-03-21 10:53:15.565438
39477,1158,11561,595,491,12766,26571,2022-03-21 10:53:16.239696
39478,844,4209,505,573,10962,17093,2022-03-21 10:53:16.408599
39480,691,7445,320,180,5869,14505,2022-03-21 10:53:20.42367
39482,140,928,51,77,1352,2548,2022-03-21 10:53:20.894446
39486,4647,46010,1052,808,41204,93721,2022-03-21 10:53:21.15454
39488,2,9,2,27,24,64,2022-03-21 10:53:22.531618
39489,0,0,0,0,6694,6694,2022-03-21 10:53:25.161095
39490,56,1100,9,28,332,1525,2022-03-21 10:53:25.347879
39498,9,212,3,44,51,319,2022-03-21 10:53:28.676918
39499,1,124,1,13,19,158,2022-03-21 10:53:30.093255
39500,2,149,0,9,26,186,2022-03-21 10:53:31.265258
39501,2,14,3,26,28,73,2022-03-21 10:53:32.335409
39505,1,13,1,30,24,69,2022-03-21 10:53:34.611883
39506,2673,6249,883,1863,10153,21821,2022-03-21 10:53:34.819977
39511,39,2479,20,25,273,2836,2022-03-21 10:53:37.619177
39517,4,129,0,9,22,164,2022-03-21 10:53:38.189166
39518,0,0,0,0,5244,5244,2022-03-21 10:53:39.747766
39519,898,13439,267,1099,4918,20621,2022-03-21 10:53:44.351633
39523,16705,136068,4805,15661,39605,212844,2022-03-21 10:53:44.787943
39527,1192,4668,496,3436,7873,17665,2022-03-21 10:53:44.95978
39528,5,28,3,57,50,143,2022-03-21 10:53:46.416606
39529,23,290,13,54,469,849,2022-03-21 10:53:48.31252
39531,2190,14529,1024,2436,17977,38156,2022-03-21 10:53:50.743308
39533,23371,305343,7925,9277,99849,445765,2022-03-21 10:53:50.921432
39534,44743,258297,19122,19442,120401,462005,2022-03-21 10:53:53.840748
39535,93995,607329,9228,11087,153754,875393,2022-03-21 10:53:54.023867
39536,4,114,2,14,46,180,2022-03-21 10:53:55.292571
39538,453,1038,192,72,2891,4646,2022-03-21 10:53:58.160796
39539,17688,70767,8517,17694,55736,170402,2022-03-21 10:53:58.327495
39540,3,56,2,17,47,125,2022-03-21 10:54:03.263448
39544,5,106,0,7,24,142,2022-03-21 10:54:05.865405
39545,1029,16914,391,274,16571,35179,2022-03-21 10:54:09.205099
39546,20,0,6,30,47,103,2022-03-21 10:54:10.6354
39547,47419,361845,12665,7473,150703,580105,2022-03-21 10:54:11.088137
39551,70205,469951,6479,4368,143293,694296,2022-03-21 10:54:12.624493
39555,3645,103604,945,841,20755,129790,2022-03-21 10:54:13.153986
39559,76,14,29,50,414,583,2022-03-21 10:54:15.194738
39560,4,161,2,8,32,207,2022-03-21 10:54:18.851175
39562,8,116,4,26,59,213,2022-03-21 10:54:20.782959
39564,10,178,2,32,55,277,2022-03-21 10:54:20.96207
43653,1,14,1,5,8,29,2022-03-21 11:31:27.860598
39565,6299,350738,1756,902,87050,446745,2022-03-21 10:54:22.606704
39567,4409,15190,1857,6616,14821,42893,2022-03-21 10:54:24.576584
39568,5,336,2,17,45,405,2022-03-21 10:54:26.527174
39569,2975,37098,1091,383,45817,87364,2022-03-21 10:54:26.708946
39570,5132,79944,2042,1484,24723,113325,2022-03-21 10:54:31.932566
39572,121,239,51,72,836,1319,2022-03-21 10:54:33.56816
39574,1036,10980,396,698,6546,19656,2022-03-21 10:54:34.151578
43655,0,7,1,7,11,26,2022-03-21 11:31:29.815634
39575,27354,112154,12214,13394,80949,246065,2022-03-21 10:54:35.193972
39576,4097,123430,1458,614,76211,205810,2022-03-21 10:54:36.129654
39581,109,474,40,215,339,1177,2022-03-21 10:54:38.065343
39583,4527,18629,1842,3912,21766,50676,2022-03-21 10:54:41.674684
39584,508,3763,173,300,12266,17010,2022-03-21 10:54:41.869969
39585,149,1790,90,95,6527,8651,2022-03-21 10:54:42.134721
39586,24195,82132,8394,5555,104320,224596,2022-03-21 10:54:42.688706
39589,213,193,89,89,1409,1993,2022-03-21 10:54:45.063492
39590,1996,7536,1104,4109,8546,23291,2022-03-21 10:54:45.270237
39592,886,9185,360,293,5342,16066,2022-03-21 10:54:51.579648
39605,588,6348,291,202,7648,15077,2022-03-21 10:54:57.060832
39606,425,12100,155,97,3753,16530,2022-03-21 10:55:01.578186
39607,1513,84047,365,442,11662,98029,2022-03-21 10:55:05.424907
39609,2856,10168,1020,2039,16558,32641,2022-03-21 10:55:06.474816
39611,29,39,22,50,128,268,2022-03-21 10:55:09.71083
39617,114482,335103,22458,103438,200621,776102,2022-03-21 10:55:12.274637
39618,8,124,4,27,60,223,2022-03-21 10:55:13.853519
39619,249,4505,129,134,4646,9663,2022-03-21 10:55:14.040343
39620,175,1243,79,719,511,2727,2022-03-21 10:55:20.660118
39621,28,225,8,72,228,561,2022-03-21 10:55:22.688193
39622,518,2495,229,908,1598,5748,2022-03-21 10:55:25.10659
39623,9,741,4,19,59,832,2022-03-21 10:55:25.29304
39626,1,5,2,35,25,68,2022-03-21 10:55:29.328004
39629,71,104,14,49,297,535,2022-03-21 10:55:33.570891
39634,8,28,2,17,49,104,2022-03-21 10:55:35.689407
39635,15,31,6,95,80,227,2022-03-21 10:55:36.817493
39638,4176,9,862,172,5612,10831,2022-03-21 10:55:36.99459
39643,311,1029,138,164,1112,2754,2022-03-21 10:55:37.169633
39644,6,116,3,12,54,191,2022-03-21 10:55:40.40503
39651,990,59229,428,155,14368,75170,2022-03-21 10:55:42.379626
39652,1439,35338,503,645,13851,51776,2022-03-21 10:55:45.615077
39653,402,1,178,130,910,1621,2022-03-21 10:55:45.811598
39654,117,1289,46,119,787,2358,2022-03-21 10:55:47.995108
39659,92,1,68,53,311,525,2022-03-21 10:55:49.986405
39663,25,57,10,54,311,457,2022-03-21 10:55:51.331208
39668,164,163,65,174,1549,2115,2022-03-21 10:55:54.452404
39674,207,3206,81,89,1328,4911,2022-03-21 10:55:57.095026
39675,537,932,112,215,1944,3740,2022-03-21 10:55:59.625676
39676,176,473,68,135,867,1719,2022-03-21 10:55:59.810028
39677,18,40,4,44,199,305,2022-03-21 10:56:03.220121
39678,106,233,34,89,782,1244,2022-03-21 10:56:05.000378
39679,54,50,32,56,175,367,2022-03-21 10:56:06.392484
39681,3084,11122,893,1110,10326,26535,2022-03-21 10:56:06.579237
39685,3,21,1,20,35,80,2022-03-21 10:56:11.774653
39690,10,169,4,14,70,267,2022-03-21 10:56:13.743208
39691,2,19,3,19,32,75,2022-03-21 10:56:16.052867
39694,15,185,2,17,57,276,2022-03-21 10:56:17.347494
39697,9,184,6,34,103,336,2022-03-21 10:56:19.212715
39700,8,207,5,12,52,284,2022-03-21 10:56:26.035139
39701,49938,410559,14681,46459,83480,605117,2022-03-21 10:56:26.490278
39703,4,265,4,10,59,342,2022-03-21 10:56:28.820778
39705,6747,63683,2356,881,30437,104104,2022-03-21 10:56:30.213421
39706,3,159,3,12,32,209,2022-03-21 10:56:33.895107
39707,12,196,5,26,113,352,2022-03-21 10:56:34.947741
39708,132,602,54,109,1395,2292,2022-03-21 10:56:37.884287
39709,138,732,91,62,1725,2748,2022-03-21 10:56:38.073569
39710,24477,135581,8072,14402,82861,265393,2022-03-21 10:56:38.594101
39711,11,68,2,39,70,190,2022-03-21 10:56:40.722418
39714,2,190,2,12,28,234,2022-03-21 10:56:42.474928
39720,60,112,15,41,191,419,2022-03-21 10:56:46.295829
39721,117,2398,101,120,1599,4335,2022-03-21 10:56:49.383703
39722,15,223,12,17,1055,1322,2022-03-21 10:56:51.122543
39725,1684,3768,585,1405,6527,13969,2022-03-21 10:56:52.15
39727,0,47,1,2,7,57,2022-03-21 10:56:53.539447
39730,5301,23187,2083,2822,18358,51751,2022-03-21 10:56:54.528953
39734,95,784,31,38,455,1403,2022-03-21 10:56:57.199568
39735,29,743,11,46,468,1297,2022-03-21 10:56:59.299693
39736,325,218,124,156,1759,2582,2022-03-21 10:56:59.478157
39741,5985,234365,2077,647,74652,317726,2022-03-21 10:57:02.755097
39753,1947,18896,685,275,35440,57243,2022-03-21 10:57:03.76082
39754,60,40,17,39,155,311,2022-03-21 10:57:05.240616
39758,4,10,2,26,23,65,2022-03-21 10:57:06.221905
39759,3,15,3,32,34,87,2022-03-21 10:57:08.207165
39760,36,391,14,27,291,759,2022-03-21 10:57:10.142596
39761,825,15215,236,199,13447,29922,2022-03-21 10:57:10.325267
39762,11,97,7,48,100,263,2022-03-21 10:57:12.08285
39763,0,0,0,0,1653,1653,2022-03-21 10:57:14.699851
39764,303,5772,142,87,7313,13617,2022-03-21 10:57:14.879374
43875,0,0,0,0,0,0,2022-03-21 11:33:02.670544
39766,15,147,3,8,85,258,2022-03-21 10:57:15.427231
39767,55,246,19,52,273,645,2022-03-21 10:57:16.976041
39769,13,1429,4,24,118,1588,2022-03-21 10:57:18.533046
39778,5,35,4,22,47,113,2022-03-21 10:57:19.991382
39780,15,569,5,18,126,733,2022-03-21 10:57:21.649519
39781,11,120,1,16,48,196,2022-03-21 10:57:21.825496
39783,50188,359762,8136,6155,111499,535740,2022-03-21 10:57:23.254328
39786,7,198,5,11,46,267,2022-03-21 10:57:23.516097
39799,8468,34403,2760,10077,26192,81900,2022-03-21 10:57:27.815692
39806,9050,21946,4409,6266,25213,66884,2022-03-21 10:57:29.920161
39808,9073,39451,2143,966,46079,97712,2022-03-21 10:57:31.32114
39810,56,375,25,56,489,1001,2022-03-21 10:57:31.499654
39811,2855,18979,1186,2421,16708,42149,2022-03-21 10:57:31.767245
39812,7,159,2,10,33,211,2022-03-21 10:57:34.800429
39815,13,705,6,11,99,834,2022-03-21 10:57:35.054627
39818,0,0,0,0,0,0,2022-03-21 10:57:36.775336
44182,0,0,0,0,0,0,2022-03-21 11:35:58.688838
44184,0,0,0,0,0,0,2022-03-21 11:35:59.834661
39819,2580,36668,850,335,16605,57038,2022-03-21 10:57:39.790038
39820,19,63,10,105,67,264,2022-03-21 10:57:41.506061
39823,170,180,26,77,541,994,2022-03-21 10:57:43.042349
39827,7,57,2,28,47,141,2022-03-21 10:57:47.8305
39831,20,509,5,18,143,695,2022-03-21 10:57:49.414957
39836,876,9715,312,500,5632,17035,2022-03-21 10:57:51.474089
39839,23,34,11,67,101,236,2022-03-21 10:57:52.655666
39840,46,397,12,37,322,814,2022-03-21 10:57:54.075321
39841,7,161,2,16,62,248,2022-03-21 10:57:55.689988
39846,221,2936,106,96,3635,6994,2022-03-21 10:57:56.152503
39849,141,908,63,189,332,1633,2022-03-21 10:57:58.259991
39851,66,47,23,40,747,923,2022-03-21 10:57:59.830779
39854,9,123,1,14,38,185,2022-03-21 10:58:00.027404
39856,7,307,0,15,50,379,2022-03-21 10:58:01.270682
39861,3,106,0,12,22,143,2022-03-21 10:58:04.536066
39862,7,95,0,27,78,207,2022-03-21 10:58:05.705012
39864,753,844,330,173,2201,4301,2022-03-21 10:58:07.907698
39869,3,87,1,11,17,119,2022-03-21 10:58:08.999469
39872,17,586,3,20,116,742,2022-03-21 10:58:10.415536
39874,5,162,3,18,35,223,2022-03-21 10:58:10.670908
39875,53,1751,20,44,481,2349,2022-03-21 10:58:10.931931
39877,5,132,1,15,35,188,2022-03-21 10:58:14.219391
39884,135,1756,41,66,1242,3240,2022-03-21 10:58:16.20854
39885,21,275,11,34,223,564,2022-03-21 10:58:17.636235
39886,4,127,0,17,30,178,2022-03-21 10:58:17.809179
39888,3,141,2,16,38,200,2022-03-21 10:58:19.050972
39892,3,112,1,14,18,148,2022-03-21 10:58:22.771245
39893,704,1482,152,1133,1647,5118,2022-03-21 10:58:25.450313
39894,0,0,0,0,17668,17668,2022-03-21 10:58:25.875406
39895,3,61,2,19,24,109,2022-03-21 10:58:26.053055
39900,1,125,0,11,24,161,2022-03-21 10:58:26.479013
39906,17,50,8,44,101,220,2022-03-21 10:58:28.789957
44188,0,0,0,0,0,0,2022-03-21 11:36:01.134345
39917,1123,1,86,1290,1881,4381,2022-03-21 10:58:32.6408
39925,3,94,0,10,18,125,2022-03-21 10:58:34.034317
39938,0,1,0,0,6135,6136,2022-03-21 10:58:36.819017
39939,3,133,1,9,24,170,2022-03-21 10:58:37.95613
39940,27216,388941,7244,6064,78385,507850,2022-03-21 10:58:38.129249
39942,1968,6491,879,2237,8695,20270,2022-03-21 10:58:41.018872
39944,100,1809,45,51,994,2999,2022-03-21 10:58:41.28038
39947,5,120,2,11,28,166,2022-03-21 10:58:41.538892
39960,1033,9491,295,551,4677,16047,2022-03-21 10:58:42.523104
39979,282,400,248,455,2006,3391,2022-03-21 10:58:48.069346
39987,181,1736,101,98,2881,4997,2022-03-21 10:58:49.859182
39988,12931,146401,4358,3487,33000,200177,2022-03-21 10:58:50.913841
39990,3863,5272,1392,3951,14991,29469,2022-03-21 10:58:52.016727
39993,130,3106,100,102,1641,5079,2022-03-21 10:58:55.074081
39994,9,96,5,14,37,161,2022-03-21 10:58:55.541085
39995,566,5092,180,98,5326,11262,2022-03-21 10:58:55.708747
39996,5,232,1,16,33,287,2022-03-21 10:58:59.446634
39999,148,2155,93,155,1826,4377,2022-03-21 10:59:02.997487
40000,6,119,1,8,24,158,2022-03-21 10:59:03.2344
40002,13,235,4,27,84,363,2022-03-21 10:59:04.122299
40004,14163,177852,4232,4268,46404,246919,2022-03-21 10:59:04.555446
40031,875,7152,353,486,5096,13962,2022-03-21 10:59:06.901599
40033,9,215,6,26,63,319,2022-03-21 10:59:10.284722
40034,655,636,313,263,1999,3866,2022-03-21 10:59:10.473691
40035,31,389,15,42,492,969,2022-03-21 10:59:10.745708
40036,24,39,13,37,405,518,2022-03-21 10:59:13.629309
40037,23,41,13,38,347,462,2022-03-21 10:59:14.745841
40044,52,1549,30,64,1174,2869,2022-03-21 10:59:18.739604
40046,24004,145565,9727,11674,102917,293887,2022-03-21 10:59:22.796784
40052,60271,259263,25697,14867,146539,506637,2022-03-21 10:59:23.250558
40058,3,131,1,17,20,172,2022-03-21 10:59:34.530136
40059,9110,67579,2252,918,40567,120426,2022-03-21 10:59:34.9708
40062,158,1395,31,64,326,1974,2022-03-21 10:59:36.522308
40063,0,0,0,0,0,0,2022-03-21 10:59:40.113536
40064,1158,36222,368,465,8039,46252,2022-03-21 10:59:44.027592
40074,5454,14114,1629,17160,22999,61356,2022-03-21 10:59:48.442814
40075,5471,15961,1989,4498,20976,48895,2022-03-21 10:59:49.260249
44233,0,0,0,0,307,307,2022-03-21 11:36:20.434607
40076,579,6072,231,157,6529,13568,2022-03-21 10:59:52.240141
40078,6,99,3,21,101,230,2022-03-21 10:59:54.187722
40080,1572,26386,391,283,11513,40145,2022-03-21 10:59:54.60413
40082,477,15199,163,126,8652,24617,2022-03-21 10:59:55.298055
40083,1826,36979,612,383,13662,53462,2022-03-21 10:59:57.842732
40085,858,2819,388,1774,4399,10238,2022-03-21 11:00:01.106451
40087,3,26,3,27,44,103,2022-03-21 11:00:02.459346
40089,188,18,7,130,105,448,2022-03-21 11:00:05.099284
40090,34,77,16,47,162,336,2022-03-21 11:00:06.538338
40091,8,67,3,36,72,186,2022-03-21 11:00:07.745474
40097,494,802,178,135,1997,3606,2022-03-21 11:00:09.151844
40100,876,3886,283,306,4011,9362,2022-03-21 11:00:09.41123
40102,885,22182,272,354,13102,36795,2022-03-21 11:00:13.831699
40104,51,436,20,49,667,1223,2022-03-21 11:00:15.316039
40105,8,194,3,12,50,267,2022-03-21 11:00:17.299275
40106,8,172,2,15,36,233,2022-03-21 11:00:19.328773
40109,150,741,74,76,2160,3201,2022-03-21 11:00:19.500671
40111,407,6607,119,134,3898,11165,2022-03-21 11:00:24.139688
40121,78,69,19,88,598,852,2022-03-21 11:00:27.784426
40124,52,197,30,46,876,1201,2022-03-21 11:00:31.521071
40128,9750,53857,4055,7487,34072,109221,2022-03-21 11:00:31.700344
40129,659,363,232,678,1958,3890,2022-03-21 11:00:31.963171
40134,405,4389,157,103,3737,8791,2022-03-21 11:00:32.194228
40136,1902,6539,852,3023,5875,18191,2022-03-21 11:00:35.052238
40137,459,1618,198,1002,2875,6152,2022-03-21 11:00:38.77642
40139,8,214,5,15,96,338,2022-03-21 11:00:43.435511
40141,21,23,7,69,73,193,2022-03-21 11:00:44.066947
40142,7,59,6,62,83,217,2022-03-21 11:00:45.746222
40145,3798,1,978,2219,7569,14565,2022-03-21 11:00:48.502707
40147,23,740,11,32,244,1050,2022-03-21 11:00:48.703396
40148,3031,15371,1387,3457,16130,39376,2022-03-21 11:00:50.675244
40152,148,1262,84,93,1231,2818,2022-03-21 11:00:53.465739
40154,517,5698,266,364,3576,10421,2022-03-21 11:00:56.247483
40155,42,18,28,38,72,198,2022-03-21 11:00:59.654303
40156,198,2516,70,104,2501,5389,2022-03-21 11:01:02.194055
40157,264,1811,80,136,1739,4030,2022-03-21 11:01:04.09296
40158,10,196,3,19,52,280,2022-03-21 11:01:04.269622
40159,7,157,1,18,44,227,2022-03-21 11:01:04.529132
40171,13,198,1,18,78,308,2022-03-21 11:01:11.085694
40172,10,644,5,13,74,746,2022-03-21 11:01:12.601644
40174,19108,70226,4654,3632,73356,170976,2022-03-21 11:01:13.052746
40176,475,15513,156,120,5414,21678,2022-03-21 11:01:15.73475
40178,1570,9967,674,2400,5657,20268,2022-03-21 11:01:15.912243
40179,48,739,30,66,419,1302,2022-03-21 11:01:18.27986
40180,64,1149,9,42,490,1754,2022-03-21 11:01:20.699182
40181,94,2043,67,109,1125,3438,2022-03-21 11:01:20.87969
40182,3,56,4,47,62,172,2022-03-21 11:01:22.106508
40188,10,26,7,20,31,94,2022-03-21 11:01:23.170093
40194,86,779,17,18,464,1364,2022-03-21 11:01:28.338651
40196,3478,11850,1293,4335,13188,34144,2022-03-21 11:01:28.53987
40197,393,2885,151,742,893,5064,2022-03-21 11:01:30.802154
40200,13,876,8,18,149,1064,2022-03-21 11:01:32.644901
40202,6,197,2,18,44,267,2022-03-21 11:01:33.778555
40205,9,122,2,14,86,233,2022-03-21 11:01:35.709252
40206,1220,43891,514,208,11129,56962,2022-03-21 11:01:38.41977
40208,270,708,87,148,1581,2794,2022-03-21 11:01:38.589295
40211,716,5563,193,160,8020,14652,2022-03-21 11:01:43.082629
40221,70705,509653,15354,21903,126182,743797,2022-03-21 11:01:46.906558
40222,13,533,6,19,118,689,2022-03-21 11:01:47.103128
40228,662,7914,292,436,3119,12423,2022-03-21 11:01:52.078391
40230,4663,23228,2186,4007,22246,56330,2022-03-21 11:01:54.78696
40233,589,1561,158,233,2503,5044,2022-03-21 11:01:57.107897
40237,9,178,1,19,63,270,2022-03-21 11:01:58.383238
40239,745,22163,208,421,4662,28199,2022-03-21 11:02:00.208261
40244,4,79,7,22,87,199,2022-03-21 11:02:02.967276
40245,73,1828,27,37,1143,3108,2022-03-21 11:02:05.590568
40246,150,2134,62,58,1820,4224,2022-03-21 11:02:08.099816
40249,242,71,19,117,515,964,2022-03-21 11:02:08.513941
40250,16,185,19,39,291,550,2022-03-21 11:02:08.710575
40251,35,397,30,35,522,1019,2022-03-21 11:02:10.061372
40254,1928,14078,572,1390,11886,29854,2022-03-21 11:02:14.375685
40255,4,146,4,9,25,188,2022-03-21 11:02:15.763931
40256,2174,20733,1193,2556,8074,34730,2022-03-21 11:02:15.937178
40266,581,1673,204,391,1909,4758,2022-03-21 11:02:21.119203
40267,1405,1594,431,1015,13893,18338,2022-03-21 11:02:23.781861
40269,2076,60444,521,473,9323,72837,2022-03-21 11:02:26.261038
40280,362,4162,203,105,4419,9251,2022-03-21 11:02:31.788801
40282,9,903,6,36,92,1046,2022-03-21 11:02:33.360331
40283,5,166,5,12,37,225,2022-03-21 11:02:34.526714
40286,9,345,7,14,43,418,2022-03-21 11:02:35.827262
40288,5,123,3,9,17,157,2022-03-21 11:02:36.931876
40292,14,794,8,33,139,988,2022-03-21 11:02:39.102808
40294,16,677,11,32,126,862,2022-03-21 11:02:41.963437
40297,5,116,3,8,24,156,2022-03-21 11:02:45.929423
40298,463,8074,187,271,5688,14683,2022-03-21 11:02:48.128666
40299,9,49,6,24,56,144,2022-03-21 11:02:48.314684
40301,8,102,7,25,122,264,2022-03-21 11:02:50.36697
40302,11,113,6,20,85,235,2022-03-21 11:02:51.560192
40312,7,731,6,15,39,798,2022-03-21 11:02:54.437259
40314,444,9373,171,144,11279,21411,2022-03-21 11:02:57.859138
40315,288,3959,196,254,6566,11263,2022-03-21 11:03:00.626783
40316,19,7,8,50,75,159,2022-03-21 11:03:01.579659
40320,649,1800,172,916,4183,7720,2022-03-21 11:03:04.243069
40321,102,599,104,81,3081,3967,2022-03-21 11:03:04.422338
40323,642,5419,220,162,6240,12683,2022-03-21 11:03:04.666336
40327,1039,832,434,564,3289,6158,2022-03-21 11:03:08.824466
40331,147,2844,70,75,3716,6852,2022-03-21 11:03:11.475369
40333,2,1,2,0,64258,64263,2022-03-21 11:03:14.280931
40334,177,2842,171,152,2603,5945,2022-03-21 11:03:16.765071
40335,260,622,110,97,5479,6568,2022-03-21 11:03:19.987969
40338,11,577,3,15,92,698,2022-03-21 11:03:21.428684
40340,52,528,20,45,535,1180,2022-03-21 11:03:23.062679
40341,7,137,6,15,96,261,2022-03-21 11:03:24.294218
40342,5,77,10,51,99,242,2022-03-21 11:03:25.409869
40344,11,1359,2,17,73,1462,2022-03-21 11:03:25.577416
40348,33,644,18,39,264,998,2022-03-21 11:03:30.066049
40349,2,153,5,11,37,208,2022-03-21 11:03:31.548931
40350,5,149,3,14,65,236,2022-03-21 11:03:33.257533
40351,33007,3,8370,6299,13085,60764,2022-03-21 11:03:33.430899
40353,3,158,3,10,31,205,2022-03-21 11:03:34.736385
40357,6,1,10,4,204251,204272,2022-03-21 11:03:35.215586
40364,3,91,2,11,18,125,2022-03-21 11:03:36.997527
40369,394,5188,120,162,3198,9062,2022-03-21 11:03:44.020599
40372,655,13849,435,416,9214,24569,2022-03-21 11:03:46.961524
40373,2,113,3,8,19,145,2022-03-21 11:03:48.053328
40377,12,149,12,33,257,463,2022-03-21 11:03:50.889115
40383,4,107,1,15,32,159,2022-03-21 11:03:55.705828
40385,6,140,1,37,60,244,2022-03-21 11:03:56.987375
40389,129,266,61,29,3492,3977,2022-03-21 11:03:58.37294
40392,8324,52708,3339,4282,38788,107441,2022-03-21 11:03:58.572895
40393,26,0,20,42,97,185,2022-03-21 11:03:58.846299
40407,2,32,4,21,45,104,2022-03-21 11:04:01.211082
40408,2,31,4,24,44,105,2022-03-21 11:04:02.458483
40412,7,271,0,43,65,386,2022-03-21 11:04:05.369052
40414,9,254,4,9,34,310,2022-03-21 11:04:06.4536
40415,4,103,3,7,49,166,2022-03-21 11:04:07.458446
40416,2102,38969,788,266,40233,82358,2022-03-21 11:04:07.626082
40417,43605,214574,12331,5527,102835,378872,2022-03-21 11:04:08.913926
40429,284,8851,145,92,7355,16727,2022-03-21 11:04:15.978302
40430,8,163,1,27,39,238,2022-03-21 11:04:17.778147
40434,6188,14200,765,437,30299,51889,2022-03-21 11:04:20.198816
40435,2789,6889,574,388,7181,17821,2022-03-21 11:04:22.097334
40436,18103,74737,4089,18701,39467,155097,2022-03-21 11:04:22.285319
40437,36,50,14,44,132,276,2022-03-21 11:04:23.679735
40438,623,1280,241,475,2506,5125,2022-03-21 11:04:27.017327
40441,5,164,3,16,23,211,2022-03-21 11:04:31.097355
40442,12,395,3,14,65,489,2022-03-21 11:04:32.566121
40452,4,118,3,11,38,174,2022-03-21 11:04:33.750334
40454,46397,279468,12120,10223,107889,456097,2022-03-21 11:04:39.152809
40455,4,28,4,21,41,98,2022-03-21 11:04:41.094463
40456,19303,843839,3173,1189,198933,1066437,2022-03-21 11:04:41.557101
40459,82,119,36,66,928,1231,2022-03-21 11:04:43.395897
40460,370,6672,150,106,7158,14456,2022-03-21 11:04:45.750278
40463,2,91,1,13,20,127,2022-03-21 11:04:47.434857
40464,124,627,40,67,1356,2214,2022-03-21 11:04:47.621919
40465,122,3201,72,84,2180,5659,2022-03-21 11:04:49.6259
40469,21,532,26,24,208,811,2022-03-21 11:04:55.024702
40473,236,562,89,538,2881,4306,2022-03-21 11:04:57.1992
40474,5,172,2,13,40,232,2022-03-21 11:04:58.311409
40476,10,262,2,13,96,383,2022-03-21 11:05:00.346719
40477,238,3404,87,129,3098,6956,2022-03-21 11:05:02.452648
40478,8,79,8,32,76,203,2022-03-21 11:05:04.597682
40479,6,67,3,29,47,152,2022-03-21 11:05:05.647485
40480,50,1676,19,48,481,2274,2022-03-21 11:05:07.806498
40482,11,57,4,32,81,185,2022-03-21 11:05:08.863126
40483,13908,102751,4138,8010,38366,167173,2022-03-21 11:05:11.620534
40484,20,61,12,35,136,264,2022-03-21 11:05:12.933026
40485,12970,16746,3134,1799,33062,67711,2022-03-21 11:05:13.113566
40488,8937,2,481,3246,10665,23331,2022-03-21 11:05:17.959486
40491,614,12626,145,126,5688,19199,2022-03-21 11:05:21.257955
40495,5,55,5,41,42,148,2022-03-21 11:05:22.924266
40496,47037,423097,7944,14541,81098,573717,2022-03-21 11:05:23.363839
40497,31392,156647,6940,8405,81526,284910,2022-03-21 11:05:23.812538
40499,8,133,0,9,31,181,2022-03-21 11:05:25.445557
40502,4,160,2,9,31,206,2022-03-21 11:05:26.545608
40504,2519,9180,559,476,5255,17989,2022-03-21 11:05:26.721879
40506,2625,1856,836,2968,4265,12550,2022-03-21 11:05:29.496081
40507,87565,47,2172,3325,130861,223970,2022-03-21 11:05:32.179678
40508,7,152,2,17,43,221,2022-03-21 11:05:35.390164
40509,2,123,2,11,30,168,2022-03-21 11:05:36.567902
40515,4892,81558,2306,5786,32902,127444,2022-03-21 11:05:38.65055
40517,61,925,25,45,665,1721,2022-03-21 11:05:40.846058
40526,6210,15575,1608,7942,14398,45733,2022-03-21 11:05:45.017781
40529,5436,31609,1988,2383,27531,68947,2022-03-21 11:05:46.205557
40530,29777,152833,6423,11975,71827,272835,2022-03-21 11:05:50.607026
40531,3,148,1,18,30,200,2022-03-21 11:05:52.202209
40539,4,58,3,18,26,109,2022-03-21 11:05:54.03624
40540,30598,348020,5484,7613,85683,477398,2022-03-21 11:05:54.314344
40542,5191,144041,1565,930,24724,176451,2022-03-21 11:05:54.485402
40543,31,101,18,36,359,545,2022-03-21 11:05:57.009951
40550,7628,25937,2701,7785,28191,72242,2022-03-21 11:05:57.262904
44296,0,0,0,0,0,0,2022-03-21 11:36:50.963271
44297,0,0,0,0,0,0,2022-03-21 11:36:51.850132
44299,0,0,0,0,0,0,2022-03-21 11:36:52.821968
44303,0,0,0,0,0,0,2022-03-21 11:36:54.113178
40555,5,142,2,7,27,183,2022-03-21 11:05:59.742114
40556,7,495,4,9,39,554,2022-03-21 11:06:01.01448
40557,8,476,4,7,52,547,2022-03-21 11:06:02.476036
40558,11,332,5,10,54,412,2022-03-21 11:06:03.618653
40559,12,383,4,8,46,453,2022-03-21 11:06:04.802765
40560,6,428,3,14,57,508,2022-03-21 11:06:05.909001
40561,0,0,0,0,0,0,2022-03-21 11:06:07.458237
40562,4,118,2,13,25,162,2022-03-21 11:06:08.528985
44315,0,0,0,0,0,0,2022-03-21 11:36:56.97816
44316,0,0,0,0,0,0,2022-03-21 11:36:57.787208
44319,0,0,0,0,0,0,2022-03-21 11:36:58.897787
40582,3,73,2,14,29,121,2022-03-21 11:06:13.218234
40586,45930,136818,9683,21716,64011,278158,2022-03-21 11:06:15.107442
40587,49,730,36,62,1170,2047,2022-03-21 11:06:16.137306
40590,0,0,0,0,10332,10332,2022-03-21 11:06:16.482616
40591,79060,751715,15453,8039,163540,1017807,2022-03-21 11:06:19.594267
40593,2,30,4,28,30,94,2022-03-21 11:06:20.755566
40594,31208,123529,5133,18255,37770,215895,2022-03-21 11:06:21.18851
40598,3,158,3,8,26,198,2022-03-21 11:06:23.803322
40599,5,85,2,13,36,141,2022-03-21 11:06:25.018502
40600,2,85,1,12,22,122,2022-03-21 11:06:26.035242
40602,1447,36883,792,909,10792,50823,2022-03-21 11:06:26.981104
40608,4521,7504,774,2962,13422,29183,2022-03-21 11:06:28.701834
40619,3,84,1,8,22,118,2022-03-21 11:06:30.637614
40620,29170,56124,5936,8178,54373,153781,2022-03-21 11:06:32.285662
40621,2,16,3,28,131,180,2022-03-21 11:06:33.477862
40623,13669,46438,4515,13969,33552,112143,2022-03-21 11:06:33.94165
40630,162,3135,55,61,1526,4939,2022-03-21 11:06:36.132835
40632,0,0,0,0,2657,2657,2022-03-21 11:06:36.342928
40633,2,59,0,8,30,99,2022-03-21 11:06:40.833209
40636,15,79,7,40,225,366,2022-03-21 11:06:42.408788
40638,90,137,28,54,265,574,2022-03-21 11:06:44.183505
40641,5,69,0,16,43,133,2022-03-21 11:06:45.890567
40644,7,23,2,13,467,512,2022-03-21 11:06:49.122189
40645,9,149,0,34,78,270,2022-03-21 11:06:50.84622
44322,0,0,0,0,0,0,2022-03-21 11:37:00.047571
44327,0,0,0,0,0,0,2022-03-21 11:37:03.214367
44330,0,0,0,0,0,0,2022-03-21 11:37:07.141945
40646,753,24857,178,152,13551,39491,2022-03-21 11:06:51.04143
40651,115,1669,42,109,897,2832,2022-03-21 11:06:53.305817
40655,4,105,1,12,20,142,2022-03-21 11:06:58.203867
40656,227,3336,163,75,2739,6540,2022-03-21 11:07:00.327841
40657,0,0,0,0,0,0,2022-03-21 11:07:01.695704
40660,21,223,5,38,132,419,2022-03-21 11:07:03.815364
40661,245,6162,77,71,2204,8759,2022-03-21 11:07:06.613929
40664,217,2646,99,62,5168,8192,2022-03-21 11:07:06.80152
44331,0,0,0,0,0,0,2022-03-21 11:37:07.923809
44334,0,0,0,0,0,0,2022-03-21 11:37:09.763004
44337,0,0,0,0,0,0,2022-03-21 11:37:10.896108
40665,153,1750,80,70,2850,4903,2022-03-21 11:07:07.950192
40667,146,997,72,74,1353,2642,2022-03-21 11:07:10.26115
40670,3,45,4,29,44,125,2022-03-21 11:07:11.559946
40671,2,38,2,27,41,110,2022-03-21 11:07:12.557219
40672,3,28,3,32,37,103,2022-03-21 11:07:13.614281
40673,3,17,2,26,33,81,2022-03-21 11:07:14.783903
40677,894,3377,444,718,4601,10034,2022-03-21 11:07:17.19926
40679,14474,34994,4998,13699,28378,96543,2022-03-21 11:07:17.634492
40682,15777,15641,2202,1183,29086,63889,2022-03-21 11:07:18.076246
40683,8,425,3,8,61,505,2022-03-21 11:07:18.247716
40684,12,340,3,9,43,407,2022-03-21 11:07:20.835425
40685,13155,34471,3808,5191,31292,87917,2022-03-21 11:07:21.273793
40686,8,416,5,10,52,491,2022-03-21 11:07:21.736908
40689,3,88,3,9,19,122,2022-03-21 11:07:25.026597
40691,25,488,9,25,242,789,2022-03-21 11:07:28.759992
40693,71,707,24,54,795,1651,2022-03-21 11:07:28.972503
40695,4,106,1,10,21,142,2022-03-21 11:07:30.79104
40702,3,129,4,5,22,163,2022-03-21 11:07:33.50407
40703,6,200,4,6,22,238,2022-03-21 11:07:34.858114
40708,17443,93448,4281,14375,39950,169497,2022-03-21 11:07:37.090346
40709,3,175,3,6,22,209,2022-03-21 11:07:38.298145
40713,7,218,4,6,29,264,2022-03-21 11:07:40.45757
40714,198,164,87,135,715,1299,2022-03-21 11:07:40.668574
40715,8,175,3,6,26,218,2022-03-21 11:07:43.399349
40716,27365,130509,10462,9224,98123,275683,2022-03-21 11:07:45.782103
40717,46,21,13,18,1066,1164,2022-03-21 11:07:47.945949
40720,0,0,0,0,0,0,2022-03-21 11:07:48.798827
40721,6,340,2,11,48,407,2022-03-21 11:07:48.971226
40722,106,30,79,12,8412,8639,2022-03-21 11:07:51.16178
40728,6,100,1,16,55,178,2022-03-21 11:07:53.971366
44340,0,0,0,0,0,0,2022-03-21 11:37:12.094812
44353,0,0,0,0,0,0,2022-03-21 11:37:15.712214
44356,0,0,0,0,0,0,2022-03-21 11:37:16.881556
40729,21234,66533,3872,2461,68553,162653,2022-03-21 11:07:54.444
40730,9390,40644,2117,1859,33435,87445,2022-03-21 11:07:54.892773
40732,95,170,18,44,572,899,2022-03-21 11:07:56.709235
40733,452,1186,113,88,2597,4436,2022-03-21 11:07:56.914059
40734,773,2604,93,169,1241,4880,2022-03-21 11:07:59.607978
40735,791,2447,182,241,2353,6014,2022-03-21 11:07:59.783432
40737,4,130,1,7,33,175,2022-03-21 11:08:01.37712
40738,1545,7652,594,2138,10260,22189,2022-03-21 11:08:03.916694
40741,3,94,3,6,18,124,2022-03-21 11:08:05.268669
40742,2,111,4,7,21,145,2022-03-21 11:08:06.321853
40746,7252,72471,1680,3503,25392,110298,2022-03-21 11:08:07.212503
40747,507,6118,185,229,9846,16885,2022-03-21 11:08:07.675425
40748,327963,1184814,33409,16915,177845,1740946,2022-03-21 11:08:07.851703
40758,48,136,23,100,518,825,2022-03-21 11:08:10.443206
40761,442,3420,218,225,3895,8200,2022-03-21 11:08:13.994699
40762,113,2055,47,78,1568,3861,2022-03-21 11:08:14.188406
40763,1010,4591,399,881,5968,12849,2022-03-21 11:08:16.528659
40765,7,77,2,25,87,198,2022-03-21 11:08:17.904539
40768,50,0,31,39,77,197,2022-03-21 11:08:18.878592
40769,81,1243,19,77,662,2082,2022-03-21 11:08:19.05438
40776,55164,449573,9025,3963,104139,621864,2022-03-21 11:08:21.969023
40778,215,2670,123,50,6818,9876,2022-03-21 11:08:24.098877
40780,75,1253,25,83,648,2084,2022-03-21 11:08:26.571148
40781,0,0,0,0,0,0,2022-03-21 11:08:27.117905
44359,0,0,0,0,0,0,2022-03-21 11:37:18.007948
44363,0,0,0,0,0,0,2022-03-21 11:37:19.34559
44366,0,0,0,0,0,0,2022-03-21 11:37:20.473808
40783,3331,14274,1029,5345,9650,33629,2022-03-21 11:08:27.294639
40785,2,100,3,6,22,133,2022-03-21 11:08:34.119254
40786,4776,10800,1641,3483,14592,35292,2022-03-21 11:08:34.309702
40787,8893,148890,2098,405,108862,269148,2022-03-21 11:08:35.361831
40789,0,0,0,0,0,0,2022-03-21 11:08:36.493552
40793,17,134,3,21,154,329,2022-03-21 11:08:39.229296
40797,0,0,0,0,0,0,2022-03-21 11:08:40.957705
40799,15,419,4,31,122,591,2022-03-21 11:08:42.519403
44369,0,0,0,0,0,0,2022-03-21 11:37:22.008094
40800,1,108,4,7,18,138,2022-03-21 11:08:43.664944
40803,6079,16170,2284,5100,20524,50157,2022-03-21 11:08:43.835919
40806,197,871,61,69,1321,2519,2022-03-21 11:08:45.823994
40811,5,153,2,7,40,207,2022-03-21 11:08:52.949616
40813,0,0,0,0,283,283,2022-03-21 11:08:55.475266
40814,783,6928,375,95,16320,24501,2022-03-21 11:08:56.340817
40815,10199,105058,2384,1734,24418,143793,2022-03-21 11:08:56.513066
40816,4,186,3,11,42,246,2022-03-21 11:08:57.779821
44373,0,0,0,0,0,0,2022-03-21 11:37:25.199052
44378,0,0,0,0,0,0,2022-03-21 11:37:26.530045
44382,0,0,0,0,0,0,2022-03-21 11:37:29.61281
40823,77,282,22,60,228,669,2022-03-21 11:09:01.094847
40827,4,113,4,7,27,155,2022-03-21 11:09:03.449509
40828,21,616,4,17,90,748,2022-03-21 11:09:03.635104
40831,2,76,2,7,14,101,2022-03-21 11:09:09.663931
40832,11,65,4,56,57,193,2022-03-21 11:09:10.817129
40834,201566,123,5879,2782,103970,314320,2022-03-21 11:09:12.693746
40835,245,1550,96,103,1559,3553,2022-03-21 11:09:12.883536
40837,2,92,3,7,21,125,2022-03-21 11:09:14.479451
40842,5035,14501,1780,2134,27136,50586,2022-03-21 11:09:15.572282
40851,12,163,4,31,77,287,2022-03-21 11:09:17.744598
40852,95934,492296,14486,7258,170425,780399,2022-03-21 11:09:18.206715
40866,0,0,0,0,0,0,2022-03-21 11:09:20.813215
40867,0,0,0,0,0,0,2022-03-21 11:09:21.660477
40879,6783,25348,2089,2112,22408,58740,2022-03-21 11:09:25.695348
40888,87,0,44,59,393,583,2022-03-21 11:09:26.417229
40902,44813,253935,13068,12185,100066,424067,2022-03-21 11:09:30.423061
44383,0,0,0,0,0,0,2022-03-21 11:37:30.541003
40903,13,120,3,8,18,162,2022-03-21 11:09:32.03216
40905,3,95,2,8,19,127,2022-03-21 11:09:35.960974
40906,27971,1,4626,6162,18338,57098,2022-03-21 11:09:36.171359
40907,10561,49931,1760,1195,48362,111809,2022-03-21 11:09:37.137884
40908,41940,145826,8932,11663,85079,293440,2022-03-21 11:09:37.314028
40909,160,1274,24,73,262,1793,2022-03-21 11:09:40.462463
40910,0,0,0,0,0,0,2022-03-21 11:09:42.034329
40911,28761,143822,7702,6406,116246,302937,2022-03-21 11:09:42.212672
40915,0,0,0,0,0,0,2022-03-21 11:09:43.077049
44549,0,0,0,0,0,0,2022-03-21 11:38:36.192801
44552,0,0,0,0,0,0,2022-03-21 11:38:37.325906
40924,104,3624,54,68,2433,6283,2022-03-21 11:09:47.844351
40930,3645,17382,901,1124,15828,38880,2022-03-21 11:09:52.143412
40932,77,2464,37,46,979,3603,2022-03-21 11:09:52.410944
40934,5641,10045,2465,6303,19277,43731,2022-03-21 11:09:57.458334
40935,33090,195450,7851,4583,109139,350113,2022-03-21 11:09:59.842082
40936,1724,66489,540,303,30776,99832,2022-03-21 11:10:02.250534
40938,79604,257291,13143,22020,104075,476133,2022-03-21 11:10:02.424393
44556,0,0,0,0,0,0,2022-03-21 11:38:39.157686
44557,0,0,0,0,0,0,2022-03-21 11:38:40.190537
44561,0,0,0,0,0,0,2022-03-21 11:38:45.219308
40939,52,28,18,115,338,551,2022-03-21 11:10:05.174378
40940,2280,2993,604,922,9155,15954,2022-03-21 11:10:05.357983
40942,732,5411,158,166,2288,8755,2022-03-21 11:10:11.438136
40948,112,712,42,69,945,1880,2022-03-21 11:10:11.625542
40953,10,28,9,52,81,180,2022-03-21 11:10:13.593924
40956,87769,335376,25075,17451,110317,575988,2022-03-21 11:10:13.85107
40957,479,1741,118,265,1958,4561,2022-03-21 11:10:17.273247
40958,2331,9066,784,3922,8694,24797,2022-03-21 11:10:17.464848
40960,14088,38636,2989,10929,33531,100173,2022-03-21 11:10:17.981106
40964,5562,9012,1617,6075,12222,34488,2022-03-21 11:10:18.720474
40966,148,1242,30,75,298,1793,2022-03-21 11:10:23.356286
40969,166,585,52,81,812,1696,2022-03-21 11:10:23.980699
40970,0,0,0,0,0,0,2022-03-21 11:10:27.099243
40971,106,2069,33,77,786,3071,2022-03-21 11:10:27.275374
40973,0,0,0,0,0,0,2022-03-21 11:10:29.815537
40974,10069,67430,2661,5869,26499,112528,2022-03-21 11:10:29.996637
40979,2086,8843,359,458,8998,20744,2022-03-21 11:10:35.113509
44564,0,0,0,0,0,0,2022-03-21 11:38:47.090156
40982,224,3432,113,73,2498,6340,2022-03-21 11:10:35.530693
40983,72,174,28,163,319,756,2022-03-21 11:10:35.722509
40989,143,664,68,99,1471,2445,2022-03-21 11:10:38.674828
40990,5,73,1,9,30,118,2022-03-21 11:10:38.853535
40991,116,1002,24,74,430,1646,2022-03-21 11:10:41.739125
40994,73,164,27,47,481,792,2022-03-21 11:10:41.914076
41005,0,0,0,0,11775,11775,2022-03-21 11:10:48.436601
41006,35830,65021,14735,17105,95542,228233,2022-03-21 11:10:48.641231
44601,0,0,0,0,0,0,2022-03-21 11:39:13.726148
44602,0,0,0,0,0,0,2022-03-21 11:39:14.549622
41008,271,7612,128,104,4676,12791,2022-03-21 11:10:48.90965
41011,9,390,4,11,75,489,2022-03-21 11:10:55.665065
41019,10,78,6,41,92,227,2022-03-21 11:10:57.363548
41025,165835,213968,33043,21464,211191,645501,2022-03-21 11:11:01.326379
41028,4,32,2,23,187,248,2022-03-21 11:11:03.524985
41029,0,0,0,0,1910,1910,2022-03-21 11:11:03.997602
41030,64,1116,35,43,736,1994,2022-03-21 11:11:04.50139
41039,7,127,2,8,24,168,2022-03-21 11:11:06.333596
41050,0,0,0,0,0,0,2022-03-21 11:11:11.573087
44612,0,0,0,0,0,0,2022-03-21 11:39:17.775841
41051,1410,5588,447,534,7692,15671,2022-03-21 11:11:12.553063
41052,60,990,30,54,784,1918,2022-03-21 11:11:14.440623
41053,996,29397,448,248,10629,41718,2022-03-21 11:11:15.386038
41054,6,53,8,25,63,155,2022-03-21 11:11:16.511775
41056,0,0,0,0,0,0,2022-03-21 11:11:17.425432
41057,0,0,0,0,0,0,2022-03-21 11:11:18.512278
41059,0,0,0,0,0,0,2022-03-21 11:11:19.894384
41060,0,0,0,0,0,0,2022-03-21 11:11:20.814232
41061,211,10240,108,58,4022,14639,2022-03-21 11:11:20.991907
41071,0,0,0,0,0,0,2022-03-21 11:11:22.710511
41075,40,628,64,68,435,1235,2022-03-21 11:11:23.215845
41084,1,0,1,0,131196,131198,2022-03-21 11:11:27.495128
41087,0,0,0,0,0,0,2022-03-21 11:11:28.618146
44613,0,0,0,0,0,0,2022-03-21 11:39:18.834633
41090,7,615,8,10,99,739,2022-03-21 11:11:29.231482
41091,4,406,7,9,60,486,2022-03-21 11:11:30.76919
41094,16257,109910,3959,5942,54389,190457,2022-03-21 11:11:31.721902
41103,25647,94237,4444,11136,53366,188830,2022-03-21 11:11:35.258405
41105,223,4054,107,140,3181,7705,2022-03-21 11:11:38.418399
41109,26036,72720,6694,6436,87616,199502,2022-03-21 11:11:39.403607
41111,3,27,3,22,32,87,2022-03-21 11:11:42.004793
41113,3,22,3,28,27,83,2022-03-21 11:11:43.835525
41115,13,72,9,30,92,216,2022-03-21 11:11:47.35673
41116,3,22,4,25,32,86,2022-03-21 11:11:48.453237
41118,7,34,4,19,106,170,2022-03-21 11:11:50.390136
41119,2,22,3,16,26,69,2022-03-21 11:11:51.936546
41120,45799,172621,16556,13844,92254,341074,2022-03-21 11:11:52.27224
41121,5,25,2,14,34,80,2022-03-21 11:11:53.632676
41124,368,2248,100,791,1208,4715,2022-03-21 11:11:56.401981
41125,0,0,0,0,0,0,2022-03-21 11:11:57.424515
41127,0,0,0,0,0,0,2022-03-21 11:11:59.488227
41128,0,0,0,0,0,0,2022-03-21 11:12:01.034364
41130,0,0,0,0,0,0,2022-03-21 11:12:01.825357
44623,0,0,0,0,0,0,2022-03-21 11:39:22.569853
41132,263,3743,61,61,1918,6046,2022-03-21 11:12:02.855069
41136,5,61,7,37,67,177,2022-03-21 11:12:05.432933
41137,113,183,28,92,535,951,2022-03-21 11:12:05.618616
41140,298,1488,165,34,6350,8335,2022-03-21 11:12:08.228429
41142,0,0,0,0,0,0,2022-03-21 11:12:12.188447
41144,0,0,0,0,0,0,2022-03-21 11:12:13.999214
41146,285,3704,97,89,2133,6308,2022-03-21 11:12:16.693793
41152,0,0,0,0,0,0,2022-03-21 11:12:17.044698
41156,5,33,3,23,38,102,2022-03-21 11:12:18.82071
41158,7,29,6,16,40,98,2022-03-21 11:12:19.967447
41160,2,22,5,24,35,88,2022-03-21 11:12:22.615957
41161,2,23,3,22,26,76,2022-03-21 11:12:24.167189
41163,0,0,0,0,0,0,2022-03-21 11:12:24.979923
41167,23,878,10,32,168,1111,2022-03-21 11:12:29.053321
41168,5881,243356,1727,1330,65475,317769,2022-03-21 11:12:31.339212
41169,6688,16996,1208,1145,23153,49190,2022-03-21 11:12:34.062809
41170,5,116,2,8,39,170,2022-03-21 11:12:35.198967
41171,6,117,0,4,21,148,2022-03-21 11:12:37.25111
44647,0,0,0,0,0,0,2022-03-21 11:39:30.171484
44648,0,0,0,0,0,0,2022-03-21 11:39:31.015569
44651,0,0,0,0,0,0,2022-03-21 11:39:32.596076
41177,4,501,3,8,49,565,2022-03-21 11:12:41.854099
41178,3,358,7,7,36,411,2022-03-21 11:12:43.006161
41179,4,410,5,7,42,468,2022-03-21 11:12:44.460756
41180,9,682,3,10,51,755,2022-03-21 11:12:46.435571
41182,76,626,77,71,1138,1988,2022-03-21 11:12:48.893044
41184,2,25,4,17,27,75,2022-03-21 11:12:52.439613
41185,3,139,1,9,25,177,2022-03-21 11:12:53.450599
41189,66,1098,55,73,973,2265,2022-03-21 11:12:55.864733
41191,34,359,27,49,419,888,2022-03-21 11:12:57.70877
41193,13,319,7,7,47,393,2022-03-21 11:13:00.883866
41195,112,3577,23,34,501,4247,2022-03-21 11:13:03.699109
41199,2,25,2,31,41,101,2022-03-21 11:13:06.23591
41202,77,1933,34,40,792,2876,2022-03-21 11:13:09.964819
41203,18,106,14,24,226,388,2022-03-21 11:13:11.377789
41204,74,1460,55,66,1104,2759,2022-03-21 11:13:13.500157
41205,81,225,43,51,1884,2284,2022-03-21 11:13:15.681927
41206,627,1685,308,181,1972,4773,2022-03-21 11:13:18.322353
41209,0,0,0,0,0,0,2022-03-21 11:13:20.146572
41210,93,477,25,50,279,924,2022-03-21 11:13:20.351588
41215,55,338,21,48,198,660,2022-03-21 11:13:22.694407
41219,367,1258,86,152,1445,3308,2022-03-21 11:13:27.527986
41220,0,0,0,0,478,478,2022-03-21 11:13:29.260766
41222,14,260,1,15,68,358,2022-03-21 11:13:32.102187
41223,676,2106,163,185,2772,5902,2022-03-21 11:13:32.563036
41224,827,1199,301,267,4140,6734,2022-03-21 11:13:32.738229
44652,0,0,0,0,0,0,2022-03-21 11:39:33.536857
44654,0,0,0,0,0,0,2022-03-21 11:39:35.624181
44656,0,0,0,0,0,0,2022-03-21 11:39:39.901704
41226,32762,225703,9286,21334,74224,363309,2022-03-21 11:13:33.270624
41239,0,0,0,0,0,0,2022-03-21 11:13:35.432793
41247,0,0,0,0,0,0,2022-03-21 11:13:40.286314
41250,27,61,10,30,177,305,2022-03-21 11:13:41.953604
41255,0,0,0,0,0,0,2022-03-21 11:13:45.039306
41279,3,162,2,9,43,219,2022-03-21 11:13:47.767297
41280,10,126,3,27,76,242,2022-03-21 11:13:49.218992
41283,295,1029,110,263,1262,2959,2022-03-21 11:13:49.392665
41294,0,0,0,0,0,0,2022-03-21 11:13:51.110508
41298,16,319,5,16,133,489,2022-03-21 11:13:52.830542
44657,0,0,0,0,0,0,2022-03-21 11:39:41.816789
44658,0,0,0,0,0,0,2022-03-21 11:39:42.739092
44662,0,0,0,0,0,0,2022-03-21 11:39:46.628292
41299,81,181,43,65,809,1179,2022-03-21 11:13:53.032614
41308,3,102,1,5,11,122,2022-03-21 11:13:54.936572
41312,12437,92534,2332,7190,24400,138893,2022-03-21 11:13:58.560608
41315,0,0,0,0,0,0,2022-03-21 11:13:59.414358
41316,13,271,7,16,133,440,2022-03-21 11:13:59.582647
41317,55,514,28,36,566,1199,2022-03-21 11:14:00.800911
41319,31,1279,17,33,224,1584,2022-03-21 11:14:01.245592
41325,13,230,9,16,141,409,2022-03-21 11:14:04.476051
44666,0,0,0,0,0,0,2022-03-21 11:39:50.228261
44673,0,0,0,0,0,0,2022-03-21 11:39:53.528624
41335,6,124,6,16,126,278,2022-03-21 11:14:07.488827
41339,48,578,28,24,606,1284,2022-03-21 11:14:09.47913
41340,35,815,15,32,584,1481,2022-03-21 11:14:11.985933
41341,965,13858,287,482,10764,26356,2022-03-21 11:14:12.152583
41345,24856,108956,6460,20224,70366,230862,2022-03-21 11:14:14.62822
41349,14,61,13,87,172,347,2022-03-21 11:14:16.08101
41353,76283,471926,17049,46035,118441,729734,2022-03-21 11:14:16.51102
41361,649,3658,186,62,9163,13718,2022-03-21 11:14:18.62177
41372,4489,12586,1594,4774,16319,39762,2022-03-21 11:14:19.73231
41377,8,200,5,8,30,251,2022-03-21 11:14:23.996618
41380,21440,135107,5439,17085,41205,220276,2022-03-21 11:14:24.917765
41392,12162,31389,4026,9973,41070,98620,2022-03-21 11:14:26.538103
41402,41262,101096,5244,3027,56312,206941,2022-03-21 11:14:27.807787
41441,0,0,0,0,0,0,2022-03-21 11:14:34.377229
41443,3,145,2,6,26,182,2022-03-21 11:14:36.60614
41444,4,161,1,6,26,198,2022-03-21 11:14:37.860945
44681,0,0,0,0,0,0,2022-03-21 11:39:55.935872
44685,0,0,0,0,0,0,2022-03-21 11:39:57.120224
44689,0,0,0,0,0,0,2022-03-21 11:39:58.439299
41445,3,204,4,6,26,243,2022-03-21 11:14:39.045099
41446,2,103,0,7,25,137,2022-03-21 11:14:40.639141
41447,4,232,1,8,52,297,2022-03-21 11:14:41.870451
41448,3,85,3,6,23,120,2022-03-21 11:14:43.003348
41449,6,243,4,17,41,311,2022-03-21 11:14:44.6341
41450,2,102,1,10,25,140,2022-03-21 11:14:44.861258
41451,3,96,2,5,20,126,2022-03-21 11:14:46.894684
41452,3,79,3,7,26,118,2022-03-21 11:14:47.986624
41453,5,123,8,7,24,167,2022-03-21 11:14:49.664365
41454,205,1114,109,96,2628,4152,2022-03-21 11:14:51.648226
41456,40394,148230,7548,15455,73777,285404,2022-03-21 11:14:52.080992
41457,60065,250016,11899,11506,144329,477815,2022-03-21 11:14:52.542193
41458,21,0,8,58,71,158,2022-03-21 11:14:53.757599
41461,20,1,4,1,121717,121743,2022-03-21 11:14:56.623261
41462,97,323,77,37,3790,4324,2022-03-21 11:14:56.840972
41463,108,691,87,38,1076,2000,2022-03-21 11:15:01.93406
41468,8178,113973,2539,2347,58209,185246,2022-03-21 11:15:07.596158
41470,24,80,12,52,525,693,2022-03-21 11:15:07.76679
41479,0,0,0,0,0,0,2022-03-21 11:15:10.864858
41481,5,123,1,7,35,171,2022-03-21 11:15:13.785666
41487,64581,322220,4386,2466,110238,503891,2022-03-21 11:15:14.698126
41500,10,137,4,7,31,189,2022-03-21 11:15:17.826728
41503,0,0,0,0,451,451,2022-03-21 11:15:19.869546
41504,6,80,3,32,58,179,2022-03-21 11:15:21.030173
41505,9,270,0,15,50,344,2022-03-21 11:15:23.39958
44692,0,0,0,0,0,0,2022-03-21 11:39:59.635706
44699,0,0,0,0,0,0,2022-03-21 11:40:02.007206
41509,9,53,4,51,60,177,2022-03-21 11:15:23.579965
41511,487,866,145,179,1848,3525,2022-03-21 11:15:27.063934
41514,1,0,0,0,83997,83998,2022-03-21 11:15:27.494321
41519,100,281,49,64,2590,3084,2022-03-21 11:15:29.44823
41520,796,2803,244,343,5155,9341,2022-03-21 11:15:31.913188
41521,903,2627,308,1171,3993,9002,2022-03-21 11:15:34.871433
41527,0,0,0,0,0,0,2022-03-21 11:15:38.347003
41529,72,103,17,141,344,677,2022-03-21 11:15:41.607105
41530,3553,13752,886,690,28749,47630,2022-03-21 11:15:41.807907
45143,0,0,0,0,0,0,2022-03-21 11:43:00.250901
45144,0,0,0,0,0,0,2022-03-21 11:43:01.154852
41531,311,2751,156,142,2992,6352,2022-03-21 11:15:44.403673
41535,5,262,6,9,94,376,2022-03-21 11:15:47.063421
41536,0,0,0,0,0,0,2022-03-21 11:15:47.946238
41541,3,78,1,7,22,111,2022-03-21 11:15:49.924852
41545,52,225,21,39,374,711,2022-03-21 11:15:52.116058
41547,15,323,8,37,104,487,2022-03-21 11:15:55.104158
45146,0,0,0,0,0,0,2022-03-21 11:43:02.547329
45147,0,0,0,0,0,0,2022-03-21 11:43:03.439951
45150,0,0,0,0,0,0,2022-03-21 11:43:04.675505
41555,124,835,48,98,494,1599,2022-03-21 11:15:58.16938
41558,346,728,152,681,1452,3359,2022-03-21 11:16:06.100287
41564,14,457,9,39,154,673,2022-03-21 11:16:07.66389
41567,6,0,0,3,58914,58923,2022-03-21 11:16:08.481635
41568,26,369,16,55,541,1007,2022-03-21 11:16:08.650279
41569,0,0,0,0,0,0,2022-03-21 11:16:11.163921
41573,2247,7228,587,1078,10082,21222,2022-03-21 11:16:11.772746
41575,0,0,0,0,0,0,2022-03-21 11:16:15.694747
41586,95,1276,38,74,860,2343,2022-03-21 11:16:18.834671
45158,0,0,0,0,0,0,2022-03-21 11:43:08.127877
45164,0,0,0,0,0,0,2022-03-21 11:43:10.532191
41587,247829,361688,31143,19971,201304,861935,2022-03-21 11:16:19.281824
41589,0,1,0,0,14242,14243,2022-03-21 11:16:19.451956
41590,930,16320,362,280,10459,28351,2022-03-21 11:16:23.287469
41595,0,1,0,1,10088,10090,2022-03-21 11:16:23.462593
41602,36,602,15,14,245,912,2022-03-21 11:16:25.286215
41609,3,47,6,27,66,149,2022-03-21 11:16:26.90053
41611,813,6780,217,166,5951,13927,2022-03-21 11:16:27.073262
41612,0,0,0,0,0,0,2022-03-21 11:16:27.878478
41613,0,0,0,0,0,0,2022-03-21 11:16:28.95524
41619,25147,143959,6906,12803,68990,257805,2022-03-21 11:16:30.012339
41625,0,0,0,0,0,0,2022-03-21 11:16:31.848536
41628,0,0,0,0,0,0,2022-03-21 11:16:34.791246
45171,0,0,0,0,0,0,2022-03-21 11:43:12.961091
45174,0,0,0,0,0,0,2022-03-21 11:43:14.07331
45179,0,0,0,0,0,0,2022-03-21 11:43:17.301134
41630,5,148,1,5,16,175,2022-03-21 11:16:35.85991
41638,55,0,15,66,158,294,2022-03-21 11:16:40.418102
41646,3,65,3,7,16,94,2022-03-21 11:16:41.578969
41651,2,75,3,11,15,106,2022-03-21 11:16:43.126275
41656,3,88,3,6,18,118,2022-03-21 11:16:44.879394
41659,194,1957,126,79,3531,5887,2022-03-21 11:16:47.147513
41660,994,12287,352,328,6514,20475,2022-03-21 11:16:48.175126
41661,0,0,0,0,0,0,2022-03-21 11:16:48.602259
45181,0,0,0,0,0,0,2022-03-21 11:43:18.998055
45184,0,0,0,0,0,0,2022-03-21 11:43:20.277969
41664,2,71,3,7,14,97,2022-03-21 11:16:53.889285
41667,12,65,6,32,47,162,2022-03-21 11:16:55.536049
41673,3,104,2,13,31,153,2022-03-21 11:16:56.68644
41681,0,0,0,0,0,0,2022-03-21 11:17:00.711006
41684,2,86,2,10,18,118,2022-03-21 11:17:01.914731
41686,43,59,15,81,186,384,2022-03-21 11:17:05.420485
41688,678,2527,186,440,1394,5225,2022-03-21 11:17:05.635483
41689,9,169,8,25,81,292,2022-03-21 11:17:07.297271
45194,0,0,0,0,0,0,2022-03-21 11:43:26.175395
41694,24636,66831,9503,7682,79947,188599,2022-03-21 11:17:07.472572
41707,2,72,1,11,14,100,2022-03-21 11:17:09.69861
41708,7,122,1,7,35,172,2022-03-21 11:17:10.837434
41709,3,106,2,6,31,148,2022-03-21 11:17:12.455863
41710,38711,146542,4492,9058,63641,262444,2022-03-21 11:17:12.71396
41714,105,466,63,55,2003,2692,2022-03-21 11:17:12.886032
41725,4,187,0,4,43,238,2022-03-21 11:17:18.923293
45198,0,0,0,0,0,0,2022-03-21 11:43:28.781151
45205,0,0,0,0,0,0,2022-03-21 11:43:32.096663
41727,3,67,0,10,15,95,2022-03-21 11:17:20.467857
41737,0,0,0,0,0,0,2022-03-21 11:17:24.861318
41745,4,86,1,11,27,129,2022-03-21 11:17:28.934658
41750,1,0,0,0,4414,4415,2022-03-21 11:17:29.166426
41762,8874,27334,2754,6507,19283,64752,2022-03-21 11:17:33.236045
41763,5,118,3,4,16,146,2022-03-21 11:17:35.038213
41764,3,106,3,4,15,131,2022-03-21 11:17:36.448211
41766,1,80,2,8,14,105,2022-03-21 11:17:37.522882
41768,6,422,1,8,53,490,2022-03-21 11:17:39.432918
45209,0,0,0,0,0,0,2022-03-21 11:43:33.39235
45212,0,0,0,0,0,0,2022-03-21 11:43:34.639769
41769,6,366,2,8,26,408,2022-03-21 11:17:40.661342
41776,3,39,5,38,80,165,2022-03-21 11:17:41.876881
41777,3,34,4,46,65,152,2022-03-21 11:17:42.906589
41778,4,30,5,50,71,160,2022-03-21 11:17:44.002641
41781,144,1777,84,50,3081,5136,2022-03-21 11:17:46.852982
41782,81,96,55,24,4835,5091,2022-03-21 11:17:49.545187
41783,8355,32291,3053,9050,26607,79356,2022-03-21 11:17:49.71962
41785,120,773,30,66,512,1501,2022-03-21 11:17:52.552077
41786,3,69,1,8,18,99,2022-03-21 11:17:53.571229
41796,3,164,3,7,51,228,2022-03-21 11:17:55.019734
41797,4,113,1,13,38,169,2022-03-21 11:17:56.144472
41800,0,0,0,0,0,0,2022-03-21 11:17:57.241424
41806,0,0,0,0,0,0,2022-03-21 11:18:00.800538
41807,50,125,23,120,707,1025,2022-03-21 11:18:02.716272
41808,6,51,8,35,105,205,2022-03-21 11:18:03.99439
41812,20854,59450,3603,7932,44302,136141,2022-03-21 11:18:04.433655
41813,3,21,6,52,59,141,2022-03-21 11:18:05.931201
45217,0,0,0,0,0,0,2022-03-21 11:43:36.944875
45220,0,0,0,0,0,0,2022-03-21 11:43:38.098749
41820,6,100,3,4,17,130,2022-03-21 11:18:07.739548
41833,9934,20065,1761,5322,22634,59716,2022-03-21 11:18:09.166602
41834,10485,14048,2908,9414,20463,57318,2022-03-21 11:18:09.425101
41874,0,0,0,0,0,0,2022-03-21 11:18:12.415072
41877,458,3448,159,97,6786,10948,2022-03-21 11:18:12.795129
41913,86,73,33,69,425,686,2022-03-21 11:18:17.685153
41915,0,0,0,0,4898,4898,2022-03-21 11:18:18.67597
41916,221,356,63,124,1397,2161,2022-03-21 11:18:21.085275
41917,273,420,71,121,1061,1946,2022-03-21 11:18:23.510916
45222,0,0,0,0,0,0,2022-03-21 11:43:39.459519
41918,187,334,31,53,446,1051,2022-03-21 11:18:25.538644
41919,0,0,0,0,4138,4138,2022-03-21 11:18:28.178514
41920,79,139,24,79,231,552,2022-03-21 11:18:29.629255
41923,2002,1752,346,348,3703,8151,2022-03-21 11:18:29.80555
41926,5,99,3,6,20,133,2022-03-21 11:18:31.024506
41932,0,0,0,0,0,0,2022-03-21 11:18:33.715338
41936,0,0,0,0,0,0,2022-03-21 11:18:35.284488
41939,10,634,3,8,32,687,2022-03-21 11:18:35.480589
41942,4,8,5,18,42,77,2022-03-21 11:18:37.813867
41946,78733,29,4707,7646,75809,166924,2022-03-21 11:18:39.338739
42008,2,24,6,22,28,82,2022-03-21 11:19:00.76931
42012,17,358,5,11,118,509,2022-03-21 11:19:01.15051
42013,7,107,0,27,65,206,2022-03-21 11:19:03.31516
42014,5,168,2,21,44,240,2022-03-21 11:19:04.663328
42027,3,65,2,9,38,117,2022-03-21 11:19:07.741871
42047,9,142,4,25,72,252,2022-03-21 11:19:09.525723
42055,31,135,16,31,287,500,2022-03-21 11:19:12.27462
42057,194,1148,52,79,1225,2698,2022-03-21 11:19:15.30198
42061,8,43,5,42,43,141,2022-03-21 11:19:16.719299
42068,23,20,8,97,210,358,2022-03-21 11:19:18.024504
42072,31872,13,894,5051,29809,67639,2022-03-21 11:19:20.12577
42076,71,2993,11,36,179,3290,2022-03-21 11:19:23.987121
42083,4,6,1,5,14,30,2022-03-21 11:19:28.197712
42084,0,0,0,0,0,0,2022-03-21 11:19:28.985202
42089,0,0,0,0,0,0,2022-03-21 11:19:29.862546
42091,1627,31898,704,947,34728,69904,2022-03-21 11:19:31.562457
42105,2,110,3,7,17,139,2022-03-21 11:19:34.228688
45228,0,0,0,0,0,0,2022-03-21 11:43:41.83262
45231,0,0,0,0,0,0,2022-03-21 11:43:42.94966
42106,246,1664,84,83,3603,5680,2022-03-21 11:19:34.431647
42108,0,0,0,0,0,0,2022-03-21 11:19:37.807707
42109,8,39,7,22,27,103,2022-03-21 11:19:39.47975
42111,3,60,1,20,40,124,2022-03-21 11:19:40.71486
42128,55,1324,46,60,461,1946,2022-03-21 11:19:42.55155
42129,329,2791,171,122,5018,8431,2022-03-21 11:19:42.746635
42132,33,91,10,32,155,321,2022-03-21 11:19:46.118788
42143,149,6661,67,157,3130,10164,2022-03-21 11:19:55.083429
45240,0,0,0,0,0,0,2022-03-21 11:43:47.163438
45241,0,0,0,0,0,0,2022-03-21 11:43:48.204116
42148,124,177,30,101,454,886,2022-03-21 11:20:02.218634
42149,29,129,10,30,112,310,2022-03-21 11:20:03.908761
42151,22,114,8,36,103,283,2022-03-21 11:20:05.153682
42153,7,35,4,23,75,144,2022-03-21 11:20:06.494868
42156,25,428,10,15,143,621,2022-03-21 11:20:06.67238
42158,62,87,23,59,413,644,2022-03-21 11:20:09.310297
42161,2528,3,851,215,1197,4794,2022-03-21 11:20:09.48342
42164,7,0,8,22,34,71,2022-03-21 11:20:12.438836
42168,6,125,1,30,48,210,2022-03-21 11:20:13.460846
42170,9,61,3,29,57,159,2022-03-21 11:20:16.197874
42172,3,63,2,26,47,141,2022-03-21 11:20:17.305608
42174,174,452,61,68,1923,2678,2022-03-21 11:20:17.48446
42176,169,788,65,70,1047,2139,2022-03-21 11:20:21.445133
42179,5,15,7,53,71,151,2022-03-21 11:20:23.766514
42181,2,75,1,23,32,133,2022-03-21 11:20:24.922407
42187,324,1133,40,84,464,2045,2022-03-21 11:20:27.39546
42192,41447,50707,9191,14308,66841,182494,2022-03-21 11:20:31.095358
42193,5,14,8,14,64,105,2022-03-21 11:20:32.441818
42194,339,1414,139,150,3368,5410,2022-03-21 11:20:32.618446
42198,8,55,7,21,44,135,2022-03-21 11:20:36.140381
42199,3,244,4,11,32,294,2022-03-21 11:20:38.054557
42203,84160,425863,14198,8164,134685,667070,2022-03-21 11:20:38.496683
42205,84461,31,15531,25488,87382,212893,2022-03-21 11:20:38.669196
42206,471,1847,139,122,2391,4970,2022-03-21 11:20:38.84039
42209,49,207,13,46,261,576,2022-03-21 11:20:45.817944
42214,5,31,2,22,55,115,2022-03-21 11:20:48.06647
42215,3,16,0,16,34,69,2022-03-21 11:20:49.662923
42220,56,1325,7,46,309,1743,2022-03-21 11:20:51.280873
42228,9,133,2,13,89,246,2022-03-21 11:20:51.451474
42231,0,0,0,0,0,0,2022-03-21 11:20:54.217537
42234,3,146,2,20,55,226,2022-03-21 11:20:56.564733
42240,0,0,0,0,0,0,2022-03-21 11:20:59.770039
42247,4,99,1,11,47,162,2022-03-21 11:21:02.929627
45243,0,0,0,0,0,0,2022-03-21 11:43:50.183663
45260,0,0,0,0,0,0,2022-03-21 11:43:54.94279
42249,218690,419850,27183,29867,173690,869280,2022-03-21 11:21:04.968688
42250,10313,37850,2780,1903,30787,83633,2022-03-21 11:21:08.352862
42256,3,81,1,11,47,143,2022-03-21 11:21:09.779977
42257,5,100,1,13,61,180,2022-03-21 11:21:11.32477
42260,1130,3582,295,2809,7141,14957,2022-03-21 11:21:15.577245
42262,3,55,1,25,40,124,2022-03-21 11:21:16.749222
42263,2,12,1,17,32,64,2022-03-21 11:21:17.801735
42266,205,1744,37,81,574,2641,2022-03-21 11:21:21.715871
42267,891,0,88,143,452,1574,2022-03-21 11:21:21.92044
42268,158,347,40,96,280,921,2022-03-21 11:21:24.084403
42274,3,65,4,10,26,108,2022-03-21 11:21:28.569173
42275,3,71,2,9,28,113,2022-03-21 11:21:30.144853
42277,2,102,2,11,46,163,2022-03-21 11:21:32.346279
42278,5,76,2,9,35,127,2022-03-21 11:21:33.547772
42279,5,75,2,10,30,122,2022-03-21 11:21:34.691636
42280,4,75,3,7,28,117,2022-03-21 11:21:36.373748
42281,5,103,1,8,31,148,2022-03-21 11:21:37.410873
42282,27041,73484,5111,5998,62139,173773,2022-03-21 11:21:37.589657
42284,338,1486,53,114,634,2625,2022-03-21 11:21:39.644795
42285,240,226,49,116,1051,1682,2022-03-21 11:21:41.590898
42286,1,11,1,14,26,53,2022-03-21 11:21:42.554721
42290,144,680,33,64,539,1460,2022-03-21 11:21:42.726525
42291,247,225,45,107,404,1028,2022-03-21 11:21:44.807108
42295,240,0,132,151,662,1185,2022-03-21 11:21:47.230111
42296,12,49,13,32,433,539,2022-03-21 11:21:47.410645
42316,5,98,4,5,21,133,2022-03-21 11:21:49.374792
42319,72,110,20,61,528,791,2022-03-21 11:21:51.185619
42321,685,1902,218,1407,2700,6912,2022-03-21 11:21:52.031423
42323,3,17,3,14,42,79,2022-03-21 11:21:55.143365
42329,1,24,3,19,35,82,2022-03-21 11:21:56.902745
42330,11,16,4,41,65,137,2022-03-21 11:21:58.798845
42331,13,18,9,44,228,312,2022-03-21 11:22:00.144258
42333,11,36,4,50,77,178,2022-03-21 11:22:02.546883
42340,22972,73672,3985,8355,41368,150352,2022-03-21 11:22:03.454351
42345,15,101,11,44,156,327,2022-03-21 11:22:05.249397
42346,8,27,5,29,41,110,2022-03-21 11:22:06.639007
42347,3,99,3,10,19,134,2022-03-21 11:22:06.817646
42351,37145,107261,4209,4098,72567,225280,2022-03-21 11:22:08.573062
42367,2,20,1,18,33,74,2022-03-21 11:22:11.734166
42378,7,215,4,8,29,263,2022-03-21 11:22:16.092493
42390,0,0,0,0,0,0,2022-03-21 11:22:17.972226
42414,729,1886,272,389,3637,6913,2022-03-21 11:22:21.625829
42422,42,614,30,48,1027,1761,2022-03-21 11:22:22.662492
42423,1187,27652,507,140,22431,51917,2022-03-21 11:22:27.303336
42429,9,0,4,0,49424,49437,2022-03-21 11:22:27.489464
42432,9,274,6,7,58,354,2022-03-21 11:22:30.588445
42433,7,160,5,5,20,197,2022-03-21 11:22:31.764356
45265,0,0,0,0,0,0,2022-03-21 11:43:58.485124
45269,0,0,0,0,0,0,2022-03-21 11:44:00.584142
42435,9,209,3,7,25,253,2022-03-21 11:22:32.903519
42438,7,253,5,7,38,310,2022-03-21 11:22:35.478496
42439,10,206,7,11,61,295,2022-03-21 11:22:36.785385
42441,0,0,0,0,0,0,2022-03-21 11:22:37.604516
42442,7,187,4,6,20,224,2022-03-21 11:22:38.684879
42443,22,128,12,36,152,350,2022-03-21 11:22:40.097744
42444,7,94,8,31,63,203,2022-03-21 11:22:41.221565
42445,13,86,10,37,86,232,2022-03-21 11:22:42.740193
45271,0,0,0,0,0,0,2022-03-21 11:44:03.01214
45272,0,0,0,0,0,0,2022-03-21 11:44:03.841712
45273,0,0,0,0,0,0,2022-03-21 11:44:04.67199
42448,3,29,4,36,46,118,2022-03-21 11:22:46.01449
42449,57,646,50,64,769,1586,2022-03-21 11:22:47.858752
42450,0,0,0,0,0,0,2022-03-21 11:22:48.119746
42451,15,226,9,20,372,642,2022-03-21 11:22:49.860406
42454,42,302,17,38,298,697,2022-03-21 11:22:51.869875
42455,27,260,15,37,252,591,2022-03-21 11:22:53.36422
42456,9,21,6,28,110,174,2022-03-21 11:22:54.531265
42457,7,27,2,23,55,114,2022-03-21 11:22:55.684803
42461,0,0,0,0,0,0,2022-03-21 11:22:58.819125
45276,0,0,0,0,0,0,2022-03-21 11:44:06.142819
45277,0,0,0,0,0,0,2022-03-21 11:44:07.304978
42465,22,39,9,42,122,234,2022-03-21 11:23:03.015232
42466,3,24,2,19,43,91,2022-03-21 11:23:04.074487
42476,40,350,38,57,611,1096,2022-03-21 11:23:05.731692
42482,95,65,29,122,636,947,2022-03-21 11:23:13.779936
42484,3,117,2,7,26,155,2022-03-21 11:23:16.452695
42486,44,370,17,55,214,700,2022-03-21 11:23:18.357278
42487,127,451,85,71,1390,2124,2022-03-21 11:23:21.701575
42488,22,504,17,30,301,874,2022-03-21 11:23:23.454422
42490,24,225,22,43,154,468,2022-03-21 11:23:24.724179
42496,347,5362,79,119,1151,7058,2022-03-21 11:23:28.978092
42497,319,5256,73,131,1106,6885,2022-03-21 11:23:29.180088
42498,1573,4213,144,217,2174,8321,2022-03-21 11:23:31.775016
42500,12,146,5,45,78,286,2022-03-21 11:23:32.986541
42501,7,146,6,25,94,278,2022-03-21 11:23:33.160716
42506,764,2700,232,466,5072,9234,2022-03-21 11:23:34.25751
42507,8,152,3,27,48,238,2022-03-21 11:23:37.688565
42509,0,0,0,0,0,0,2022-03-21 11:23:38.493379
42513,4,25,4,19,54,106,2022-03-21 11:23:41.652382
42514,522,1472,199,354,603,3150,2022-03-21 11:23:44.394492
42516,1828,2977,470,1692,4310,11277,2022-03-21 11:23:44.574271
42517,1204,9322,338,475,7536,18875,2022-03-21 11:23:44.747032
42519,1045,23540,320,116,8858,33879,2022-03-21 11:23:50.588811
42522,63,62,26,67,207,425,2022-03-21 11:23:51.848135
42524,0,0,0,0,0,0,2022-03-21 11:23:52.648035
45278,0,0,0,0,0,0,2022-03-21 11:44:08.370138
42526,9,218,2,8,30,267,2022-03-21 11:23:53.834901
42531,0,0,0,0,0,0,2022-03-21 11:23:54.68584
42538,0,0,0,0,0,0,2022-03-21 11:23:56.958266
42540,6,24,3,19,34,86,2022-03-21 11:23:58.083509
42542,2,43,1,16,27,89,2022-03-21 11:23:59.04932
42546,8,128,5,38,99,278,2022-03-21 11:23:59.416089
42549,0,0,0,0,0,0,2022-03-21 11:24:02.460978
42562,466,1708,189,208,4349,6920,2022-03-21 11:24:05.057351
42563,7,148,3,6,21,185,2022-03-21 11:24:06.324248
42564,0,0,0,0,0,0,2022-03-21 11:24:07.335221
42566,0,0,0,0,0,0,2022-03-21 11:24:08.280773
45284,0,0,0,0,0,0,2022-03-21 11:44:13.413878
45287,0,0,0,0,0,0,2022-03-21 11:44:15.483598
42568,5330,12670,1672,3974,15881,39527,2022-03-21 11:24:09.217381
42571,4796,26082,1228,3650,21892,57648,2022-03-21 11:24:10.238711
42590,16077,53636,3837,5246,46205,125001,2022-03-21 11:24:11.329717
42593,138,430,145,83,3986,4782,2022-03-21 11:24:14.040344
42603,3536,104332,869,610,28736,138083,2022-03-21 11:24:18.29379
42616,3,94,1,7,20,125,2022-03-21 11:24:19.981743
42618,4,88,2,7,23,124,2022-03-21 11:24:22.26018
42625,16430,63309,3072,4417,58181,145409,2022-03-21 11:24:26.466094
42627,24826,53706,5128,14276,44825,142761,2022-03-21 11:24:26.93832
42632,269,6653,132,76,2864,9994,2022-03-21 11:24:31.813043
42637,1,72,1,11,15,100,2022-03-21 11:24:33.579947
42640,385,4127,92,102,1829,6535,2022-03-21 11:24:36.074537
42641,70,104,35,63,1629,1901,2022-03-21 11:24:40.583681
42646,2,64,3,6,16,91,2022-03-21 11:24:42.506805
42650,2,108,1,13,21,145,2022-03-21 11:24:44.725587
42653,480,686,160,262,1016,2604,2022-03-21 11:24:46.745732
42654,4,69,4,28,38,143,2022-03-21 11:24:47.948384
42656,1,62,1,5,15,84,2022-03-21 11:24:49.00597
42657,81,371,41,256,214,963,2022-03-21 11:24:49.28498
42660,4,64,5,26,38,137,2022-03-21 11:24:53.319663
42662,1,66,1,5,14,87,2022-03-21 11:24:54.364393
42663,1,68,1,7,13,90,2022-03-21 11:24:55.408421
42667,6,12,4,16,74,112,2022-03-21 11:24:57.938359
42668,4362,18939,1925,4018,20698,49942,2022-03-21 11:24:58.133361
42670,31966,9,974,958,44966,78873,2022-03-21 11:24:59.968079
42672,1,70,1,9,14,95,2022-03-21 11:25:01.081496
42673,0,0,0,0,0,0,2022-03-21 11:25:01.259503
42681,1,69,1,8,17,96,2022-03-21 11:25:02.56363
42682,1,65,1,11,14,92,2022-03-21 11:25:03.664265
42690,1,60,2,5,13,81,2022-03-21 11:25:07.500125
42697,7,185,5,27,109,333,2022-03-21 11:25:07.694289
45291,0,0,0,0,0,0,2022-03-21 11:44:16.697009
45296,0,0,0,0,0,0,2022-03-21 11:44:18.951903
45309,0,0,0,0,0,0,2022-03-21 11:44:24.531025
45310,0,0,0,0,0,0,2022-03-21 11:44:25.336059
42698,3,52,1,15,33,104,2022-03-21 11:25:09.656594
42703,11,471,5,8,72,567,2022-03-21 11:25:12.403988
42714,1074,4843,321,563,6654,13455,2022-03-21 11:25:16.41692
42717,73,109,70,132,432,816,2022-03-21 11:25:18.096813
42718,0,0,0,0,0,0,2022-03-21 11:25:18.934352
42723,297,2995,105,218,2789,6404,2022-03-21 11:25:22.622164
42725,2,105,3,6,23,139,2022-03-21 11:25:23.856819
42726,0,0,0,0,0,0,2022-03-21 11:25:25.106282
45321,0,0,0,0,0,0,2022-03-21 11:44:28.629392
42731,8,141,4,9,70,232,2022-03-21 11:25:27.432771
42733,2,67,3,7,15,94,2022-03-21 11:25:28.832823
42736,3,69,2,7,15,96,2022-03-21 11:25:30.374813
42744,1,65,1,7,14,88,2022-03-21 11:25:32.868462
42745,9,1,2,0,27614,27626,2022-03-21 11:25:33.126496
42753,0,0,0,0,0,0,2022-03-21 11:25:34.404567
42761,5,27,4,37,44,117,2022-03-21 11:25:36.193747
42768,1,69,1,9,17,97,2022-03-21 11:25:39.459078
45324,0,0,0,0,0,0,2022-03-21 11:44:29.823578
45327,0,0,0,0,0,0,2022-03-21 11:44:30.979741
45330,0,0,0,0,0,0,2022-03-21 11:44:32.174176
42780,1,87,1,10,17,116,2022-03-21 11:25:43.861304
42783,34,915,26,17,341,1333,2022-03-21 11:25:45.488103
42784,70,110,23,52,135,390,2022-03-21 11:25:46.761285
42785,1,65,2,5,13,86,2022-03-21 11:25:47.926799
42786,1,82,4,6,18,111,2022-03-21 11:25:49.617024
42793,8,233,2,11,38,292,2022-03-21 11:25:55.003731
42797,32,373,16,35,218,674,2022-03-21 11:25:55.841602
42798,195,3633,92,93,5097,9110,2022-03-21 11:25:56.102776
42801,4,81,1,6,21,113,2022-03-21 11:26:00.143486
42803,948,7095,329,176,4363,12911,2022-03-21 11:26:02.218692
42815,15,20,8,38,249,330,2022-03-21 11:26:04.858732
42820,10,196,3,8,45,262,2022-03-21 11:26:05.05223
42822,7414,27225,2025,4661,16947,58272,2022-03-21 11:26:06.839309
42829,93,240,39,43,1350,1765,2022-03-21 11:26:07.589536
42838,3,58,2,9,14,86,2022-03-21 11:26:10.812878
42840,6,11,4,22,97,140,2022-03-21 11:26:11.973022
42844,4,50,3,4,18,79,2022-03-21 11:26:16.354269
42845,7,64,3,13,24,111,2022-03-21 11:26:18.087714
42847,1888,1636,675,84,39702,43985,2022-03-21 11:26:21.888845
42852,4,6,2,9,40,61,2022-03-21 11:26:23.101834
42853,3,80,3,7,22,115,2022-03-21 11:26:24.337761
42854,7,118,5,7,20,157,2022-03-21 11:26:25.454603
42855,72,979,22,59,544,1676,2022-03-21 11:26:27.962456
42862,1160,4659,315,634,4029,10797,2022-03-21 11:26:28.158024
42863,3,67,2,7,18,97,2022-03-21 11:26:31.821298
42864,0,0,0,0,0,0,2022-03-21 11:26:32.602287
42865,5,164,2,10,43,224,2022-03-21 11:26:33.810746
42867,1105,6171,363,461,8662,16762,2022-03-21 11:26:34.079078
42870,59,0,21,118,376,574,2022-03-21 11:26:35.750068
42873,2,68,1,9,20,100,2022-03-21 11:26:37.994209
42874,0,0,0,0,0,0,2022-03-21 11:26:38.844476
42875,31,0,22,23,120,196,2022-03-21 11:26:39.026087
42882,31,281,7,20,190,529,2022-03-21 11:26:41.153269
45333,0,0,0,0,0,0,2022-03-21 11:44:33.739958
45357,0,0,0,0,0,0,2022-03-21 11:44:40.527024
42883,473,2980,136,675,1549,5813,2022-03-21 11:26:43.14338
42885,47,52,14,30,249,392,2022-03-21 11:26:44.48345
42886,265,1,52,20,8917,9255,2022-03-21 11:26:44.658823
42889,92,1685,44,36,828,2685,2022-03-21 11:26:46.75689
42897,140315,617862,19050,19661,165962,962850,2022-03-21 11:26:49.188702
42910,3,59,1,4,15,82,2022-03-21 11:26:52.078288
42914,33,335,41,55,385,849,2022-03-21 11:26:54.441621
42919,1,77,1,10,19,108,2022-03-21 11:26:56.879563
42922,4,13,0,16,27,60,2022-03-21 11:26:58.110249
42923,61519,233050,11563,11618,102534,420284,2022-03-21 11:26:58.37179
42930,0,0,0,0,0,0,2022-03-21 11:27:02.924815
42932,0,0,0,0,0,0,2022-03-21 11:27:03.911585
42940,3354,51472,538,322,13482,69168,2022-03-21 11:27:04.572984
42956,51,190,15,50,290,596,2022-03-21 11:27:06.882058
42959,890,5626,246,319,4663,11744,2022-03-21 11:27:11.883453
42962,2,0,5,2,81581,81590,2022-03-21 11:27:12.352888
42963,4,1,7,2,182261,182275,2022-03-21 11:27:12.519233
45361,0,0,0,0,0,0,2022-03-21 11:44:41.793777
45364,0,0,0,0,0,0,2022-03-21 11:44:42.967278
42981,358,1663,117,796,1231,4165,2022-03-21 11:27:17.396107
42985,55,584,24,46,313,1022,2022-03-21 11:27:19.737498
42988,4,91,3,7,19,124,2022-03-21 11:27:21.229791
42989,3,108,5,7,25,148,2022-03-21 11:27:22.988816
42990,383,7895,148,133,5089,13648,2022-03-21 11:27:25.405398
42994,0,0,0,0,7596,7596,2022-03-21 11:27:25.590027
42995,4,87,2,5,18,116,2022-03-21 11:27:26.070649
42996,2,98,1,6,17,124,2022-03-21 11:27:28.627793
45371,0,0,0,0,0,0,2022-03-21 11:44:45.935004
45373,0,0,0,0,0,0,2022-03-21 11:44:48.317711
42998,8,14,6,61,63,152,2022-03-21 11:27:29.836904
43004,1,74,2,9,15,101,2022-03-21 11:27:32.839222
43007,31031,89968,6719,21915,62077,211710,2022-03-21 11:27:34.189201
43011,2,81,3,6,17,109,2022-03-21 11:27:35.697926
43020,9,306,7,24,77,423,2022-03-21 11:27:39.107091
43043,3,81,3,5,19,111,2022-03-21 11:27:41.523595
43201,4,164,1,8,25,202,2022-03-21 11:27:44.243054
43204,35,266,32,31,979,1343,2022-03-21 11:27:46.953134
43205,0,0,0,0,0,0,2022-03-21 11:27:47.162714
43206,0,0,0,0,0,0,2022-03-21 11:27:48.269622
43207,20,53,4,39,150,266,2022-03-21 11:27:49.409004
43208,1,31,2,7,15,56,2022-03-21 11:27:50.34089
43213,2,22,2,8,16,50,2022-03-21 11:27:52.242492
43214,0,12,1,8,11,32,2022-03-21 11:27:53.164088
43215,2,21,2,11,16,52,2022-03-21 11:27:54.205202
43216,0,15,2,8,10,35,2022-03-21 11:27:55.257538
45374,0,0,0,0,0,0,2022-03-21 11:44:49.15841
45377,0,0,0,0,0,0,2022-03-21 11:44:50.287125
45380,0,0,0,0,0,0,2022-03-21 11:44:51.445924
43218,2,23,2,7,17,51,2022-03-21 11:27:56.376796
43221,0,4,3,13,12,32,2022-03-21 11:27:57.628674
43225,0,19,1,11,12,43,2022-03-21 11:28:00.046977
43227,0,23,2,7,8,40,2022-03-21 11:28:01.55056
43228,0,18,2,7,8,35,2022-03-21 11:28:02.467173
43233,0,11,2,9,10,32,2022-03-21 11:28:04.911654
43236,0,14,2,8,10,34,2022-03-21 11:28:06.080786
43238,0,8,1,8,10,27,2022-03-21 11:28:07.524573
43292,2,54,4,8,18,86,2022-03-21 11:28:31.812322
43299,89661,278000,23349,23368,191018,605396,2022-03-21 11:28:32.802295
43309,4,14,0,13,22,53,2022-03-21 11:28:35.412297
43314,0,16,0,5,12,33,2022-03-21 11:28:37.210013
43325,22877,82078,4542,2417,62970,174884,2022-03-21 11:28:40.429037
43345,0,9,1,7,8,25,2022-03-21 11:28:43.1439
43348,0,3,0,8,13,24,2022-03-21 11:28:45.340468
43349,256,8644,86,136,1954,11076,2022-03-21 11:28:45.541857
45383,0,0,0,0,0,0,2022-03-21 11:44:52.65574
45389,0,0,0,0,0,0,2022-03-21 11:44:55.542344
43350,57,449,20,61,390,977,2022-03-21 11:28:49.342057
43351,9,109,2,6,23,149,2022-03-21 11:28:50.612011
43352,6,112,3,5,18,144,2022-03-21 11:28:52.287411
43356,0,7,1,8,14,30,2022-03-21 11:28:56.3552
43357,0,9,1,7,14,31,2022-03-21 11:28:57.446142
43359,0,9,1,7,11,28,2022-03-21 11:28:59.1396
43362,0,11,0,10,10,31,2022-03-21 11:29:02.402691
43367,0,10,2,7,12,31,2022-03-21 11:29:04.216504
43415,7,157,3,5,29,201,2022-03-21 11:29:33.561813
43417,7,151,2,15,70,245,2022-03-21 11:29:36.409983
43419,6,277,0,8,37,328,2022-03-21 11:29:40.134462
43429,5,34,6,9,55,109,2022-03-21 11:29:42.332801
43430,3,8,4,15,31,61,2022-03-21 11:29:43.332378
43431,4,8,6,14,25,57,2022-03-21 11:29:44.279869
43432,6,11,6,14,58,95,2022-03-21 11:29:45.347071
43433,1,62,3,21,19,106,2022-03-21 11:29:46.407437
43435,7,132,2,6,20,167,2022-03-21 11:29:49.767999
43438,21,519,14,27,137,718,2022-03-21 11:29:51.357647
43439,20937,67981,5404,6106,60764,161192,2022-03-21 11:29:51.795123
43444,9,250,3,10,85,357,2022-03-21 11:29:53.718729
43446,2,66,3,7,15,93,2022-03-21 11:29:53.904496
43449,0,4,2,9,12,27,2022-03-21 11:29:57.272156
43454,0,3,0,9,13,25,2022-03-21 11:29:59.206121
43456,0,11,3,10,11,35,2022-03-21 11:30:01.121648
43457,5,112,2,5,22,146,2022-03-21 11:30:02.230392
43458,0,8,1,6,12,27,2022-03-21 11:30:03.059122
43462,0,11,2,6,11,30,2022-03-21 11:30:04.420718
43464,1,5,2,7,11,26,2022-03-21 11:30:05.437584
43478,0,0,0,0,0,0,2022-03-21 11:30:08.41521
43494,0,9,2,6,10,27,2022-03-21 11:30:16.362963
43508,0,11,1,7,8,27,2022-03-21 11:30:21.090483
43511,0,9,1,7,9,26,2022-03-21 11:30:22.35539
43517,3,44,3,12,17,79,2022-03-21 11:30:24.948791
43519,0,13,0,7,14,34,2022-03-21 11:30:26.061957
43521,4,135,2,9,26,176,2022-03-21 11:30:27.423095
43522,6,845,3,9,35,898,2022-03-21 11:30:29.037824
43523,28727,161574,2898,4620,56228,254047,2022-03-21 11:30:29.479401
43533,0,8,1,7,11,27,2022-03-21 11:30:32.463304
43534,0,10,1,7,9,27,2022-03-21 11:30:33.341284
43536,0,13,1,6,9,29,2022-03-21 11:30:33.912467
43621,1,54,2,3,8,68,2022-03-21 11:31:08.355901
43624,1,10,0,6,9,26,2022-03-21 11:31:11.894474
43625,0,18,0,5,8,31,2022-03-21 11:31:13.81286
43628,2,70,2,6,12,92,2022-03-21 11:31:16.816841
43629,0,0,0,0,7764,7764,2022-03-21 11:31:17.017155
43632,0,15,1,4,10,30,2022-03-21 11:31:19.961036
43633,0,6,1,7,10,24,2022-03-21 11:31:20.90511
45394,0,0,0,0,0,0,2022-03-21 11:44:59.961663
45396,0,0,0,0,0,0,2022-03-21 11:45:00.981864
43657,0,16,1,5,7,29,2022-03-21 11:31:30.946239
43669,0,12,0,7,8,27,2022-03-21 11:31:36.867176
43674,0,6,1,7,10,24,2022-03-21 11:31:39.168993
43678,0,5,0,8,11,24,2022-03-21 11:31:41.868919
43681,0,4,0,10,13,27,2022-03-21 11:31:45.599786
43690,17466,141178,5619,11592,56627,232482,2022-03-21 11:31:46.84363
43703,2,33,5,23,38,101,2022-03-21 11:31:48.166862
43735,7276,1,404,1543,7763,16987,2022-03-21 11:31:49.350907
43755,193,114,138,29,8584,9058,2022-03-21 11:31:53.051876
43756,12404,32909,3058,3766,31852,83989,2022-03-21 11:31:53.263924
43760,0,0,0,0,1271,1271,2022-03-21 11:31:55.593074
43761,1,56,2,6,15,80,2022-03-21 11:31:57.088136
43763,1729,6393,416,2759,6556,17853,2022-03-21 11:32:00.159558
43767,4297,7799,1040,3277,22373,38786,2022-03-21 11:32:03.569302
43769,121,0,58,25,103,307,2022-03-21 11:32:04.560597
43778,49,62,10,63,240,424,2022-03-21 11:32:13.034132
45405,0,0,0,0,0,0,2022-03-21 11:45:06.994016
45409,0,0,0,0,0,0,2022-03-21 11:45:08.240219
43780,11,37,5,21,480,554,2022-03-21 11:32:16.090297
43794,0,14,1,10,8,33,2022-03-21 11:32:17.455287
43796,1,5,1,8,11,26,2022-03-21 11:32:19.378144
43798,0,8,1,7,11,27,2022-03-21 11:32:21.252853
43799,0,10,2,6,10,28,2022-03-21 11:32:22.176585
43800,0,9,1,7,9,26,2022-03-21 11:32:23.015854
43803,0,6,0,10,12,28,2022-03-21 11:32:24.213077
43806,0,11,1,6,8,26,2022-03-21 11:32:25.488724
45412,0,0,0,0,0,0,2022-03-21 11:45:09.351707
43809,0,11,1,5,12,29,2022-03-21 11:32:26.753345
43814,19211,75017,3035,6119,35160,138542,2022-03-21 11:32:27.150896
43816,0,10,1,6,9,26,2022-03-21 11:32:30.74
43817,0,10,2,6,9,27,2022-03-21 11:32:31.683312
43819,0,10,2,6,10,28,2022-03-21 11:32:34.179564
43821,0,0,0,0,0,0,2022-03-21 11:32:35.965188
43823,0,0,0,0,0,0,2022-03-21 11:32:37.616349
43828,0,0,0,0,0,0,2022-03-21 11:32:40.463853
43829,0,0,0,0,0,0,2022-03-21 11:32:41.343744
43831,0,0,0,0,0,0,2022-03-21 11:32:42.358301
43840,0,0,0,0,0,0,2022-03-21 11:32:45.850384
43851,0,0,0,0,0,0,2022-03-21 11:32:49.480924
43854,0,0,0,0,0,0,2022-03-21 11:32:50.686535
43866,0,0,0,0,0,0,2022-03-21 11:32:58.280428
43867,0,0,0,0,0,0,2022-03-21 11:32:59.228932
43871,0,0,0,0,0,0,2022-03-21 11:33:00.846363
43872,0,0,0,0,0,0,2022-03-21 11:33:01.681804
43878,154,726,61,50,911,1902,2022-03-21 11:33:03.173917
43879,8,403,0,6,44,461,2022-03-21 11:33:05.080157
43880,0,0,0,0,0,0,2022-03-21 11:33:06.834239
43881,0,0,0,0,0,0,2022-03-21 11:33:07.630343
43883,0,0,0,0,0,0,2022-03-21 11:33:09.167202
43884,0,0,0,0,0,0,2022-03-21 11:33:10.071414
43890,0,0,0,0,0,0,2022-03-21 11:33:12.309195
43905,0,0,0,0,0,0,2022-03-21 11:33:18.28513
43920,0,0,0,0,0,0,2022-03-21 11:33:27.69133
43921,0,0,0,0,0,0,2022-03-21 11:33:28.538067
43925,0,0,0,0,0,0,2022-03-21 11:33:30.245714
43936,0,0,0,0,0,0,2022-03-21 11:33:37.638588
43943,0,0,0,0,0,0,2022-03-21 11:33:39.872726
43946,0,0,0,0,0,0,2022-03-21 11:33:41.031389
43953,0,0,0,0,0,0,2022-03-21 11:33:43.496005
43956,0,0,0,0,0,0,2022-03-21 11:33:44.653877
43962,0,0,0,0,0,0,2022-03-21 11:33:47.134063
43965,0,0,0,0,0,0,2022-03-21 11:33:48.84334
43966,0,0,0,0,0,0,2022-03-21 11:33:49.646513
45417,0,0,0,0,0,0,2022-03-21 11:45:11.970504
45419,0,0,0,0,0,0,2022-03-21 11:45:13.011777
43969,43827,117675,7572,23908,68544,261526,2022-03-21 11:33:50.39894
43976,0,0,0,0,0,0,2022-03-21 11:33:53.094618
43987,1,30,0,20,23,74,2022-03-21 11:33:55.87506
43995,1,25,0,20,25,71,2022-03-21 11:34:00.266238
43998,1,24,1,21,21,68,2022-03-21 11:34:03.423474
44001,2,26,0,20,24,72,2022-03-21 11:34:06.54091
44002,2,28,2,30,31,93,2022-03-21 11:34:07.894421
44004,1,20,0,19,30,70,2022-03-21 11:34:10.396083
45430,0,0,0,0,0,0,2022-03-21 11:45:15.489801
45431,0,0,0,0,0,0,2022-03-21 11:45:16.635708
44006,3,20,3,23,38,87,2022-03-21 11:34:12.094595
44007,1,21,2,23,31,78,2022-03-21 11:34:13.840545
44008,1,17,0,23,32,73,2022-03-21 11:34:14.759129
44014,3,10,0,13,19,45,2022-03-21 11:34:17.303612
44016,0,0,0,0,0,0,2022-03-21 11:34:18.373985
44026,7,29,3,45,61,145,2022-03-21 11:34:22.20892
44028,0,0,0,0,0,0,2022-03-21 11:34:23.47617
44029,0,0,0,0,0,0,2022-03-21 11:34:24.847868
44035,0,0,0,0,0,0,2022-03-21 11:34:26.974377
44037,36984,99336,3234,7275,54445,201274,2022-03-21 11:34:27.60145
44055,49175,24,1222,1928,42901,95250,2022-03-21 11:34:29.643098
44065,322,364,53,73,907,1719,2022-03-21 11:34:32.536186
44067,162,437,45,55,1302,2001,2022-03-21 11:34:32.73746
44068,392,1035,70,77,1043,2617,2022-03-21 11:34:34.661597
44069,10398,20286,1175,680,27406,59945,2022-03-21 11:34:36.927579
44070,652,19432,171,176,7805,28236,2022-03-21 11:34:37.195118
44071,266,592,29,65,492,1444,2022-03-21 11:34:38.522426
44072,135,117,36,53,808,1149,2022-03-21 11:34:42.927382
44074,22729,62086,4560,2242,96227,187844,2022-03-21 11:34:44.936468
44075,44,74,18,55,315,506,2022-03-21 11:34:46.893821
44077,2,45,0,3,8,58,2022-03-21 11:34:48.55316
44078,86,79,22,35,243,465,2022-03-21 11:34:48.750037
44079,0,0,0,0,399,399,2022-03-21 11:34:51.629497
44084,6,208,2,4,34,254,2022-03-21 11:34:53.415555
44086,25,1249,10,23,176,1483,2022-03-21 11:34:55.714287
44087,1700,29718,543,220,19546,51727,2022-03-21 11:34:57.838758
44089,2,45,0,3,4,54,2022-03-21 11:34:59.454909
45435,0,0,0,0,0,0,2022-03-21 11:45:17.954844
45441,0,0,0,0,0,0,2022-03-21 11:45:20.615898
45442,0,0,0,0,0,0,2022-03-21 11:45:21.467599
44090,49,460,23,36,278,846,2022-03-21 11:34:59.633139
44096,36,30,11,29,222,328,2022-03-21 11:35:03.343473
44097,152,411,49,65,875,1552,2022-03-21 11:35:06.01708
44099,3,68,1,6,18,96,2022-03-21 11:35:07.226851
44103,0,0,0,0,0,0,2022-03-21 11:35:10.391877
44111,0,0,0,0,0,0,2022-03-21 11:35:15.858028
44120,0,0,0,0,0,0,2022-03-21 11:35:20.15624
44138,0,0,0,0,0,0,2022-03-21 11:35:28.527711
44141,0,1,0,0,9579,9580,2022-03-21 11:35:32.082947
44144,1,16,0,16,13,46,2022-03-21 11:35:33.071398
44145,0,12,0,12,12,36,2022-03-21 11:35:33.946371
44147,0,12,0,15,12,39,2022-03-21 11:35:37.119507
44148,0,12,1,17,14,44,2022-03-21 11:35:38.369116
44149,0,11,1,16,12,40,2022-03-21 11:35:39.298581
44153,0,9,0,12,11,32,2022-03-21 11:35:43.126644
44155,0,13,0,17,10,40,2022-03-21 11:35:44.63227
44157,0,10,0,17,10,37,2022-03-21 11:35:46.083933
44163,0,9,0,10,13,32,2022-03-21 11:35:48.009004
44196,1007,2489,188,189,1907,5780,2022-03-21 11:36:04.383847
44200,3321,49212,1466,275,94309,148583,2022-03-21 11:36:04.615191
44203,31282,146135,3146,7682,50865,239110,2022-03-21 11:36:05.579451
44218,430,1247,57,125,662,2521,2022-03-21 11:36:06.519533
44221,637,2479,143,136,2310,5705,2022-03-21 11:36:10.111913
44223,5,258,2,5,19,289,2022-03-21 11:36:14.202989
44225,3,54,4,13,36,110,2022-03-21 11:36:15.96777
44228,32,63,15,43,258,411,2022-03-21 11:36:17.650861
44235,1265,7034,252,391,2038,10980,2022-03-21 11:36:20.878384
44236,125,1147,31,68,858,2229,2022-03-21 11:36:21.05638
44247,0,0,0,0,0,0,2022-03-21 11:36:26.275137
44248,12726,6255,2869,454,16245,38549,2022-03-21 11:36:29.107026
44249,0,0,0,0,0,0,2022-03-21 11:36:29.986265
44256,0,0,0,0,0,0,2022-03-21 11:36:34.234745
44257,0,24,0,0,1,25,2022-03-21 11:36:36.19301
44259,0,0,0,0,0,0,2022-03-21 11:36:37.268867
44266,0,0,0,0,0,0,2022-03-21 11:36:39.638223
44269,0,0,0,0,0,0,2022-03-21 11:36:40.801742
44272,0,0,0,0,0,0,2022-03-21 11:36:42.000079
44276,24135,96286,4327,13666,45079,183493,2022-03-21 11:36:42.658615
44284,0,0,0,0,0,0,2022-03-21 11:36:44.409862
44287,0,0,0,0,0,0,2022-03-21 11:36:45.552484
44389,246,0,17,36,375,674,2022-03-21 11:37:32.658355
44433,0,0,0,0,0,0,2022-03-21 11:37:43.771336
44436,0,0,0,0,0,0,2022-03-21 11:37:46.003717
44437,0,0,0,0,0,0,2022-03-21 11:37:46.913022
44439,0,0,0,0,0,0,2022-03-21 11:37:48.18224
44444,0,0,0,0,0,0,2022-03-21 11:37:49.413265
44447,0,0,0,0,0,0,2022-03-21 11:37:51.202861
44455,0,0,0,0,0,0,2022-03-21 11:37:54.150103
44458,0,0,0,0,0,0,2022-03-21 11:37:55.343545
44472,0,0,0,0,0,0,2022-03-21 11:38:01.335501
44475,0,0,0,0,0,0,2022-03-21 11:38:03.056001
44478,0,0,0,0,0,0,2022-03-21 11:38:05.678549
44481,0,0,0,0,0,0,2022-03-21 11:38:07.369325
44487,0,0,0,0,0,0,2022-03-21 11:38:09.867473
44493,0,0,0,0,0,0,2022-03-21 11:38:13.569093
44498,0,0,0,0,0,0,2022-03-21 11:38:15.914927
44509,0,0,0,0,0,0,2022-03-21 11:38:20.514098
44530,0,0,0,0,0,0,2022-03-21 11:38:29.197946
44570,16,51,10,24,94,195,2022-03-21 11:38:48.531767
44571,16,49,11,22,121,219,2022-03-21 11:38:50.326378
44572,0,0,0,0,0,0,2022-03-21 11:38:51.19442
44573,0,0,0,0,0,0,2022-03-21 11:38:51.999772
44575,0,0,0,0,0,0,2022-03-21 11:38:52.988616
44578,0,0,0,0,0,0,2022-03-21 11:38:54.111166
44586,866,6756,452,165,25365,33604,2022-03-21 11:38:59.198874
44587,4,46,4,12,64,130,2022-03-21 11:39:00.947471
44588,14,123,3,15,111,266,2022-03-21 11:39:02.948474
44590,34,505,42,49,517,1147,2022-03-21 11:39:05.234428
44595,0,0,0,0,0,0,2022-03-21 11:39:08.052132
44702,5,6,4,21,19,55,2022-03-21 11:40:03.327125
44705,0,0,0,0,0,0,2022-03-21 11:40:04.317262
44711,0,0,0,0,0,0,2022-03-21 11:40:06.783019
44714,0,0,0,0,0,0,2022-03-21 11:40:08.450643
44716,0,0,0,0,0,0,2022-03-21 11:40:10.54748
44724,0,0,0,0,0,0,2022-03-21 11:40:12.736529
44727,0,0,0,0,0,0,2022-03-21 11:40:13.970125
44737,0,0,0,0,0,0,2022-03-21 11:40:16.35774
44740,0,0,0,0,0,0,2022-03-21 11:40:17.556686
44753,0,0,0,0,0,0,2022-03-21 11:40:21.197961
44756,0,0,0,0,0,0,2022-03-21 11:40:22.386444
44762,0,0,0,0,0,0,2022-03-21 11:40:24.79823
44765,0,0,0,0,0,0,2022-03-21 11:40:25.972568
44776,4,121,2,12,48,187,2022-03-21 11:40:31.342839
44779,0,0,0,0,0,0,2022-03-21 11:40:33.324486
44822,0,0,0,0,0,0,2022-03-21 11:40:47.565519
44825,0,0,0,0,0,0,2022-03-21 11:40:48.708932
44837,0,0,0,0,0,0,2022-03-21 11:40:52.519167
45543,0,0,0,0,0,0,2022-03-21 11:46:12.549431
45545,0,0,0,0,0,0,2022-03-21 11:46:13.880001
44848,21,83,10,62,168,344,2022-03-21 11:40:56.514807
44865,0,0,0,0,0,0,2022-03-21 11:41:00.76253
44872,0,0,0,0,0,0,2022-03-21 11:41:03.259725
44875,0,0,0,0,0,0,2022-03-21 11:41:04.442157
44878,0,0,0,0,0,0,2022-03-21 11:41:05.564208
44894,0,0,0,0,0,0,2022-03-21 11:41:10.384354
44907,0,0,0,0,0,0,2022-03-21 11:41:13.977397
44909,0,0,0,0,0,0,2022-03-21 11:41:15.371647
44917,0,0,0,0,0,0,2022-03-21 11:41:19.404554
44920,0,0,0,0,0,0,2022-03-21 11:41:21.289878
44923,0,0,0,0,0,0,2022-03-21 11:41:22.433551
44927,0,0,0,0,0,0,2022-03-21 11:41:25.307821
44931,1442,62628,377,130,34098,98675,2022-03-21 11:41:26.779536
44942,9990,117409,2590,9787,38375,178151,2022-03-21 11:41:28.929751
44950,0,0,0,0,0,0,2022-03-21 11:41:31.421141
44958,0,0,0,0,0,0,2022-03-21 11:41:34.404639
45548,0,0,0,0,0,0,2022-03-21 11:46:15.498611
44961,132420,71,11210,33751,123656,301108,2022-03-21 11:41:34.934022
44972,0,0,0,0,0,0,2022-03-21 11:41:37.94707
44984,0,0,0,0,0,0,2022-03-21 11:41:42.341999
44987,0,0,0,0,0,0,2022-03-21 11:41:44.016283
44993,0,0,0,0,0,0,2022-03-21 11:41:46.421871
44999,0,0,0,0,0,0,2022-03-21 11:41:48.791758
45003,0,0,0,0,0,0,2022-03-21 11:41:50.579706
45011,0,0,0,0,0,0,2022-03-21 11:41:54.819329
45017,0,0,0,0,0,0,2022-03-21 11:41:57.324433
45020,0,0,0,0,0,0,2022-03-21 11:41:58.791935
45024,0,0,0,0,0,0,2022-03-21 11:42:01.340846
45025,0,0,0,0,0,0,2022-03-21 11:42:02.596078
45026,0,0,0,0,0,0,2022-03-21 11:42:03.418748
45027,0,0,0,0,0,0,2022-03-21 11:42:05.096563
45028,0,0,0,0,0,0,2022-03-21 11:42:05.931309
45032,0,0,0,0,0,0,2022-03-21 11:42:06.948113
45035,0,0,0,0,0,0,2022-03-21 11:42:08.115947
45038,0,0,0,0,0,0,2022-03-21 11:42:09.316038
45042,12,76,6,25,76,195,2022-03-21 11:42:12.198635
45043,0,0,0,0,0,0,2022-03-21 11:42:13.590109
45044,0,0,0,0,0,0,2022-03-21 11:42:14.399198
45843,0,0,0,0,0,0,2022-03-21 11:48:58.607125
45053,7,229,2,10,38,286,2022-03-21 11:42:21.768204
45055,14191,38655,2001,2803,34114,91764,2022-03-21 11:42:22.002399
45066,0,2,0,6,6,14,2022-03-21 11:42:26.531733
45075,0,0,0,0,0,0,2022-03-21 11:42:29.766255
45077,0,0,0,0,0,0,2022-03-21 11:42:30.942938
45080,0,6,0,10,9,25,2022-03-21 11:42:32.171137
45088,0,0,0,0,0,0,2022-03-21 11:42:35.05973
45091,0,0,0,0,0,0,2022-03-21 11:42:39.183837
45093,0,0,0,0,0,0,2022-03-21 11:42:40.801783
45095,0,0,0,0,0,0,2022-03-21 11:42:41.848985
45097,0,0,0,0,0,0,2022-03-21 11:42:42.870078
45100,0,0,0,0,0,0,2022-03-21 11:42:44.020778
45104,0,0,0,0,0,0,2022-03-21 11:42:45.392001
45113,0,0,0,0,0,0,2022-03-21 11:42:48.875858
45123,0,0,0,0,0,0,2022-03-21 11:42:52.570966
45126,0,0,0,0,0,0,2022-03-21 11:42:53.72825
45132,0,0,0,0,0,0,2022-03-21 11:42:55.066116
45134,0,0,0,0,0,0,2022-03-21 11:42:56.109046
45140,0,0,0,0,0,0,2022-03-21 11:42:58.571358
45445,13,33,8,22,59,135,2022-03-21 11:45:22.925491
45449,0,0,0,0,0,0,2022-03-21 11:45:25.59009
45450,0,0,0,0,0,0,2022-03-21 11:45:26.477394
45451,0,0,0,0,0,0,2022-03-21 11:45:27.549839
45454,0,0,0,0,0,0,2022-03-21 11:45:28.685528
45457,0,0,0,0,0,0,2022-03-21 11:45:29.87889
45460,0,0,0,0,0,0,2022-03-21 11:45:31.053267
45476,0,0,0,0,0,0,2022-03-21 11:45:35.935967
45491,0,0,0,0,0,0,2022-03-21 11:45:44.29744
45493,0,0,0,0,0,0,2022-03-21 11:45:46.062535
45494,0,0,0,0,0,0,2022-03-21 11:45:46.878347
45496,0,0,0,0,0,0,2022-03-21 11:45:47.854668
45499,0,0,0,0,0,0,2022-03-21 11:45:49.032099
45503,0,0,0,0,0,0,2022-03-21 11:45:50.377823
45517,1,12,1,16,21,51,2022-03-21 11:45:56.465884
45519,1,9,1,12,20,43,2022-03-21 11:45:57.650785
45845,0,0,0,0,0,0,2022-03-21 11:48:59.626983
45521,1,9,0,12,19,41,2022-03-21 11:45:58.749646
45524,1,7,0,11,18,37,2022-03-21 11:45:59.984344
45527,1,9,1,15,16,42,2022-03-21 11:46:01.29543
45530,1,10,1,15,16,43,2022-03-21 11:46:04.072411
45531,1,9,1,15,16,42,2022-03-21 11:46:05.037308
45532,2,19,0,10,17,48,2022-03-21 11:46:05.967342
45535,1,14,0,10,19,44,2022-03-21 11:46:07.243293
45540,1,12,1,16,21,51,2022-03-21 11:46:10.29852
45556,1800,19574,361,218,8634,30587,2022-03-21 11:46:21.376074
45557,86,139,26,74,358,683,2022-03-21 11:46:22.941938
45558,73,769,17,47,386,1292,2022-03-21 11:46:23.125521
45560,27657,29,1130,6580,25876,61272,2022-03-21 11:46:25.059068
45562,4,31,4,10,30,79,2022-03-21 11:46:26.15009
45567,308,1634,187,239,2882,5250,2022-03-21 11:46:26.325257
45571,3,49,2,7,42,103,2022-03-21 11:46:30.166033
45572,13113,33117,2672,6140,51681,106723,2022-03-21 11:46:32.970506
45574,65,1909,17,42,373,2406,2022-03-21 11:46:33.162391
45576,82180,331436,4365,2647,109810,530438,2022-03-21 11:46:34.969568
45577,1587,4501,296,362,7736,14482,2022-03-21 11:46:35.40685
45582,4,76,3,7,25,115,2022-03-21 11:46:36.662904
45583,2,55,4,16,38,115,2022-03-21 11:46:37.817218
45585,66,442,43,92,815,1458,2022-03-21 11:46:42.536923
45587,806,3013,166,674,1618,6277,2022-03-21 11:46:45.672
45595,112,1,46,15,95,269,2022-03-21 11:46:47.041867
45596,46,134,19,95,301,595,2022-03-21 11:46:47.228342
45598,1064,29321,307,324,9081,40097,2022-03-21 11:46:51.949297
45600,113,177,26,80,224,620,2022-03-21 11:46:56.945887
45604,1001,20965,312,123,9111,31512,2022-03-21 11:46:59.842034
45607,2,74,1,14,36,127,2022-03-21 11:47:01.877947
45611,6,103,2,28,51,190,2022-03-21 11:47:04.198619
45612,36,61,9,41,111,258,2022-03-21 11:47:06.458916
45613,0,1,0,0,93610,93611,2022-03-21 11:47:06.643682
45856,0,0,0,0,0,0,2022-03-21 11:49:03.409729
45860,0,0,0,0,0,0,2022-03-21 11:49:07.07923
45615,2,122,1,11,22,158,2022-03-21 11:47:08.230849
45618,120,142,43,138,1395,1838,2022-03-21 11:47:09.933429
45619,0,0,0,0,0,0,2022-03-21 11:47:12.770123
45620,115,210,71,26,3419,3841,2022-03-21 11:47:14.965106
45627,3,68,1,6,16,94,2022-03-21 11:47:17.459588
45643,35,320,6,21,253,635,2022-03-21 11:47:19.112453
45645,2,43,5,25,56,131,2022-03-21 11:47:20.380143
45649,0,0,0,0,5854,5854,2022-03-21 11:47:24.174138
45653,0,0,1,1,32298,32300,2022-03-21 11:47:25.606819
45867,0,0,0,0,0,0,2022-03-21 11:49:09.301846
45876,0,0,0,0,0,0,2022-03-21 11:49:14.008228
45654,15,78,8,27,149,277,2022-03-21 11:47:25.947369
45658,266,1796,82,131,1337,3612,2022-03-21 11:47:28.903545
45660,1,6,0,11,20,38,2022-03-21 11:47:30.36214
45661,1,6,0,11,20,38,2022-03-21 11:47:31.36153
45671,0,0,0,0,0,0,2022-03-21 11:47:39.840315
45680,0,0,0,0,0,0,2022-03-21 11:47:42.839807
45682,1,6,1,10,16,34,2022-03-21 11:47:43.948346
45685,0,0,0,0,0,0,2022-03-21 11:47:45.03291
45689,3,13,2,22,18,58,2022-03-21 11:47:46.505393
45691,0,0,0,0,0,0,2022-03-21 11:47:47.552923
45694,0,0,0,0,0,0,2022-03-21 11:47:49.31506
45695,0,0,0,0,0,0,2022-03-21 11:47:50.159727
45697,1,8,0,11,19,39,2022-03-21 11:47:51.300876
45699,1,6,0,10,19,36,2022-03-21 11:47:52.41512
45705,1,8,0,13,19,41,2022-03-21 11:47:56.447501
45706,1,5,0,12,19,37,2022-03-21 11:47:57.931214
45708,0,0,0,0,0,0,2022-03-21 11:47:59.609909
45721,0,0,0,0,0,0,2022-03-21 11:48:04.412205
45724,0,0,0,0,0,0,2022-03-21 11:48:05.624391
45727,0,0,0,0,0,0,2022-03-21 11:48:06.841186
45737,0,0,0,0,0,0,2022-03-21 11:48:09.31311
45739,0,0,0,0,0,0,2022-03-21 11:48:10.335401
45746,0,0,0,0,0,0,2022-03-21 11:48:12.822607
45753,1406,32565,305,284,7848,42408,2022-03-21 11:48:14.618453
45762,1,6,0,11,19,37,2022-03-21 11:48:17.718677
45766,1,5,0,11,18,35,2022-03-21 11:48:20.044889
45770,1,4,0,13,18,36,2022-03-21 11:48:21.304545
45772,0,0,0,0,0,0,2022-03-21 11:48:22.362814
45782,782,1851,179,220,1480,4512,2022-03-21 11:48:24.189668
45783,2721,2,207,704,5608,9242,2022-03-21 11:48:26.597934
45790,1,6,0,10,16,33,2022-03-21 11:48:30.933645
45792,0,0,0,0,0,0,2022-03-21 11:48:31.96712
45805,0,0,0,0,0,0,2022-03-21 11:48:36.764413
45809,0,0,0,0,0,0,2022-03-21 11:48:39.826307
45811,0,0,0,0,0,0,2022-03-21 11:48:41.718643
45816,2,5,0,11,16,34,2022-03-21 11:48:44.116083
45827,0,0,0,0,0,0,2022-03-21 11:48:51.529049
45828,0,0,0,0,0,0,2022-03-21 11:48:52.953373
45838,0,0,0,0,0,0,2022-03-21 11:48:56.079131
46003,48,336,34,77,645,1140,2022-03-21 11:50:05.131224
46004,57,358,38,78,736,1267,2022-03-21 11:50:07.094472
46005,0,0,0,0,0,0,2022-03-21 11:50:07.903548
46006,0,0,0,0,0,0,2022-03-21 11:50:09.304494
46008,0,0,0,0,0,0,2022-03-21 11:50:10.136928
46009,0,0,0,0,0,0,2022-03-21 11:50:11.244199
46014,0,0,0,0,0,0,2022-03-21 11:50:16.364832
46020,0,0,0,0,0,0,2022-03-21 11:50:22.415309
46023,0,0,0,0,0,0,2022-03-21 11:50:24.301884
46025,0,0,0,0,0,0,2022-03-21 11:50:26.141553
46032,0,0,0,0,0,0,2022-03-21 11:50:29.48613
46033,0,0,0,0,0,0,2022-03-21 11:50:30.745841
46036,0,0,0,0,0,0,2022-03-21 11:50:31.895586
46046,0,0,0,0,0,0,2022-03-21 11:50:34.397619
46049,0,0,0,0,0,0,2022-03-21 11:50:35.518144
46065,0,0,0,0,0,0,2022-03-21 11:50:43.21802
46068,0,0,0,0,0,0,2022-03-21 11:50:46.363398
46071,0,0,0,0,0,0,2022-03-21 11:50:47.455563
46093,28282,30061,6971,9422,64027,138763,2022-03-21 11:50:53.59798
46095,55789,182557,11890,8494,138261,396991,2022-03-21 11:50:54.279127
46102,30205,141373,6288,3837,96019,277722,2022-03-21 11:50:55.510719
46108,0,0,0,0,0,0,2022-03-21 11:50:57.322396
46110,0,0,0,0,0,0,2022-03-21 11:50:58.503621
46118,6471,10116,2388,5726,17522,42223,2022-03-21 11:51:00.018228
46127,0,0,0,0,0,0,2022-03-21 11:51:02.028961
46131,0,0,0,0,0,0,2022-03-21 11:51:06.49754
46132,0,0,0,0,0,0,2022-03-21 11:51:07.526575
46133,0,0,0,0,0,0,2022-03-21 11:51:08.526529
46134,0,0,0,0,0,0,2022-03-21 11:51:09.32844
46147,0,0,0,0,0,0,2022-03-21 11:51:13.93965
46150,1,8,0,13,18,40,2022-03-21 11:51:15.240612
46160,0,0,0,0,0,0,2022-03-21 11:51:20.211182
46163,0,0,0,0,0,0,2022-03-21 11:51:22.574944
46171,472,1,116,54,728,1371,2022-03-21 11:51:25.327943
46256,1,4,0,11,20,36,2022-03-21 11:51:56.237022
46263,0,0,0,0,0,0,2022-03-21 11:51:58.484486
46277,1,6,0,12,19,38,2022-03-21 11:52:03.36436
46284,0,0,0,0,0,0,2022-03-21 11:52:05.74162
46287,0,0,0,0,0,0,2022-03-21 11:52:06.898545
46299,1,9,0,12,22,44,2022-03-21 11:52:10.532272
46302,0,0,0,0,0,0,2022-03-21 11:52:11.741176
46305,1,5,0,13,19,38,2022-03-21 11:52:12.939274
46308,0,0,0,0,0,0,2022-03-21 11:52:14.119446
46311,0,0,0,0,0,0,2022-03-21 11:52:15.393205
46316,1,9,0,11,20,41,2022-03-21 11:52:17.747644
46322,0,0,0,0,0,0,2022-03-21 11:52:20.061294
46325,0,0,0,0,0,0,2022-03-21 11:52:21.392628
46334,0,0,0,0,0,0,2022-03-21 11:52:24.871308
46338,0,0,0,0,0,0,2022-03-21 11:52:26.065227
46344,0,0,0,0,0,0,2022-03-21 11:52:28.703026
46381,248,4,28,86,591,957,2022-03-21 11:52:49.556172
46390,0,0,0,0,0,0,2022-03-21 11:52:51.369162
46393,0,0,0,0,0,0,2022-03-21 11:52:52.582221
46405,0,0,0,0,0,0,2022-03-21 11:52:56.121723
46420,1195,23533,619,246,26754,52347,2022-03-21 11:53:00.215353
46422,0,0,0,0,4250,4250,2022-03-21 11:53:02.674426
46430,0,0,0,0,0,0,2022-03-21 11:53:13.799993
46432,0,0,0,0,0,0,2022-03-21 11:53:15.284098
46438,0,0,0,0,0,0,2022-03-21 11:53:17.917109
46440,0,0,0,0,0,0,2022-03-21 11:53:18.900481
46449,0,0,0,0,0,0,2022-03-21 11:53:23.085386
46457,0,0,0,0,0,0,2022-03-21 11:53:26.09654
46460,0,0,0,0,0,0,2022-03-21 11:53:27.351026
46462,0,0,0,0,0,0,2022-03-21 11:53:28.727155
46466,0,0,0,0,0,0,2022-03-21 11:53:32.706408
46467,0,0,0,0,0,0,2022-03-21 11:53:33.537392
46476,0,0,0,0,0,0,2022-03-21 11:53:36.974884
46482,0,0,0,0,0,0,2022-03-21 11:53:39.461227
46484,0,0,0,0,0,0,2022-03-21 11:53:40.501098
46491,37,1261,28,53,727,2106,2022-03-21 11:53:41.165536
46494,0,0,0,0,0,0,2022-03-21 11:53:45.152985
46495,0,0,0,0,0,0,2022-03-21 11:53:45.982352
46496,0,0,0,0,0,0,2022-03-21 11:53:46.879846
46498,0,0,0,0,0,0,2022-03-21 11:53:48.978691
46500,0,0,0,0,0,0,2022-03-21 11:53:50.695582
46505,0,0,0,0,0,0,2022-03-21 11:53:53.817071
46508,0,0,0,0,0,0,2022-03-21 11:53:54.996346
46511,0,0,0,0,0,0,2022-03-21 11:53:56.702091
46526,0,0,0,0,0,0,2022-03-21 11:54:02.724831
46528,0,0,0,0,0,0,2022-03-21 11:54:04.550176
46531,0,0,0,0,0,0,2022-03-21 11:54:05.724465
46536,0,0,0,0,0,0,2022-03-21 11:54:07.008961
46539,0,0,0,0,0,0,2022-03-21 11:54:08.247385
46542,0,0,0,0,0,0,2022-03-21 11:54:09.368147
46545,0,0,0,0,0,0,2022-03-21 11:54:10.615434
46569,0,0,0,0,41601,41601,2022-03-21 11:54:18.271207
46571,0,0,0,0,0,0,2022-03-21 11:54:20.368811
46576,0,0,0,0,0,0,2022-03-21 11:54:22.54203
46583,0,0,0,0,0,0,2022-03-21 11:54:25.514611
46595,0,0,0,0,0,0,2022-03-21 11:54:31.29437
46596,0,0,0,0,0,0,2022-03-21 11:54:32.218428
46602,0,0,0,0,0,0,2022-03-21 11:54:34.537756
46617,0,0,0,0,0,0,2022-03-21 11:54:36.929744
46622,0,0,0,0,0,0,2022-03-21 11:54:38.211903
46625,0,0,0,0,0,0,2022-03-21 11:54:39.382424
46630,67,42,30,52,282,473,2022-03-21 11:54:41.764234
46633,0,0,0,0,0,0,2022-03-21 11:54:42.580854
46640,0,0,0,0,0,0,2022-03-21 11:54:47.129489
46642,0,0,0,0,0,0,2022-03-21 11:54:49.119702
46652,92,0,20,104,385,601,2022-03-21 11:54:54.049896
46659,0,0,0,0,0,0,2022-03-21 11:54:56.362007
46661,0,0,0,0,0,0,2022-03-21 11:54:57.539911
46663,0,0,0,0,0,0,2022-03-21 11:54:58.613043
46678,0,0,0,0,0,0,2022-03-21 11:55:03.713742
46681,0,0,0,0,0,0,2022-03-21 11:55:05.770716
46684,0,0,0,0,0,0,2022-03-21 11:55:07.090834
46692,0,0,0,0,0,0,2022-03-21 11:55:09.934553
46697,0,0,0,0,0,0,2022-03-21 11:55:12.234475
46698,1,5,0,11,17,34,2022-03-21 11:55:13.184846
46700,0,0,0,0,0,0,2022-03-21 11:55:14.160058
46704,1,4,0,13,19,37,2022-03-21 11:55:15.599544
46706,1,14,1,17,20,53,2022-03-21 11:55:16.785906
46721,1,8,0,13,18,40,2022-03-21 11:55:23.969277
46724,0,0,0,0,0,0,2022-03-21 11:55:25.178206
46727,1,4,0,10,18,33,2022-03-21 11:55:27.710007
46746,0,0,0,0,0,0,2022-03-21 11:55:32.440093
46748,0,0,0,0,0,0,2022-03-21 11:55:34.068148
46749,0,0,0,0,0,0,2022-03-21 11:55:35.475237
46754,0,0,0,0,0,0,2022-03-21 11:55:38.968953
46755,0,0,0,0,0,0,2022-03-21 11:55:40.422024
46756,0,0,0,0,0,0,2022-03-21 11:55:41.267596
46757,0,0,0,0,0,0,2022-03-21 11:55:42.175023
46758,0,0,0,0,0,0,2022-03-21 11:55:43.05703
46761,0,0,0,0,0,0,2022-03-21 11:55:44.273428
46765,0,0,0,0,0,0,2022-03-21 11:55:47.776527
46766,0,0,0,0,0,0,2022-03-21 11:55:48.622932
46770,0,0,0,0,0,0,2022-03-21 11:55:52.651664
46778,0,0,0,0,0,0,2022-03-21 11:55:59.009217
46792,0,0,0,0,0,0,2022-03-21 11:56:03.474921
46795,0,0,0,0,0,0,2022-03-21 11:56:04.646411
46798,0,0,0,0,0,0,2022-03-21 11:56:05.870274
46805,0,0,0,0,0,0,2022-03-21 11:56:10.476503
46806,0,0,0,0,0,0,2022-03-21 11:56:11.34561
46807,0,0,0,0,0,0,2022-03-21 11:56:12.217593
46808,0,0,0,0,186,186,2022-03-21 11:56:13.666535
46971,283,6127,89,61,1777,8337,2022-03-21 11:57:17.642542
46992,0,0,0,0,0,0,2022-03-21 11:57:22.228106
46996,0,0,0,0,0,0,2022-03-21 11:57:25.126068
46999,0,0,0,0,0,0,2022-03-21 11:57:26.936182
47000,0,0,0,0,0,0,2022-03-21 11:57:27.783711
47006,0,0,0,0,0,0,2022-03-21 11:57:29.913152
47010,0,0,0,0,0,0,2022-03-21 11:57:31.257733
47014,0,0,0,0,0,0,2022-03-21 11:57:33.841058
47016,0,0,0,0,0,0,2022-03-21 11:57:36.103682
47018,0,0,0,0,0,0,2022-03-21 11:57:37.144402
47021,0,0,0,0,0,0,2022-03-21 11:57:38.346463
47034,0,0,0,0,0,0,2022-03-21 11:57:43.253389
47044,257,564,30,68,335,1254,2022-03-21 11:57:49.760349
47048,0,0,0,0,0,0,2022-03-21 11:57:53.832695
47050,0,0,0,0,0,0,2022-03-21 11:57:55.58889
47065,0,0,0,0,0,0,2022-03-21 11:58:10.328518
47066,0,0,0,0,0,0,2022-03-21 11:58:11.136424
47069,0,0,0,0,0,0,2022-03-21 11:58:12.254854
47159,80966,12,1909,3270,53484,139641,2022-03-21 11:58:51.451408
47161,72625,31,1564,6615,36730,117565,2022-03-21 11:58:54.74604
47162,4,0,0,0,17341,17345,2022-03-21 11:58:56.227543
47163,2,1,0,0,19907,19910,2022-03-21 11:58:57.852139
47164,0,0,0,0,100020,100020,2022-03-21 11:58:58.284647
47169,0,0,0,0,0,0,2022-03-21 11:59:00.795889
47175,0,0,0,0,0,0,2022-03-21 11:59:03.260324
47178,0,0,0,0,0,0,2022-03-21 11:59:05.115737
47182,0,0,0,0,0,0,2022-03-21 11:59:06.327067
47185,0,0,0,0,0,0,2022-03-21 11:59:07.764588
47210,0,0,0,0,0,0,2022-03-21 11:59:15.890987
47230,0,0,0,0,0,0,2022-03-21 11:59:22.152008
47239,0,0,0,0,0,0,2022-03-21 11:59:25.743505
47250,12135,21395,3811,13291,33961,84593,2022-03-21 11:59:29.076039
47257,27409,63740,5683,9940,61631,168403,2022-03-21 11:59:29.586992
47267,1,4,0,13,16,34,2022-03-21 11:59:31.596062
47279,0,0,0,0,0,0,2022-03-21 11:59:34.078826
47281,0,0,0,0,0,0,2022-03-21 11:59:35.275416
47286,0,0,0,0,0,0,2022-03-21 11:59:37.4508
47290,0,0,0,0,0,0,2022-03-21 11:59:38.760259
47293,0,0,0,0,0,0,2022-03-21 11:59:39.909223
47315,0,0,0,0,0,0,2022-03-21 11:59:46.942675
47316,0,0,0,0,0,0,2022-03-21 11:59:47.926013
47317,0,0,0,0,0,0,2022-03-21 11:59:48.727306
47327,0,0,0,0,0,0,2022-03-21 11:59:53.77612
47337,0,0,0,0,0,0,2022-03-21 12:00:00.389539
47338,0,0,0,0,0,0,2022-03-21 12:00:01.809087
47339,0,0,0,0,0,0,2022-03-21 12:00:02.774559
47340,0,0,0,0,0,0,2022-03-21 12:00:04.189135
47343,0,0,0,0,0,0,2022-03-21 12:00:07.439054
47344,0,0,0,0,0,0,2022-03-21 12:00:08.336755
47349,0,0,0,0,0,0,2022-03-21 12:00:11.283997
47398,920,24639,279,285,11235,37358,2022-03-21 12:00:36.818594
47402,79,2792,21,28,778,3698,2022-03-21 12:00:42.691987
47403,78,111,33,61,631,914,2022-03-21 12:00:44.676732
47405,1422,1,120,173,2411,4127,2022-03-21 12:00:44.858903
47410,104,1707,47,63,1284,3205,2022-03-21 12:00:50.805806
47413,271,1467,81,68,3224,5111,2022-03-21 12:00:53.587858
47425,9,44,3,25,59,140,2022-03-21 12:00:57.164876
47426,4,86,5,24,52,171,2022-03-21 12:00:58.382606
47429,0,0,0,0,0,0,2022-03-21 12:00:59.687868
47433,0,0,0,0,0,0,2022-03-21 12:01:03.482414
47447,0,0,0,0,0,0,2022-03-21 12:01:09.554506
47448,0,0,0,0,0,0,2022-03-21 12:01:10.501812
47452,0,0,0,0,0,0,2022-03-21 12:01:12.449461
47463,0,0,0,0,0,0,2022-03-21 12:01:16.39827
47466,0,0,0,0,0,0,2022-03-21 12:01:18.50548
47469,0,0,0,0,0,0,2022-03-21 12:01:20.173876
47473,0,0,0,0,0,0,2022-03-21 12:01:22.056792
47477,0,0,0,0,0,0,2022-03-21 12:01:25.884492
47497,0,0,0,0,0,0,2022-03-21 12:01:34.229518
47499,0,0,0,0,0,0,2022-03-21 12:01:35.218269
47503,0,0,0,0,0,0,2022-03-21 12:01:36.583381
47506,0,0,0,0,0,0,2022-03-21 12:01:37.794013
47514,0,0,0,0,0,0,2022-03-21 12:01:41.394496
47521,0,0,0,0,0,0,2022-03-21 12:01:46.087788
47524,0,0,0,0,0,0,2022-03-21 12:01:47.844913
47526,0,0,0,0,0,0,2022-03-21 12:01:49.670265
47530,0,0,0,0,0,0,2022-03-21 12:01:50.92698
47534,0,0,0,0,0,0,2022-03-21 12:01:53.659597
47548,0,0,0,0,0,0,2022-03-21 12:01:57.392117
47550,0,0,0,0,0,0,2022-03-21 12:01:59.540952
47552,0,0,0,0,0,0,2022-03-21 12:02:00.576102
47554,0,0,0,0,0,0,2022-03-21 12:02:01.718411
47591,3938,13959,807,1606,14095,34405,2022-03-21 12:02:16.753442
47603,0,0,0,0,0,0,2022-03-21 12:02:21.544895
47605,0,0,0,0,0,0,2022-03-21 12:02:23.538242
47612,0,0,0,0,0,0,2022-03-21 12:02:27.012488
47616,2157,28433,427,1569,10270,42856,2022-03-21 12:02:27.559565
47618,24,165,9,32,145,375,2022-03-21 12:02:31.320955
47620,1,8,1,5,9,24,2022-03-21 12:02:32.287582
47621,1,7,0,6,6,20,2022-03-21 12:02:33.483986
47623,61,0,19,97,569,746,2022-03-21 12:02:35.794705
47624,0,4,1,4,7,16,2022-03-21 12:02:36.736653
47626,0,6,0,6,6,18,2022-03-21 12:02:37.63361
47635,14,418,12,14,94,552,2022-03-21 12:02:44.244389
47639,3443,3389,1074,4089,12292,24287,2022-03-21 12:02:48.924788
47640,0,0,0,0,0,0,2022-03-21 12:02:49.755146
47642,0,0,0,0,0,0,2022-03-21 12:02:51.026767
47654,0,0,0,0,0,0,2022-03-21 12:02:56.298358
47666,0,0,0,0,0,0,2022-03-21 12:03:01.868085
47674,0,0,0,0,0,0,2022-03-21 12:03:04.203176
47677,0,0,0,0,0,0,2022-03-21 12:03:05.418729
47688,0,0,0,0,0,0,2022-03-21 12:03:10.348383
47695,0,0,0,0,0,0,2022-03-21 12:03:12.639126
47701,0,0,0,0,0,0,2022-03-21 12:03:15.151076
47706,0,0,0,0,0,0,2022-03-21 12:03:17.420496
47714,0,0,0,0,0,0,2022-03-21 12:03:21.218615
47774,0,4,0,11,12,27,2022-03-21 12:03:44.02991
47776,0,6,0,9,12,27,2022-03-21 12:03:45.097807
47787,2,0,2,10,16,30,2022-03-21 12:03:46.406632
47790,56577,200851,4133,7764,71656,340981,2022-03-21 12:03:46.884877
47806,0,0,0,0,0,0,2022-03-21 12:03:49.969819
47808,0,0,0,0,0,0,2022-03-21 12:03:51.054823
47811,75,575,40,64,526,1280,2022-03-21 12:03:53.533683
47812,0,0,0,0,0,0,2022-03-21 12:03:54.433511
47814,1,3,1,8,6,19,2022-03-21 12:03:56.219369
47815,0,3,1,9,5,18,2022-03-21 12:03:57.171888
47820,0,0,0,0,0,0,2022-03-21 12:03:58.359039
47828,0,0,0,0,0,0,2022-03-21 12:04:00.737295
47912,1,60,1,4,10,76,2022-03-21 12:04:32.691447
47917,0,0,0,0,5244,5244,2022-03-21 12:04:34.122252
47924,0,0,0,0,0,0,2022-03-21 12:04:35.652794
47926,0,0,0,0,0,0,2022-03-21 12:04:36.724267
47929,0,0,0,0,0,0,2022-03-21 12:04:37.938322
47938,0,0,0,0,0,0,2022-03-21 12:04:43.980775
47939,0,0,0,0,0,0,2022-03-21 12:04:45.518228
47942,0,0,0,0,0,0,2022-03-21 12:04:49.506673
47943,0,0,0,0,0,0,2022-03-21 12:04:50.431983
47944,0,4,0,9,12,25,2022-03-21 12:04:51.349902
47946,0,5,0,10,12,27,2022-03-21 12:04:52.57771
47948,0,6,0,11,12,29,2022-03-21 12:04:54.234237
47949,0,5,0,11,12,28,2022-03-21 12:04:55.183557
47954,1,5,0,10,15,31,2022-03-21 12:04:58.383827
47961,0,0,0,0,0,0,2022-03-21 12:05:01.941188
47970,0,0,0,0,0,0,2022-03-21 12:05:04.457269
47974,0,0,0,0,0,0,2022-03-21 12:05:06.796101
47977,0,0,0,0,0,0,2022-03-21 12:05:07.922205
47982,1,6,0,11,20,38,2022-03-21 12:05:10.988144
47984,0,0,0,0,0,0,2022-03-21 12:05:13.37265
47985,0,0,0,0,0,0,2022-03-21 12:05:14.244863
47987,0,3,0,11,13,27,2022-03-21 12:05:15.602915
47997,0,5,2,8,17,32,2022-03-21 12:05:18.759152
48002,0,5,1,12,16,34,2022-03-21 12:05:20.041116
48011,0,5,0,9,13,27,2022-03-21 12:05:22.470288
48013,1,4,0,11,20,36,2022-03-21 12:05:23.583117
48016,1,7,0,12,18,38,2022-03-21 12:05:24.856015
48019,0,0,0,0,0,0,2022-03-21 12:05:26.083787
48022,1,6,0,12,19,38,2022-03-21 12:05:27.317589
48028,0,5,0,12,14,31,2022-03-21 12:05:30.833901
48029,0,6,0,11,13,30,2022-03-21 12:05:32.17137
48034,0,7,0,10,12,29,2022-03-21 12:05:34.495006
48037,0,5,0,10,13,28,2022-03-21 12:05:35.587193
48046,0,5,0,10,12,27,2022-03-21 12:05:38.000495
48049,0,4,0,11,14,29,2022-03-21 12:05:39.356342
48051,0,5,0,12,13,30,2022-03-21 12:05:41.015654
48062,1,8,0,14,13,36,2022-03-21 12:05:45.355723
48064,0,0,0,0,0,0,2022-03-21 12:05:46.364393
48067,2,7,0,12,11,32,2022-03-21 12:05:47.577792
48070,0,5,0,9,14,28,2022-03-21 12:05:48.826089
48076,0,8,0,14,16,38,2022-03-21 12:05:51.801397
48077,1,5,0,13,16,35,2022-03-21 12:05:52.781029
48079,0,5,1,13,13,32,2022-03-21 12:05:54.828614
48083,0,6,0,12,13,31,2022-03-21 12:05:57.730104
48084,0,8,0,10,12,30,2022-03-21 12:05:58.644283
48088,0,4,0,10,13,27,2022-03-21 12:06:02.042727
48091,0,5,0,11,13,29,2022-03-21 12:06:03.26488
48102,1,7,0,13,15,36,2022-03-21 12:06:06.891717
48107,1,5,0,12,18,36,2022-03-21 12:06:09.246534
48111,2,4,0,9,15,30,2022-03-21 12:06:10.476951
48114,2,7,2,15,18,44,2022-03-21 12:06:11.739998
48116,21,0,3,11,61,96,2022-03-21 12:06:13.595651
48117,1,13,0,9,14,37,2022-03-21 12:06:15.080925
48120,2,10,1,21,23,57,2022-03-21 12:06:17.047678
48123,1,26,3,27,109,166,2022-03-21 12:06:19.385587
48125,10,654,2,29,107,802,2022-03-21 12:06:19.584553
48126,3,21,2,23,32,81,2022-03-21 12:06:22.786088
48129,2,11,1,20,28,62,2022-03-21 12:06:24.942988
48130,3,13,1,23,32,72,2022-03-21 12:06:26.124995
48171,562,237,311,38,21268,22416,2022-03-21 12:06:43.722618
48172,0,0,0,0,0,0,2022-03-21 12:06:45.176678
48173,0,0,0,0,0,0,2022-03-21 12:06:46.038033
48174,0,0,0,0,0,0,2022-03-21 12:06:47.01344
48176,0,0,0,0,0,0,2022-03-21 12:06:48.36425
48180,0,0,0,0,0,0,2022-03-21 12:06:52.845095
48182,0,0,0,0,0,0,2022-03-21 12:06:55.23751
48183,0,0,0,0,0,0,2022-03-21 12:06:56.543387
48188,0,0,0,0,0,0,2022-03-21 12:06:59.339786
48189,0,0,0,0,0,0,2022-03-21 12:07:00.219211
48190,0,0,0,0,0,0,2022-03-21 12:07:01.022317
48191,0,0,0,0,0,0,2022-03-21 12:07:01.839609
48193,0,0,0,0,0,0,2022-03-21 12:07:04.010942
48197,0,0,0,0,0,0,2022-03-21 12:07:06.036171
48201,0,0,0,0,0,0,2022-03-21 12:07:07.21148
48205,0,0,0,0,0,0,2022-03-21 12:07:08.557996
48208,1,11,1,18,22,53,2022-03-21 12:07:09.901369
48213,0,0,0,0,0,0,2022-03-21 12:07:13.778681
48214,0,0,0,0,0,0,2022-03-21 12:07:14.61738
48216,0,0,0,0,0,0,2022-03-21 12:07:16.576011
48217,0,0,0,0,0,0,2022-03-21 12:07:17.417702
48218,0,0,0,0,0,0,2022-03-21 12:07:18.187184
48224,1,5,1,13,17,37,2022-03-21 12:07:20.571061
48231,3,25,1,19,33,81,2022-03-21 12:07:23.121353
48240,0,0,0,0,0,0,2022-03-21 12:07:26.508414
48244,0,0,0,0,0,0,2022-03-21 12:07:27.70092
48247,0,0,0,0,0,0,2022-03-21 12:07:28.841371
48253,0,0,0,0,0,0,2022-03-21 12:07:31.810931
48254,1,7,0,14,23,45,2022-03-21 12:07:33.301744
48256,2,13,3,16,29,63,2022-03-21 12:07:35.414806
48257,1,10,1,20,23,55,2022-03-21 12:07:36.408529
48260,2,8,1,18,25,54,2022-03-21 12:07:38.692706
48263,2,13,3,23,30,71,2022-03-21 12:07:39.95297
48265,0,0,0,0,0,0,2022-03-21 12:07:40.963126
48268,0,0,0,0,0,0,2022-03-21 12:07:42.184682
48275,0,0,0,0,0,0,2022-03-21 12:07:45.951816
48280,0,0,0,0,0,0,2022-03-21 12:07:48.208443
48290,5,17,4,27,51,104,2022-03-21 12:07:51.574945
48292,1,16,1,13,23,54,2022-03-21 12:07:52.600097
48294,0,0,0,0,0,0,2022-03-21 12:07:54.338103
48296,0,0,0,0,0,0,2022-03-21 12:07:55.342225
48305,11,360,5,24,127,527,2022-03-21 12:08:00.336926
48317,1,11,1,12,19,44,2022-03-21 12:08:05.149845
48320,2,11,4,12,26,55,2022-03-21 12:08:06.326058
48325,1,9,1,12,21,44,2022-03-21 12:08:11.432755
48329,0,0,0,0,0,0,2022-03-21 12:08:14.518814
48333,5,10,4,18,23,60,2022-03-21 12:08:15.784491
48338,1,13,1,15,24,54,2022-03-21 12:08:18.229349
48341,1,12,2,17,22,54,2022-03-21 12:08:19.558851
48343,12,33,6,35,58,144,2022-03-21 12:08:21.689191
48344,1,11,2,24,22,60,2022-03-21 12:08:22.7388
48347,5,25,2,16,72,120,2022-03-21 12:08:25.895633
48352,21,48,15,30,694,808,2022-03-21 12:08:31.165919
48363,1,0,0,0,5894,5895,2022-03-21 12:08:33.935443
48365,325,0,120,242,779,1466,2022-03-21 12:08:34.113345
48369,105,399,11,50,168,733,2022-03-21 12:08:37.368295
48374,50,109,44,39,236,478,2022-03-21 12:08:38.901611
48375,1468,21142,333,155,36327,59425,2022-03-21 12:08:41.683323
48377,7,467,8,12,57,551,2022-03-21 12:08:41.85471
48391,289,2,83,281,655,1310,2022-03-21 12:08:45.672253
48405,280,84,105,7,15203,15679,2022-03-21 12:08:46.730416
48415,2,0,0,1,32587,32590,2022-03-21 12:08:48.039063
48425,0,0,0,0,926,926,2022-03-21 12:08:50.704869
48426,0,0,0,0,1838,1838,2022-03-21 12:08:53.271616
48430,0,0,0,0,0,0,2022-03-21 12:08:55.163936
48432,9,225,2,21,65,322,2022-03-21 12:08:57.087325
48436,0,0,0,0,0,0,2022-03-21 12:08:58.498529
48438,7893,7,1779,155,34754,44588,2022-03-21 12:08:58.868422
48439,8,503,3,7,51,572,2022-03-21 12:09:00.973824
48442,0,0,0,0,1371,1371,2022-03-21 12:09:06.205146
48453,3673,19542,683,1030,12714,37642,2022-03-21 12:09:07.17889
48455,706,12,100,132,862,1812,2022-03-21 12:09:07.441297
48470,2843,4554,702,3442,9553,21094,2022-03-21 12:09:08.072781
48490,0,0,0,0,0,0,2022-03-21 12:09:10.023623
48492,18016,8962,3801,13683,29751,74213,2022-03-21 12:09:14.336162
48505,12205,6,693,670,16848,30422,2022-03-21 12:09:22.104221
48512,32,123,10,22,229,416,2022-03-21 12:09:25.433263
48517,100,0,20,73,135,328,2022-03-21 12:09:26.453904
48529,0,0,0,0,0,0,2022-03-21 12:09:27.237188
48537,422,907,99,68,1810,3306,2022-03-21 12:09:28.487165
48541,0,0,0,0,0,0,2022-03-21 12:09:33.237899
48542,0,0,0,0,7131,7131,2022-03-21 12:09:36.052502
48543,164,69,25,45,181,484,2022-03-21 12:09:37.458595
48544,23,0,10,31,54,118,2022-03-21 12:09:38.51372
48548,4,2,2,0,92462,92470,2022-03-21 12:09:39.159609
48549,4,0,2,0,83570,83576,2022-03-21 12:09:39.362568
48552,0,0,0,0,0,0,2022-03-21 12:09:39.535733
48561,4230,7942,1810,125,288859,302966,2022-03-21 12:09:41.627165
48575,18,103,5,27,126,279,2022-03-21 12:09:42.881933
48615,290,1263,168,147,1710,3578,2022-03-21 12:09:46.432749
48616,40,154,22,38,323,577,2022-03-21 12:09:50.585516
48617,4,230,4,15,63,316,2022-03-21 12:09:51.923308
48624,0,0,0,0,7959,7959,2022-03-21 12:09:52.093667
48627,56,1187,39,36,2026,3344,2022-03-21 12:09:52.266257
48628,11,28,3,30,66,138,2022-03-21 12:09:54.044876
48633,0,0,0,0,4692,4692,2022-03-21 12:09:59.971089
48634,0,0,0,0,0,0,2022-03-21 12:10:01.375934
48641,8922,7264,1364,1454,12371,31375,2022-03-21 12:10:03.209936
48643,1,0,0,0,21718,21719,2022-03-21 12:10:03.46142
48644,2198,4686,467,1869,7349,16569,2022-03-21 12:10:05.230429
48645,37,37,17,29,182,302,2022-03-21 12:10:08.550226
48646,3,27,4,17,39,90,2022-03-21 12:10:08.729918
48649,0,0,0,0,3541,3541,2022-03-21 12:10:08.989983
48653,317,9125,42,58,927,10469,2022-03-21 12:10:12.468826
48661,165625,66,21717,994,114745,303147,2022-03-21 12:10:15.063476
48672,39,240,40,45,311,675,2022-03-21 12:10:16.80767
48673,3,52,1,3,17,76,2022-03-21 12:10:17.9248
48675,9,0,0,1,60796,60806,2022-03-21 12:10:22.160758
48678,90,229,90,45,2917,3371,2022-03-21 12:10:24.99689
48680,2365,2710,481,4579,9801,19936,2022-03-21 12:10:25.179915
48684,289,549,34,67,467,1406,2022-03-21 12:10:27.124661
48694,166,220,53,39,758,1236,2022-03-21 12:10:29.035351
48701,0,0,0,0,337,337,2022-03-21 12:10:32.445767
48703,4,18,1,22,95,140,2022-03-21 12:10:36.948592
48707,5530,53324,858,457,30075,90244,2022-03-21 12:10:37.156926
48708,0,0,0,0,507,507,2022-03-21 12:10:41.093417
48709,3,60,3,6,19,91,2022-03-21 12:10:42.701121
48727,1312,3758,372,181,3974,9597,2022-03-21 12:10:45.316675
48735,1255,4353,304,217,1487,7616,2022-03-21 12:10:52.084238
48736,337565,286,4702,4969,132965,480487,2022-03-21 12:10:52.29542
48742,1,0,0,0,9136,9137,2022-03-21 12:10:55.509718
48749,6,35,3,20,49,113,2022-03-21 12:10:57.738797
48750,10,35,7,20,49,121,2022-03-21 12:10:59.041134
48753,46086,45270,9672,15873,74418,191319,2022-03-21 12:11:00.443547
48760,3,0,0,1,38828,38832,2022-03-21 12:11:03.894911
48761,44577,84973,4522,11710,57627,203409,2022-03-21 12:11:04.39172
48763,2,13,3,24,27,69,2022-03-21 12:11:07.40156
48765,0,0,0,0,0,0,2022-03-21 12:11:08.992507
48789,5,22,1,44,42,114,2022-03-21 12:11:13.751505
48800,0,0,0,0,0,0,2022-03-21 12:11:16.216717
48813,0,0,0,0,0,0,2022-03-21 12:11:18.256825
48830,0,0,0,1,18321,18322,2022-03-21 12:11:19.957927
48853,0,0,0,0,0,0,2022-03-21 12:11:23.006424
48857,0,0,0,0,4146,4146,2022-03-21 12:11:25.12072
48858,4002,6971,774,2262,15176,29185,2022-03-21 12:11:25.589232
48866,37,51,7,34,160,289,2022-03-21 12:11:29.071324
48867,0,0,0,0,294,294,2022-03-21 12:11:30.648337
48869,14,435,5,8,189,651,2022-03-21 12:11:32.515033
48872,4,62,1,18,34,119,2022-03-21 12:11:36.400929
48873,25,24,9,38,107,203,2022-03-21 12:11:37.557689
48874,0,0,0,0,133,133,2022-03-21 12:11:38.875542
48875,63,44,27,28,1212,1374,2022-03-21 12:11:40.951021
48876,13,1268,6,12,127,1426,2022-03-21 12:11:43.10723
48877,20,232,12,37,157,458,2022-03-21 12:11:43.549249
48882,2,52,1,3,12,70,2022-03-21 12:11:47.169657
48890,22,370,16,30,235,673,2022-03-21 12:11:50.590471
48892,195,151,49,80,2060,2535,2022-03-21 12:11:54.369635
48894,3,57,1,3,13,77,2022-03-21 12:11:55.518963
48895,9,1,10,5,161597,161622,2022-03-21 12:11:55.856868
48896,0,0,0,0,13508,13508,2022-03-21 12:11:56.390472
48897,0,0,0,0,0,0,2022-03-21 12:12:00.617926
48898,0,0,0,0,0,0,2022-03-21 12:12:01.443772
48899,14,22,6,26,58,126,2022-03-21 12:12:03.267697
48903,2,0,0,0,35273,35275,2022-03-21 12:12:03.454487
48904,2,23,1,19,48,93,2022-03-21 12:12:04.569792
48906,1,17,1,7,16,42,2022-03-21 12:12:05.562925
48908,2,41,1,9,18,71,2022-03-21 12:12:07.529959
48909,2,17,4,24,29,76,2022-03-21 12:12:07.725586
48916,1,0,0,0,14355,14356,2022-03-21 12:12:09.529304
48941,1625,5807,232,152,4912,12728,2022-03-21 12:12:11.938877
48945,6,382,2,6,49,445,2022-03-21 12:12:18.857369
48947,2,21,1,10,46,80,2022-03-21 12:12:20.570418
48951,24,29,17,23,512,605,2022-03-21 12:12:22.061219
48953,85,1000,34,41,979,2139,2022-03-21 12:12:22.86584
48954,25,65,13,15,957,1075,2022-03-21 12:12:27.097869
48956,762,1,47,59,284,1153,2022-03-21 12:12:28.867436
48961,2,139,3,4,27,175,2022-03-21 12:12:31.390191
48962,388,349,59,56,1932,2784,2022-03-21 12:12:31.593373
48963,2,72,1,4,14,93,2022-03-21 12:12:35.205735
48966,4,109,3,5,22,143,2022-03-21 12:12:38.298363
48968,3,79,4,9,21,116,2022-03-21 12:12:40.525397
48969,7,112,3,11,28,161,2022-03-21 12:12:41.735943
48971,3,147,3,11,35,199,2022-03-21 12:12:44.194901
48976,0,0,0,0,0,0,2022-03-21 12:12:48.576928
49008,0,0,0,0,0,0,2022-03-21 12:12:52.308472
49032,1,39,0,5,6,51,2022-03-21 12:12:54.738176
49049,5,412,5,11,49,482,2022-03-21 12:12:56.548891
49052,1,0,0,1,18664,18666,2022-03-21 12:12:56.755709
49053,628,23147,201,103,31923,56002,2022-03-21 12:12:59.63947
49054,12,138,1,5,36,192,2022-03-21 12:13:00.988488
49057,2,24,2,12,21,61,2022-03-21 12:13:01.920328
49060,14,337,8,31,238,628,2022-03-21 12:13:02.985252
49069,1,10,0,13,19,43,2022-03-21 12:13:04.45529
49071,3,14,1,18,24,60,2022-03-21 12:13:05.614482
49078,3,32,2,34,43,114,2022-03-21 12:13:07.018905
49079,38,0,6,60,161,265,2022-03-21 12:13:08.323091
49090,10,234,7,4,111,366,2022-03-21 12:13:11.374102
49091,3,60,1,4,16,84,2022-03-21 12:13:12.507291
49094,4,131,4,11,18,168,2022-03-21 12:13:13.596597
49098,51,129,20,40,251,491,2022-03-21 12:13:14.999962
49099,1,36,1,8,12,58,2022-03-21 12:13:15.993571
49103,9,497,3,6,31,546,2022-03-21 12:13:18.743875
49104,9,444,2,5,22,482,2022-03-21 12:13:20.37643
49109,0,0,0,0,28517,28517,2022-03-21 12:13:20.555063
49110,828,3649,180,233,3938,8828,2022-03-21 12:13:22.74831
49112,111,1,78,34,221,445,2022-03-21 12:13:23.367089
49114,67330,41,1772,905,68412,138460,2022-03-21 12:13:23.542641
49120,0,0,0,0,526,526,2022-03-21 12:13:28.648737
49123,1913,0,68,64,1294,3339,2022-03-21 12:13:30.871712
49125,0,0,0,0,557,557,2022-03-21 12:13:32.787562
49127,2,55,0,4,8,69,2022-03-21 12:13:34.616844
49133,1,16,2,22,22,63,2022-03-21 12:13:35.705602
49139,1,20,1,7,17,46,2022-03-21 12:13:39.496013
49143,1,13,0,18,27,59,2022-03-21 12:13:40.528927
49145,156,2677,141,99,1778,4851,2022-03-21 12:13:43.72841
49146,10,114,12,27,574,737,2022-03-21 12:13:45.507935
49152,0,0,0,0,0,0,2022-03-21 12:13:49.883584
49153,154,441,61,41,1425,2122,2022-03-21 12:13:51.805004
49160,0,0,0,0,5452,5452,2022-03-21 12:13:54.291184
49163,0,0,0,0,2227,2227,2022-03-21 12:13:57.529184
49164,0,0,0,0,1041,1041,2022-03-21 12:13:59.905067
49165,145,1569,47,118,2185,4064,2022-03-21 12:14:02.543757
49170,175,148,39,58,232,652,2022-03-21 12:14:04.996663
49179,0,0,0,0,864,864,2022-03-21 12:14:05.182166
49182,3,102,2,9,24,140,2022-03-21 12:14:08.138158
49184,64,30,16,103,260,473,2022-03-21 12:14:08.316447
49194,3,13,3,11,33,63,2022-03-21 12:14:10.86353
49198,2,23,6,9,35,75,2022-03-21 12:14:14.975319
49199,45,108,18,22,278,471,2022-03-21 12:14:16.383367
49200,471,14211,132,63,4426,19303,2022-03-21 12:14:16.555511
49204,326,0,74,172,2013,2585,2022-03-21 12:14:20.994505
49208,107,96,39,40,884,1166,2022-03-21 12:14:23.90983
49211,287,1357,46,76,1173,2939,2022-03-21 12:14:28.436854
49214,195,576,76,99,1365,2311,2022-03-21 12:14:31.357495
49221,17,64,5,54,112,252,2022-03-21 12:14:35.676261
49223,1110,49,109,131,2781,4180,2022-03-21 12:14:35.857331
49228,125,1159,34,52,606,1976,2022-03-21 12:14:36.905255
49233,0,1,0,1,78762,78764,2022-03-21 12:14:39.065293
49235,671,27094,228,373,10414,38780,2022-03-21 12:14:39.54163
49236,1763,26452,349,118,12830,41512,2022-03-21 12:14:39.703971
49241,656,8864,192,190,5536,15438,2022-03-21 12:14:43.31434
49251,0,0,0,0,0,0,2022-03-21 12:14:55.053216
49254,0,0,0,0,0,0,2022-03-21 12:14:56.609627
49277,13,0,7,18,84,122,2022-03-21 12:15:00.703615
49283,0,0,1,0,11506,11507,2022-03-21 12:15:00.911192
49292,4523,6795,871,6332,16845,35366,2022-03-21 12:15:05.221353
49297,674,13787,156,170,6023,20810,2022-03-21 12:15:05.850384
49303,0,0,0,0,33298,33298,2022-03-21 12:15:06.846483
49310,591,199,322,29,42073,43214,2022-03-21 12:15:13.232009
49315,0,0,0,0,0,0,2022-03-21 12:15:16.091063
49316,3,2,0,0,18753,18758,2022-03-21 12:15:16.302262
49318,1685,28614,292,301,7250,38142,2022-03-21 12:15:19.334897
49320,0,1,0,1,4767,4769,2022-03-21 12:15:19.513743
49348,81,349,29,53,735,1247,2022-03-21 12:15:24.701093
49351,0,45,0,7,17,69,2022-03-21 12:15:25.828063
49357,7221,37247,2120,1678,18106,66372,2022-03-21 12:15:28.898305
49361,991,9873,184,44,5194,16286,2022-03-21 12:15:29.106935
49387,1,0,1,0,86957,86959,2022-03-21 12:15:36.114287
49391,3,23,2,16,24,68,2022-03-21 12:15:37.713033
49392,1076,430,253,310,444,2513,2022-03-21 12:15:37.887062
49395,50,1194,21,23,399,1687,2022-03-21 12:15:39.98534
49396,60,1793,36,25,674,2588,2022-03-21 12:15:42.356478
49398,334,1,28,49,379,791,2022-03-21 12:15:45.082118
49399,0,25,1,7,11,44,2022-03-21 12:15:46.03525
49410,341,327,131,87,2139,3025,2022-03-21 12:15:55.823136
49413,1,0,0,0,22403,22404,2022-03-21 12:15:56.044134
49414,0,0,0,0,0,0,2022-03-21 12:15:57.463922
49418,6,287,1,6,34,334,2022-03-21 12:15:58.827374
49420,5,332,2,8,24,371,2022-03-21 12:16:01.114078
49422,1,6,3,8,15,33,2022-03-21 12:16:02.020586
49423,0,0,0,0,877,877,2022-03-21 12:16:04.427755
49426,27,376,21,28,803,1255,2022-03-21 12:16:06.356578
49430,0,0,0,0,3038,3038,2022-03-21 12:16:07.730683
49432,0,0,0,0,297,297,2022-03-21 12:16:14.981005
49433,64,71,17,33,135,320,2022-03-21 12:16:16.792366
49434,0,0,0,0,0,0,2022-03-21 12:16:17.612974
49437,2,97,1,5,17,122,2022-03-21 12:16:18.793031
49438,0,0,1,0,7994,7995,2022-03-21 12:16:21.792071
49439,0,56,1,4,19,80,2022-03-21 12:16:23.011909
49442,7,131,4,17,53,212,2022-03-21 12:16:25.424998
49445,9,23,8,22,55,117,2022-03-21 12:16:26.617704
49450,3,31,2,15,25,76,2022-03-21 12:16:29.388981
49454,32,0,13,27,90,162,2022-03-21 12:16:30.744292
49457,407,6801,164,74,9345,16791,2022-03-21 12:16:32.531514
49458,1,3,1,1,84503,84509,2022-03-21 12:16:35.130201
49460,0,0,0,0,742,742,2022-03-21 12:16:35.400169
49487,334,2169,78,41,2183,4805,2022-03-21 12:16:44.375518
49491,1,40,0,6,17,64,2022-03-21 12:16:45.851221
49498,1,48,0,4,15,68,2022-03-21 12:16:48.793883
49501,459,585,152,119,2782,4097,2022-03-21 12:16:51.098284
49505,2688,8317,524,1015,14038,26582,2022-03-21 12:16:54.255262
49507,437,301,92,94,2485,3409,2022-03-21 12:16:54.599229
49514,4222,2,331,2424,7529,14508,2022-03-21 12:17:00.270413
49515,7681,1,590,999,5565,14836,2022-03-21 12:17:00.437534
49518,153,71,56,24,3055,3359,2022-03-21 12:17:00.869927
49523,0,0,0,0,1327,1327,2022-03-21 12:17:01.65461
49549,5,15,4,7,24,55,2022-03-21 12:17:11.001825
49550,308,7383,84,143,1897,9815,2022-03-21 12:17:11.263426
49566,0,0,0,0,1258,1258,2022-03-21 12:17:15.142805
49567,0,0,0,0,949,949,2022-03-21 12:17:17.048184
49569,339,0,24,25,383,771,2022-03-21 12:17:17.232077
49571,576,0,23,29,427,1055,2022-03-21 12:17:19.674088
49572,0,0,0,0,6347,6347,2022-03-21 12:17:21.679745
49573,0,0,0,0,469,469,2022-03-21 12:17:23.1747
49581,8,132,1,11,36,188,2022-03-21 12:17:27.255068
49587,762,0,33,23,1425,2243,2022-03-21 12:17:29.654768
49590,0,0,0,0,13647,13647,2022-03-21 12:17:34.069946
49592,241,164,48,40,1262,1755,2022-03-21 12:17:36.299354
49596,0,0,0,0,50709,50709,2022-03-21 12:17:37.345443
49598,15,0,5,20,79,119,2022-03-21 12:17:40.661867
49600,3,161,2,7,18,191,2022-03-21 12:17:44.733496
49601,0,0,0,0,0,0,2022-03-21 12:17:45.623121
49603,2,11,0,3,5,21,2022-03-21 12:17:46.783068
49605,11714,37738,1562,1999,22663,75676,2022-03-21 12:17:47.214937
49613,0,0,0,0,2677,2677,2022-03-21 12:17:56.669184
49614,1,87,2,8,45,143,2022-03-21 12:17:58.145794
49615,1,24,2,16,31,74,2022-03-21 12:17:59.099558
49618,0,0,0,1,6585,6586,2022-03-21 12:18:02.971568
49620,18,49,9,20,126,222,2022-03-21 12:18:04.314743
49627,534,463,114,28,2513,3652,2022-03-21 12:18:05.788487
49638,593,1972,39,55,513,3172,2022-03-21 12:18:08.3108
49654,7,144,5,13,48,217,2022-03-21 12:18:11.066986
49661,162,1067,36,30,1321,2616,2022-03-21 12:18:12.876406
49664,82,84,23,99,717,1005,2022-03-21 12:18:14.597902
49668,2,135,5,14,52,208,2022-03-21 12:18:19.412149
49681,0,0,0,0,0,0,2022-03-21 12:18:24.217658
49682,3,92,1,3,17,116,2022-03-21 12:18:25.647919
49683,2,108,2,4,64,180,2022-03-21 12:18:25.831724
49684,6,96,1,6,15,124,2022-03-21 12:18:27.78339
49688,0,0,0,0,0,0,2022-03-21 12:18:28.658094
49690,356,1026,167,30,2038,3617,2022-03-21 12:18:29.802412
49700,10,66,8,10,54,148,2022-03-21 12:18:36.608602
49701,630,1330,57,75,933,3025,2022-03-21 12:18:38.672962
49709,1,0,1,2,85439,85443,2022-03-21 12:18:42.896217
49716,0,0,0,0,679,679,2022-03-21 12:18:44.472297
49717,0,0,0,0,209,209,2022-03-21 12:18:45.691486
49718,99,106,33,21,569,828,2022-03-21 12:18:47.532465
49721,53430,17,1475,676,52524,108122,2022-03-21 12:18:47.710078
49722,0,0,1,0,13994,13995,2022-03-21 12:18:51.090319
49728,3,5,0,10,29,47,2022-03-21 12:18:52.014761
49730,1866,6133,283,192,1867,10341,2022-03-21 12:18:52.185814
49733,3,0,2,1,17209,17215,2022-03-21 12:18:55.252536
49735,18,67,14,19,238,356,2022-03-21 12:18:58.877457
49737,5,203,2,8,44,262,2022-03-21 12:19:01.272955
49738,10141,16820,2191,2802,25766,57720,2022-03-21 12:19:04.573949
49739,39,952,30,37,307,1365,2022-03-21 12:19:04.746538
49750,0,0,0,0,70,70,2022-03-21 12:19:14.344011
49751,7,273,2,4,20,306,2022-03-21 12:19:16.165908
49755,40,2017,15,26,450,2548,2022-03-21 12:19:18.103782
49757,0,0,0,0,456,456,2022-03-21 12:19:20.443559
49759,0,0,0,0,140,140,2022-03-21 12:19:21.546679
49766,0,0,0,0,2621,2621,2022-03-21 12:19:23.586161
49771,3,168,8,14,75,268,2022-03-21 12:19:27.525732
49776,0,0,1,0,9916,9917,2022-03-21 12:19:31.739215
49778,0,0,0,0,1080,1080,2022-03-21 12:19:34.063391
49780,2898,1,96,456,1545,4996,2022-03-21 12:19:34.2624
49782,0,0,2,0,26502,26504,2022-03-21 12:19:34.43415
49784,2,0,0,0,28352,28354,2022-03-21 12:19:37.344088
49785,0,0,2,0,46526,46528,2022-03-21 12:19:37.775304
49793,0,0,0,0,0,0,2022-03-21 12:19:38.537113
49796,0,0,0,0,130,130,2022-03-21 12:19:40.482354
49827,0,0,0,1,2780,2781,2022-03-21 12:19:46.3241
49835,0,0,0,0,932,932,2022-03-21 12:19:49.609054
49838,17,1032,4,13,120,1186,2022-03-21 12:19:51.507897
49842,0,0,0,0,22422,22422,2022-03-21 12:19:52.899674
49843,0,0,0,0,57,57,2022-03-21 12:19:56.647685
49845,0,0,0,0,274,274,2022-03-21 12:19:57.548114
49849,0,0,0,0,1020,1020,2022-03-21 12:19:59.782079
49854,6366,22762,876,920,13540,44464,2022-03-21 12:20:00.877657
49860,130,1654,27,41,515,2367,2022-03-21 12:20:11.538332
49861,12,812,9,8,110,951,2022-03-21 12:20:13.604853
49866,288,1691,150,46,4936,7111,2022-03-21 12:20:13.788946
49869,282,1289,159,55,7465,9250,2022-03-21 12:20:17.18285
49873,155,164,22,25,136,502,2022-03-21 12:20:20.749797
49877,1,0,0,0,71872,71873,2022-03-21 12:20:21.737682
49878,6,281,0,5,22,314,2022-03-21 12:20:23.008897
49884,0,0,0,0,0,0,2022-03-21 12:20:27.517201
49900,0,58,0,4,14,76,2022-03-21 12:20:30.49891
49903,2,61,0,5,17,85,2022-03-21 12:20:34.136196
49909,4274,8688,130,75,5012,18179,2022-03-21 12:20:36.410604
49936,8,56,7,13,117,201,2022-03-21 12:20:38.997393
49938,0,0,0,0,2359,2359,2022-03-21 12:20:41.843938
49939,603,354,33,51,267,1308,2022-03-21 12:20:43.853691
49941,1,168,4,17,63,253,2022-03-21 12:20:45.164854
49952,352,0,25,55,193,625,2022-03-21 12:20:50.012639
49955,0,0,0,0,0,0,2022-03-21 12:20:51.040066
49961,0,5,0,9,14,28,2022-03-21 12:20:54.279382
49964,9,462,4,6,41,522,2022-03-21 12:20:56.289505
49967,0,4,0,13,14,31,2022-03-21 12:20:59.333074
49968,1,5,0,11,15,32,2022-03-21 12:21:00.814051
49969,11178,2,638,2774,14596,29188,2022-03-21 12:21:00.989223
49971,0,5,0,11,16,32,2022-03-21 12:21:03.479349
49972,0,0,0,0,0,0,2022-03-21 12:21:04.405854
49976,6,185,1,9,41,242,2022-03-21 12:21:06.093104
49977,9,200,1,7,39,256,2022-03-21 12:21:07.520761
49980,0,0,0,0,651,651,2022-03-21 12:21:09.72741
49982,105,20,43,18,1470,1656,2022-03-21 12:21:14.905377
49983,0,0,0,0,93,93,2022-03-21 12:21:16.127936
49984,0,0,0,0,96,96,2022-03-21 12:21:17.252439
49985,10,36,4,7,52,109,2022-03-21 12:21:18.357209
49992,4,12,0,12,19,47,2022-03-21 12:21:21.690136
49994,5,91,1,4,12,113,2022-03-21 12:21:22.861269
49997,0,61,0,5,13,79,2022-03-21 12:21:24.978849
50000,1,50,0,6,9,66,2022-03-21 12:21:25.981901
50005,0,54,0,3,7,64,2022-03-21 12:21:28.054182
50007,5,99,0,4,13,121,2022-03-21 12:21:29.579754
50008,2,142,1,8,15,168,2022-03-21 12:21:30.877677
50012,0,0,0,1,1220,1221,2022-03-21 12:21:33.699793
50025,0,0,0,0,346,346,2022-03-21 12:21:35.53192
50027,2,64,0,5,10,81,2022-03-21 12:21:36.585203
50028,0,67,1,10,8,86,2022-03-21 12:21:37.80248
50029,11,313,8,15,81,428,2022-03-21 12:21:39.152829
50030,9,622,1,7,55,694,2022-03-21 12:21:39.324852
50031,2,79,0,4,13,98,2022-03-21 12:21:42.171847
50033,2,103,2,5,18,130,2022-03-21 12:21:43.395052
50037,6,287,0,4,32,329,2022-03-21 12:21:46.830165
50038,4,106,0,3,21,134,2022-03-21 12:21:47.956147
50040,2,64,1,4,13,84,2022-03-21 12:21:49.42297
50042,3,93,0,5,22,123,2022-03-21 12:21:51.977578
50046,28,563,29,19,266,905,2022-03-21 12:21:56.087268
50049,2,14,2,14,18,50,2022-03-21 12:21:59.102801
50052,8,35,3,35,60,141,2022-03-21 12:22:01.56775
50054,3,123,0,4,22,152,2022-03-21 12:22:04.208256
50056,3,96,2,4,14,119,2022-03-21 12:22:06.760479
50057,3,78,1,4,13,99,2022-03-21 12:22:07.825673
50059,7,207,5,7,42,268,2022-03-21 12:22:11.116338
50060,0,0,0,1,748,749,2022-03-21 12:22:11.321689
50062,5,106,0,4,23,138,2022-03-21 12:22:12.410641
50063,4,154,1,4,29,192,2022-03-21 12:22:13.894039
50064,3,83,3,4,31,124,2022-03-21 12:22:14.965123
50066,8,267,9,12,100,396,2022-03-21 12:22:17.864842
50071,4,83,0,5,13,105,2022-03-21 12:22:19.544884
50072,5,125,0,4,16,150,2022-03-21 12:22:20.68712
50073,2,61,0,4,18,85,2022-03-21 12:22:21.949898
50074,5,110,1,7,46,169,2022-03-21 12:22:23.620177
50076,2,84,0,4,16,106,2022-03-21 12:22:26.51548
50077,2,80,0,3,20,105,2022-03-21 12:22:27.729166
50079,1,68,0,4,12,85,2022-03-21 12:22:29.210069
50080,0,56,0,4,12,72,2022-03-21 12:22:30.319335
50086,2,52,1,2,8,65,2022-03-21 12:22:33.087544
50088,2,54,0,4,15,75,2022-03-21 12:22:35.541444
50094,151,2608,44,37,1236,4076,2022-03-21 12:22:36.468773
50096,0,0,0,0,0,0,2022-03-21 12:22:39.304272
50099,0,0,0,0,2698,2698,2022-03-21 12:22:41.490948
50100,2,19,0,3,3,27,2022-03-21 12:22:44.35154
50101,2,18,2,6,4,32,2022-03-21 12:22:45.569551
50110,5,132,4,8,62,211,2022-03-21 12:22:53.454618
50111,5,77,10,7,47,146,2022-03-21 12:22:54.650444
50113,1,54,0,2,6,63,2022-03-21 12:22:56.527596
50115,2,83,0,5,13,103,2022-03-21 12:22:59.202014
50116,2,104,2,6,13,127,2022-03-21 12:23:00.317261
50119,1,26,0,3,4,34,2022-03-21 12:23:01.350779
50120,4,15,2,6,27,54,2022-03-21 12:23:01.538379
50125,2,36,0,2,6,46,2022-03-21 12:23:04.343672
50136,23,277,7,16,155,478,2022-03-21 12:23:06.848743
50138,0,0,0,0,0,0,2022-03-21 12:23:07.94579
50150,4,69,0,2,15,90,2022-03-21 12:23:15.001978
50151,2,37,0,2,7,48,2022-03-21 12:23:16.08221
50152,0,0,0,0,0,0,2022-03-21 12:23:16.925799
50158,0,0,0,0,0,0,2022-03-21 12:23:17.798962
50159,0,0,0,0,20454,20454,2022-03-21 12:23:17.972313
50175,34,0,7,1,39534,39576,2022-03-21 12:23:19.465174
50184,0,0,0,0,5561,5561,2022-03-21 12:23:22.521215
50185,19027,10,576,767,18292,38672,2022-03-21 12:23:22.73275
50191,6,36,5,13,127,187,2022-03-21 12:23:24.545217
50193,0,0,0,0,160,160,2022-03-21 12:23:24.732389
50197,1,0,2,2,86796,86801,2022-03-21 12:23:27.084392
50203,2,0,0,0,8645,8647,2022-03-21 12:23:27.572892
50216,0,0,0,0,0,0,2022-03-21 12:23:29.44841
50221,0,0,0,0,889,889,2022-03-21 12:23:34.727893
50222,0,0,0,0,0,0,2022-03-21 12:23:35.948504
50225,1,36,0,4,14,55,2022-03-21 12:23:36.988165
50230,9,13,1,10,24,57,2022-03-21 12:23:41.213084
50239,4,42,0,3,12,61,2022-03-21 12:23:43.678729
50241,2,26,0,3,2,33,2022-03-21 12:23:46.246467
50242,2,37,0,1,3,43,2022-03-21 12:23:47.734638
50244,0,0,0,0,0,0,2022-03-21 12:23:49.678248
50248,0,0,0,0,4161,4161,2022-03-21 12:23:50.879024
50250,0,0,0,0,94,94,2022-03-21 12:23:54.909366
50255,2,5,3,8,35,53,2022-03-21 12:23:57.086037
50258,54,99,11,14,345,523,2022-03-21 12:23:59.621217
50265,16,1,2,1,153095,153115,2022-03-21 12:23:59.922742
50280,50,37,10,27,205,329,2022-03-21 12:24:07.508103
50281,2156,0,97,118,2162,4533,2022-03-21 12:24:07.707102
50282,7,23,4,23,116,173,2022-03-21 12:24:08.826333
50284,0,0,0,0,1337,1337,2022-03-21 12:24:09.00458
50285,205,0,39,88,1727,2059,2022-03-21 12:24:13.813388
50287,0,0,0,0,7374,7374,2022-03-21 12:24:13.991187
50288,11,614,7,16,76,724,2022-03-21 12:24:16.331166
50289,1,32,1,4,7,45,2022-03-21 12:24:17.480037
50290,12,144,8,14,157,335,2022-03-21 12:24:18.800391
50291,0,0,0,0,0,0,2022-03-21 12:24:19.620913
50295,7,0,2,7,10,26,2022-03-21 12:24:23.041115
50300,1,5,1,7,8,22,2022-03-21 12:24:24.839114
50313,0,3,0,6,7,16,2022-03-21 12:24:31.554214
50315,0,0,0,0,15759,15759,2022-03-21 12:24:34.854024
50316,3,42,1,2,12,60,2022-03-21 12:24:36.44228
50319,0,0,0,0,0,0,2022-03-21 12:24:39.634689
50324,14,735,5,4,72,830,2022-03-21 12:24:41.499867
50325,1544,18861,251,76,10333,31065,2022-03-21 12:24:41.688657
50326,6,6,4,10,78,104,2022-03-21 12:24:45.457742
50335,0,0,0,0,0,0,2022-03-21 12:24:49.043358
50339,3,0,1,1,10317,10322,2022-03-21 12:24:53.402261
50346,9,0,1,0,42286,42296,2022-03-21 12:24:54.796147
50348,0,0,0,0,12398,12398,2022-03-21 12:24:55.766704
50352,1,116,0,3,13,133,2022-03-21 12:24:59.5292
50360,1852,24802,212,26,44157,71049,2022-03-21 12:25:01.964084
50379,0,0,0,0,1659,1659,2022-03-21 12:25:04.02654
50398,49,12,6,14,71,152,2022-03-21 12:25:07.501721
50399,3,0,1,0,10449,10453,2022-03-21 12:25:07.712997
50408,0,0,0,0,0,0,2022-03-21 12:25:11.877268
50410,1,0,0,1,38827,38829,2022-03-21 12:25:12.335701
50418,409,0,41,190,868,1508,2022-03-21 12:25:13.591884
50430,192,0,17,27,282,518,2022-03-21 12:25:15.601752
50432,0,0,0,0,92,92,2022-03-21 12:25:16.920015
50433,0,0,0,0,71,71,2022-03-21 12:25:18.552645
50440,0,0,0,0,0,0,2022-03-21 12:25:22.983246
50442,0,0,0,0,0,0,2022-03-21 12:25:24.417484
50444,174,0,10,17,115,316,2022-03-21 12:25:26.342258
50453,0,0,0,0,0,0,2022-03-21 12:25:29.867008
50458,0,0,0,0,0,0,2022-03-21 12:25:30.995497
50469,0,0,0,0,1541,1541,2022-03-21 12:25:35.296086
50481,0,0,0,0,3389,3389,2022-03-21 12:25:38.635909
50482,2,49,1,2,7,61,2022-03-21 12:25:39.865804
50484,1,29,0,5,6,41,2022-03-21 12:25:41.273183
50485,1,32,0,2,4,39,2022-03-21 12:25:42.23829
50503,29,199,4,17,156,405,2022-03-21 12:25:44.941378
50505,0,0,0,0,0,0,2022-03-21 12:25:45.774085
50507,0,0,0,0,0,0,2022-03-21 12:25:46.806253
50526,0,0,0,0,0,0,2022-03-21 12:25:52.904433
50534,1,39,0,2,8,50,2022-03-21 12:25:55.728214
50535,0,0,0,0,0,0,2022-03-21 12:25:56.601395
50537,0,0,0,0,0,0,2022-03-21 12:25:57.586332
50540,0,0,0,0,0,0,2022-03-21 12:25:59.268339
50545,0,0,0,0,0,0,2022-03-21 12:26:01.148443
50549,4,0,0,0,34608,34612,2022-03-21 12:26:01.932197
50562,0,0,1,1,367,369,2022-03-21 12:26:02.930058
50576,0,0,0,0,0,0,2022-03-21 12:26:07.096678
50580,0,0,0,0,0,0,2022-03-21 12:26:08.24317
50590,0,0,0,0,769,769,2022-03-21 12:26:12.790568
50591,0,0,0,0,0,0,2022-03-21 12:26:13.686417
50593,0,0,0,0,3621,3621,2022-03-21 12:26:14.11829
50599,2129,0,90,118,2650,4987,2022-03-21 12:26:14.908163
50631,11,0,7,1,111523,111542,2022-03-21 12:26:17.349727
50639,4,45,2,3,6,60,2022-03-21 12:26:19.954996
50640,6,127,0,6,20,159,2022-03-21 12:26:21.779772
50644,15,40,3,17,42,117,2022-03-21 12:26:22.870379
50646,0,0,0,0,0,0,2022-03-21 12:26:23.707342
50647,219,0,14,28,213,474,2022-03-21 12:26:24.792737
50653,2,0,1,0,28766,28769,2022-03-21 12:26:27.87725
50657,69,14,7,20,82,192,2022-03-21 12:26:32.030043
50662,3,32,0,13,13,61,2022-03-21 12:26:33.03764
50664,0,0,0,0,27467,27467,2022-03-21 12:26:36.954635
50673,405,1842,80,40,1582,3949,2022-03-21 12:26:46.432205
50677,0,0,0,0,0,0,2022-03-21 12:26:48.557354
50678,0,0,0,0,3233,3233,2022-03-21 12:26:48.754442
50683,0,0,0,0,0,0,2022-03-21 12:26:50.596993
50684,0,0,0,0,0,0,2022-03-21 12:26:51.590068
50696,349,6733,85,79,2246,9492,2022-03-21 12:26:57.229959
50697,0,0,0,0,0,0,2022-03-21 12:26:58.322071
50698,12,129,7,8,74,230,2022-03-21 12:26:58.485723
50702,0,0,0,0,0,0,2022-03-21 12:27:02.901127
50706,58,47,23,12,1580,1720,2022-03-21 12:27:04.302974
50727,0,0,0,0,0,0,2022-03-21 12:27:05.934249
50736,0,0,0,0,0,0,2022-03-21 12:27:07.118732
50746,6,34,3,10,23,76,2022-03-21 12:27:13.761934
50747,4,81,5,2,31,123,2022-03-21 12:27:16.103982
50748,8,116,3,5,45,177,2022-03-21 12:27:17.360506
50760,0,0,0,0,687,687,2022-03-21 12:27:21.76988
50770,184,1336,54,47,1328,2949,2022-03-21 12:27:28.154207
50771,0,0,0,0,0,0,2022-03-21 12:27:29.182316
50773,0,0,0,0,0,0,2022-03-21 12:27:30.783446
50774,2,182,1,3,16,204,2022-03-21 12:27:32.558258
50789,0,0,0,1,673,674,2022-03-21 12:27:37.57618
50790,4,16,2,7,16,45,2022-03-21 12:27:37.795675
50845,19,63,5,14,173,274,2022-03-21 12:27:49.516485
50848,0,0,0,0,0,0,2022-03-21 12:27:54.318588
50849,73,0,8,25,88,194,2022-03-21 12:27:55.472591
50851,1,45,0,3,6,55,2022-03-21 12:27:57.456953
50852,0,0,0,0,0,0,2022-03-21 12:27:58.286229
50854,0,0,0,0,703,703,2022-03-21 12:27:59.797324
50855,0,0,0,0,838,838,2022-03-21 12:27:59.988794
50863,0,0,0,0,231,231,2022-03-21 12:28:04.905542
50869,0,0,0,0,1459,1459,2022-03-21 12:28:09.628808
50871,0,0,0,0,431,431,2022-03-21 12:28:10.988261
50876,3,51,2,2,9,67,2022-03-21 12:28:14.438105
50878,0,0,0,0,0,0,2022-03-21 12:28:16.228725
50880,0,0,0,0,0,0,2022-03-21 12:28:17.601218
50881,6,113,0,1,10,130,2022-03-21 12:28:18.845935
50887,0,0,0,0,0,0,2022-03-21 12:28:20.261835
50913,0,0,0,0,0,0,2022-03-21 12:28:25.1538
50916,0,0,0,0,12004,12004,2022-03-21 12:28:25.716681
50924,1,23,0,1,3,28,2022-03-21 12:28:30.054457
50930,96,0,23,16,338,473,2022-03-21 12:28:31.512591
50931,0,0,0,0,0,0,2022-03-21 12:28:32.307067
50950,0,0,0,0,0,0,2022-03-21 12:28:35.486021
50964,7,167,5,6,29,214,2022-03-21 12:28:37.986748
50970,48,0,19,9,289,365,2022-03-21 12:28:39.551876
50972,0,0,0,0,0,0,2022-03-21 12:28:40.395952
50973,2,35,0,1,1,39,2022-03-21 12:28:41.314254
50976,0,0,0,0,0,0,2022-03-21 12:28:42.131744
50992,0,0,0,0,0,0,2022-03-21 12:28:45.732124
51005,2,47,0,2,9,60,2022-03-21 12:28:49.394873
51009,1,0,0,0,19756,19757,2022-03-21 12:28:52.005222
51027,0,0,0,0,0,0,2022-03-21 12:28:53.872377
51032,0,0,0,0,0,0,2022-03-21 12:28:55.199137
51037,0,0,0,0,50,50,2022-03-21 12:28:56.93104
51056,1,43,0,2,9,55,2022-03-21 12:29:00.080231
51063,0,0,0,0,0,0,2022-03-21 12:29:03.658659
51069,0,0,0,0,0,0,2022-03-21 12:29:08.080613
51076,0,0,0,0,0,0,2022-03-21 12:29:10.291319
51077,0,0,0,0,0,0,2022-03-21 12:29:11.200982
51078,0,0,0,0,0,0,2022-03-21 12:29:12.015059
51085,0,0,0,0,0,0,2022-03-21 12:29:14.442841
51089,4,48,0,1,7,60,2022-03-21 12:29:15.758414
51091,2,73,0,2,5,82,2022-03-21 12:29:17.130341
51095,0,0,0,0,0,0,2022-03-21 12:29:20.323162
51096,15,1,9,2,31058,31085,2022-03-21 12:29:20.754868
51097,5,46,7,8,39,105,2022-03-21 12:29:20.913253
51124,0,0,0,0,0,0,2022-03-21 12:29:25.073857
51132,9,20,4,16,26,75,2022-03-21 12:29:28.144716
51157,8,65,3,2,33,111,2022-03-21 12:29:33.974413
51158,0,14,2,5,5,26,2022-03-21 12:29:34.916174
51161,16,365,5,1,82,469,2022-03-21 12:29:35.657896
51169,0,0,0,0,0,0,2022-03-21 12:29:37.12687
51179,8,1,4,0,37132,37145,2022-03-21 12:29:41.544842
51187,4,15,3,6,29,57,2022-03-21 12:29:43.417282
51193,3,32,5,6,14,60,2022-03-21 12:29:45.797398
51195,161,214,23,14,772,1184,2022-03-21 12:29:46.426724
51203,0,0,0,0,0,0,2022-03-21 12:29:48.027527
51210,0,0,0,0,0,0,2022-03-21 12:29:50.729897
51211,10,0,5,7,10,32,2022-03-21 12:29:52.191503
51219,0,0,0,0,1175,1175,2022-03-21 12:29:55.19637
51220,0,0,0,0,0,0,2022-03-21 12:29:56.008617
51222,3,85,5,11,26,130,2022-03-21 12:29:58.263644
51224,5,60,1,8,22,96,2022-03-21 12:29:59.493798
51225,184,617,44,13,845,1703,2022-03-21 12:30:01.781287
51226,0,0,0,0,0,0,2022-03-21 12:30:02.634515
51233,0,0,0,0,0,0,2022-03-21 12:30:06.581014
51234,6,54,0,6,16,82,2022-03-21 12:30:07.678486
51235,0,0,0,0,0,0,2022-03-21 12:30:08.441639
51237,0,0,0,0,0,0,2022-03-21 12:30:11.111481
51238,0,0,0,0,0,0,2022-03-21 12:30:11.939809
51239,0,0,0,0,0,0,2022-03-21 12:30:12.311205
51240,0,0,0,0,0,0,2022-03-21 12:30:12.654808
51241,0,0,0,0,0,0,2022-03-21 12:30:13.080605
51248,0,0,0,0,0,0,2022-03-21 12:30:14.744066
51251,0,0,0,0,1406,1406,2022-03-21 12:30:15.245082
51259,0,0,0,0,0,0,2022-03-21 12:30:17.218306
51261,0,0,0,0,0,0,2022-03-21 12:30:18.323313
51266,0,0,0,0,0,0,2022-03-21 12:30:19.619714
51269,0,0,0,0,0,0,2022-03-21 12:30:20.822724
51279,0,0,0,0,0,0,2022-03-21 12:30:23.206427
51282,0,0,0,0,0,0,2022-03-21 12:30:24.401657
51288,0,0,0,0,0,0,2022-03-21 12:30:26.78611
51291,0,0,0,0,0,0,2022-03-21 12:30:27.962195
51300,8,30,4,3,97,142,2022-03-21 12:30:32.077631
51302,0,0,0,0,0,0,2022-03-21 12:30:33.50826
51303,0,0,0,0,0,0,2022-03-21 12:30:34.395036
51304,2,1,1,2,7307,7313,2022-03-21 12:30:34.816077
51320,0,0,0,0,0,0,2022-03-21 12:30:37.557808
51328,0,0,0,0,0,0,2022-03-21 12:30:39.928702
51333,0,0,0,0,44,44,2022-03-21 12:30:41.771691
51336,0,0,0,0,0,0,2022-03-21 12:30:42.614924
51340,0,0,0,0,0,0,2022-03-21 12:30:43.621592
51345,1,18,1,3,4,27,2022-03-21 12:30:46.048562
51394,0,0,0,0,0,0,2022-05-12 22:42:25.918115
51397,0,0,0,0,0,0,2022-05-12 22:42:27.092157
51401,0,0,0,0,0,0,2022-05-12 22:42:28.370364
51404,0,0,0,0,404,404,2022-05-12 22:42:34.952202
1,149778,911271,90790,34586,414841,1601266,2022-05-12 00:17:36.040709
5,5538,247346,2445,958,75283,331570,2022-05-12 00:17:36.465593
6,35370,390533,29506,16218,182029,653656,2022-05-12 00:17:36.705776
15,15466,88520,15524,12835,35539,167884,2022-05-12 00:17:37.429285
22,13747,86224,14217,13852,36976,165016,2022-05-12 00:17:38.615583
29,999,7681,804,702,9155,19341,2022-05-12 00:17:39.887588
44,7535,165132,3463,2069,77303,255502,2022-05-12 00:17:40.781651
45,34426,242955,34415,20955,114822,447573,2022-05-12 00:17:46.681651
47,11319,545149,4522,2821,156426,720237,2022-05-12 00:17:56.58615
48,7364,97145,8802,12867,44522,170700,2022-05-12 00:17:56.769303
50,6624,91671,7039,8566,34432,148332,2022-05-12 00:18:05.075671
52,1841,34743,2746,2976,12341,54647,2022-05-12 00:18:09.30699
53,4611,64146,4488,6304,23857,103406,2022-05-12 00:18:09.497999
54,911,54695,453,556,12822,69437,2022-05-12 00:18:14.276796
55,638,7479,754,966,5355,15192,2022-05-12 00:18:17.783238
56,650,8245,735,1318,5699,16647,2022-05-12 00:18:21.238687
57,13417,149011,11785,9505,117680,301398,2022-05-12 00:18:21.416802
58,3161,34183,2752,3456,29765,73317,2022-05-12 00:18:22.590958
59,17311,295177,19576,24379,88616,445059,2022-05-12 00:18:22.755896
60,8956,124437,10358,10508,58581,212840,2022-05-12 00:18:27.701034
62,3323,37674,2994,4088,24295,72374,2022-05-12 00:18:34.171616
64,6282,121044,6353,8405,49100,191184,2022-05-12 00:18:35.194914
65,2227,77480,2201,1772,15719,99399,2022-05-12 00:18:38.062337
66,16159,156260,17399,14182,91470,295470,2022-05-12 00:18:38.48133
67,7719,88053,6843,7512,61667,171794,2022-05-12 00:18:38.65005
68,11426,154294,12476,12000,62731,252927,2022-05-12 00:18:38.89609
74,2861,64088,3065,3199,18808,92021,2022-05-12 00:18:42.5471
75,2440,17543,1967,2150,20207,44307,2022-05-12 00:18:45.540845
76,3658,50805,3050,2838,36110,96461,2022-05-12 00:18:49.288715
77,1565,42629,1152,901,14774,61021,2022-05-12 00:18:52.170765
79,12085,162770,10282,14392,62804,262333,2022-05-12 00:18:52.581472
80,9463,61483,6328,3574,33288,114136,2022-05-12 00:18:52.759446
84,1242,27858,795,517,8225,38637,2022-05-12 00:19:01.487249
85,4869,38435,3033,1231,15684,63252,2022-05-12 00:19:04.59865
86,2034,21530,1523,1074,9935,36096,2022-05-12 00:19:07.039408
87,632,31581,292,207,8872,41584,2022-05-12 00:19:09.127175
89,1441,11563,1228,698,8968,23898,2022-05-12 00:19:13.083559
90,6867,104000,6572,4882,24745,147066,2022-05-12 00:19:16.275467
92,1773,17774,1845,1104,9818,32314,2022-05-12 00:19:21.990134
93,5774,110749,4897,5390,27692,154502,2022-05-12 00:19:25.050942
94,2557,76418,2419,2941,13626,97961,2022-05-12 00:19:25.223737
95,2803,16875,2553,1623,17590,41444,2022-05-12 00:19:25.712694
96,2992,42753,2773,1785,11831,62134,2022-05-12 00:19:26.122366
98,3829,63010,3843,4497,33231,108410,2022-05-12 00:19:26.447834
108,311,7622,232,187,3997,12349,2022-05-12 00:19:33.801722
110,1104,9295,932,922,5654,17907,2022-05-12 00:19:38.200604
112,285,3875,263,618,3018,8059,2022-05-12 00:19:43.526288
113,911,11317,1004,1057,8401,22690,2022-05-12 00:19:46.947728
114,9283,54205,8746,5892,47566,125692,2022-05-12 00:19:50.035279
116,715,8849,680,741,5334,16319,2022-05-12 00:19:53.569167
117,600,9779,477,410,6033,17299,2022-05-12 00:19:58.141142
118,199,5844,179,139,2082,8443,2022-05-12 00:20:00.90586
119,1067,22768,818,1171,7955,33779,2022-05-12 00:20:03.652003
120,19692,339513,14950,19788,104142,498085,2022-05-12 00:20:03.98227
121,62713,1015204,48834,46470,172328,1345549,2022-05-12 00:20:04.245987
122,4309,56440,5115,5884,29001,100749,2022-05-12 00:20:04.65006
125,1141,20869,1014,1566,8938,33528,2022-05-12 00:20:08.392726
127,794,11615,988,1258,6074,20729,2022-05-12 00:20:11.738484
1289,347,4233,203,122,4065,8970,2022-05-12 14:29:57.684824
129,3002,23894,3378,3300,17590,51164,2022-05-12 00:20:18.612357
131,827,11514,753,576,8059,21729,2022-05-12 00:20:25.06335
132,6187,59941,8431,7969,31967,114495,2022-05-12 00:20:25.438416
133,2973,82551,2270,5753,18736,112283,2022-05-12 00:20:28.337489
134,7390,88501,8221,8795,62818,175725,2022-05-12 00:20:31.33826
136,36265,320821,19894,18924,122328,518232,2022-05-12 00:20:35.183112
137,2610,90022,1013,934,20857,115436,2022-05-12 00:20:35.45489
138,2851,115870,1011,953,18215,138900,2022-05-12 00:20:35.702111
151,1013,12275,685,594,11347,25914,2022-05-12 00:20:37.867818
155,570,24268,360,393,8764,34355,2022-05-12 00:20:41.206931
156,3032,41787,3476,3243,24451,75989,2022-05-12 00:20:43.83131
157,6145,79705,5453,7981,32257,131541,2022-05-12 00:20:46.94727
158,2598,24427,2133,2994,28831,60983,2022-05-12 00:20:48.115326
160,5235,44181,3656,2806,69146,125024,2022-05-12 00:20:55.674177
2670,69,8736,45,108,614,9572,2022-05-12 15:06:11.824708
161,2389,28226,2490,2302,18976,54383,2022-05-12 00:20:58.623651
162,832,12809,1162,1636,5671,22110,2022-05-12 00:21:02.182915
163,238,4412,246,486,1752,7134,2022-05-12 00:21:04.881697
164,14996,910842,4288,1770,155835,1087731,2022-05-12 00:21:05.294091
165,4602,49079,4760,4611,47144,110196,2022-05-12 00:21:06.25499
166,5012,72706,5282,4874,34037,121911,2022-05-12 00:21:09.463517
167,3732,44839,3775,3535,32707,88588,2022-05-12 00:21:12.955413
26097,8,63,4,49,72,196,2022-05-12 18:16:47.538292
169,6019,84006,4141,4601,54177,152944,2022-05-12 00:21:16.508237
170,20168,132253,15061,9447,76078,253007,2022-05-12 00:21:16.77198
171,223,1726,181,244,2494,4868,2022-05-12 00:21:19.631651
174,8450,108439,6588,9424,42819,175720,2022-05-12 00:21:25.426929
175,1471,14256,1415,1867,8456,27465,2022-05-12 00:21:28.319409
176,224,3401,160,209,2550,6544,2022-05-12 00:21:31.32193
177,10205,114135,12032,12835,63507,212714,2022-05-12 00:21:31.511343
26139,9,34,2,47,57,149,2022-05-12 18:17:11.740578
178,1375,16623,1455,1715,9516,30684,2022-05-12 00:21:36.993819
179,86,3485,84,77,1589,5321,2022-05-12 00:21:39.137505
181,911,42213,755,656,6057,50592,2022-05-12 00:21:43.953342
182,5806,75950,5506,4590,49082,140934,2022-05-12 00:21:44.395387
183,616,7980,538,653,3592,13379,2022-05-12 00:21:47.522498
184,722,10021,867,1253,6382,19245,2022-05-12 00:21:49.875938
185,19820,192743,10775,6266,75042,304646,2022-05-12 00:21:50.182726
187,1877,125129,655,437,18262,146360,2022-05-12 00:21:54.086469
189,8694,164218,7849,12554,54077,247392,2022-05-12 00:21:54.347774
192,411,44318,332,206,5273,50540,2022-05-12 00:22:01.038054
193,4130,61726,3219,4556,18583,92214,2022-05-12 00:22:01.482571
194,1021,23481,725,490,10387,36104,2022-05-12 00:22:04.331228
195,4528,119014,2981,4617,32670,163810,2022-05-12 00:22:06.913651
196,1999,63951,1572,2294,13908,83724,2022-05-12 00:22:09.400825
198,5511,44567,5165,5300,43817,104360,2022-05-12 00:22:15.813846
26145,7,34,3,51,48,143,2022-05-12 18:17:14.564119
199,19602,1442211,4003,1816,130443,1598075,2022-05-12 00:22:16.161027
200,1787,10408,1650,1706,9824,25375,2022-05-12 00:22:20.046828
201,786,15187,634,528,9154,26289,2022-05-12 00:22:24.631153
202,14531,147460,16011,12831,112212,303045,2022-05-12 00:22:27.756371
205,74448,655771,55138,24336,279091,1088784,2022-05-12 00:22:31.579657
206,1352,12875,1308,1243,12115,28893,2022-05-12 00:22:35.301484
208,1324,41801,907,659,16744,61435,2022-05-12 00:22:43.799343
209,2568,34426,3219,2691,22208,65112,2022-05-12 00:22:47.878176
210,22016,111551,25436,19434,47474,225911,2022-05-12 00:22:50.689357
215,104,1336,74,83,759,2356,2022-05-12 00:22:56.250631
216,80,1594,57,72,879,2682,2022-05-12 00:22:58.076926
218,2652,22177,2368,1927,19707,48831,2022-05-12 00:23:00.614162
222,870,10003,828,1019,6800,19520,2022-05-12 00:23:05.655836
223,48926,725729,33927,29805,61047,899434,2022-05-12 00:23:05.844763
225,12453,487158,8886,24578,32674,565749,2022-05-12 00:23:06.192767
226,43578,1003358,31848,47074,248739,1374597,2022-05-12 00:23:06.538872
228,21001,141442,20082,19571,123265,325361,2022-05-12 00:23:07.184616
241,5820,88141,4413,7788,29882,136044,2022-05-12 00:23:12.902449
243,3005,81474,2546,5550,19173,111748,2022-05-12 00:23:17.098377
245,56058,395705,39885,21715,201505,714868,2022-05-12 00:23:24.584254
246,5560,44739,7001,7690,27883,92873,2022-05-12 00:23:27.045436
248,3651,68069,2885,4787,28199,107591,2022-05-12 00:23:35.927685
249,70867,371109,65136,54167,143292,704571,2022-05-12 00:23:36.125519
250,8709,57167,11480,12355,23238,112949,2022-05-12 00:23:36.28113
251,10301,41317,9904,9660,32206,103388,2022-05-12 00:23:39.328728
253,1524,15538,2129,2019,10635,31845,2022-05-12 00:23:46.177137
255,174,7159,191,142,1877,9543,2022-05-12 00:23:49.069011
256,2456,93672,1111,729,46040,144008,2022-05-12 00:23:49.539532
257,7018,84345,4928,9308,41651,147250,2022-05-12 00:23:52.407935
259,428,6387,338,376,3475,11004,2022-05-12 00:23:57.716351
261,495,8980,360,376,3830,14041,2022-05-12 00:24:02.161867
262,229,6063,155,140,2384,8971,2022-05-12 00:24:04.51235
263,41007,266710,23933,11876,133212,476738,2022-05-12 00:24:04.933412
264,1978,96065,615,444,15344,114446,2022-05-12 00:24:05.087657
265,1290,77107,472,367,12229,91465,2022-05-12 00:24:05.245175
28089,11,72,8,66,82,239,2022-05-12 18:23:24.229929
269,278943,802952,161778,198862,196308,1638843,2022-05-12 00:24:06.080503
277,975,21357,811,719,6701,30563,2022-05-12 00:24:12.664536
278,482,5816,673,1238,2522,10731,2022-05-12 00:24:15.642849
279,1828,10507,1379,1262,19209,34185,2022-05-12 00:24:18.990908
280,205,726,299,386,1044,2660,2022-05-12 00:24:21.939438
281,385,12366,369,671,4268,18059,2022-05-12 00:24:24.273336
282,1072,5551,1122,1252,7242,16239,2022-05-12 00:24:27.03403
283,1524,10146,1275,906,13773,27624,2022-05-12 00:24:30.12396
284,487,6262,542,534,5091,12916,2022-05-12 00:24:33.31173
285,1165,7722,1202,1401,13276,24766,2022-05-12 00:24:35.83001
287,6606,72292,2855,3113,22547,107413,2022-05-12 00:24:39.355926
289,589,9755,814,1075,6003,18236,2022-05-12 00:24:42.191289
291,950,20718,896,941,8660,32165,2022-05-12 00:24:43.468381
292,1082,11885,986,1526,5088,20567,2022-05-12 00:24:48.67591
294,520,5008,482,906,4724,11640,2022-05-12 00:24:51.568385
295,287,3349,270,329,2664,6899,2022-05-12 00:24:54.836618
296,1381,11407,1648,1962,5492,21890,2022-05-12 00:24:57.345697
297,1933,31677,1784,2479,14709,52582,2022-05-12 00:25:00.087994
299,684,22537,1095,921,6668,31905,2022-05-12 00:25:04.066283
300,799,15038,676,819,7987,25319,2022-05-12 00:25:07.357468
301,248,3199,291,461,2548,6747,2022-05-12 00:25:07.602653
303,593,13513,880,1243,4878,21107,2022-05-12 00:25:13.437222
305,150,1983,99,161,1803,4196,2022-05-12 00:25:14.346121
308,881,4192,874,938,11859,18744,2022-05-12 00:25:20.849299
309,272,1787,239,372,2751,5421,2022-05-12 00:25:23.372261
310,47,888,53,178,544,1710,2022-05-12 00:25:25.646488
311,572,3411,498,489,6276,11246,2022-05-12 00:25:28.01777
312,93,829,59,101,886,1968,2022-05-12 00:25:30.520625
313,83,2006,65,109,1410,3673,2022-05-12 00:25:32.500659
314,112,1143,102,107,1116,2580,2022-05-12 00:25:34.498644
315,81,1437,53,97,1251,2919,2022-05-12 00:25:36.484002
317,1558,189080,515,527,11555,203235,2022-05-12 00:25:36.936468
319,154,3795,135,172,1665,5921,2022-05-12 00:25:39.46757
321,591,7659,500,987,4187,13924,2022-05-12 00:25:41.746534
322,7611,109665,5185,5181,64222,191864,2022-05-12 00:25:42.071101
323,18417,163857,13453,9613,151453,356793,2022-05-12 00:25:44.656244
324,2281,10224,1798,1118,17421,32842,2022-05-12 00:25:47.363044
325,3543,60461,2901,6241,19800,92946,2022-05-12 00:25:50.514758
326,1410,37081,926,954,19309,59680,2022-05-12 00:25:50.916124
28119,10,46,7,49,102,214,2022-05-12 18:23:43.059996
328,300,3603,346,675,3382,8306,2022-05-12 00:25:59.33821
329,12829,78192,9870,6817,116943,224651,2022-05-12 00:26:00.302789
330,4773,106822,3494,4715,33076,152880,2022-05-12 00:26:03.376315
331,595,3786,649,607,4215,9852,2022-05-12 00:26:05.852467
332,176,1739,174,224,1365,3678,2022-05-12 00:26:09.41081
334,3542,23693,3362,3508,15609,49714,2022-05-12 00:26:14.205331
335,1658,19766,1921,2083,11007,36435,2022-05-12 00:26:16.781982
336,519,4432,643,962,5737,12293,2022-05-12 00:26:19.332348
337,401,6182,325,540,3297,10745,2022-05-12 00:26:22.039423
338,5308,29376,4385,2665,41512,83246,2022-05-12 00:26:22.454728
339,44282,275347,29263,18669,255072,622633,2022-05-12 00:26:22.606446
340,1252,11820,804,870,8050,22796,2022-05-12 00:26:25.991131
341,2068,27255,2606,2534,15390,49853,2022-05-12 00:26:30.092062
342,635,6040,581,727,6457,14440,2022-05-12 00:26:33.064367
343,4120,34171,4549,5248,22934,71022,2022-05-12 00:26:36.92273
344,333,4388,457,425,4017,9620,2022-05-12 00:26:39.945931
345,2291,20218,1809,1619,25077,51014,2022-05-12 00:26:42.383454
347,339,3574,372,495,2596,7376,2022-05-12 00:26:46.129276
352,621,13379,608,737,3433,18778,2022-05-12 00:26:57.208225
354,438,4049,344,696,3355,8882,2022-05-12 00:27:01.698354
355,22262,310438,19840,22945,129099,504584,2022-05-12 00:27:05.145208
356,35263,596631,23188,27600,177739,860421,2022-05-12 00:27:05.705763
357,4392,133468,3056,6039,35140,182095,2022-05-12 00:27:05.876258
358,788,13183,637,641,9110,24359,2022-05-12 00:27:09.192713
359,139,2689,101,134,2059,5122,2022-05-12 00:27:11.676647
362,105,2057,100,84,1351,3697,2022-05-12 00:27:16.597673
363,94,1621,95,82,1280,3172,2022-05-12 00:27:18.87606
364,762,3538,754,712,7451,13217,2022-05-12 00:27:21.220972
365,264,15104,142,199,3766,19475,2022-05-12 00:27:24.031925
366,1247,17308,877,1505,9670,30607,2022-05-12 00:27:27.486889
367,61,1458,71,97,795,2482,2022-05-12 00:27:29.190075
372,1262,89759,632,441,14046,106140,2022-05-12 00:27:35.963215
374,211,2744,218,288,1778,5239,2022-05-12 00:27:41.553613
376,1702,153782,1007,702,23803,180996,2022-05-12 00:27:44.979512
377,338,5720,219,359,3351,9987,2022-05-12 00:27:48.215316
378,90,3266,66,70,1193,4685,2022-05-12 00:27:50.562881
379,5267,50216,7200,7771,30590,101044,2022-05-12 00:27:53.566187
380,363,16864,296,231,3897,21651,2022-05-12 00:27:56.107876
382,1229,21957,759,950,8323,33218,2022-05-12 00:27:56.883256
390,4316,64483,3553,4665,31634,108651,2022-05-12 00:28:04.960857
392,62268,306211,48857,22348,151246,590930,2022-05-12 00:28:08.949087
393,1226,41043,716,581,19974,63540,2022-05-12 00:28:11.508407
394,1283,42759,1162,1212,9339,55755,2022-05-12 00:28:14.491016
395,2393,119390,1595,2004,24826,150208,2022-05-12 00:28:14.895104
397,603,14609,453,301,5926,21892,2022-05-12 00:28:21.413255
398,412,11308,219,158,4465,16562,2022-05-12 00:28:24.092009
28565,8,32,3,46,45,134,2022-05-12 18:26:14.560292
399,75,1761,58,90,1174,3158,2022-05-12 00:28:26.143704
401,1237,59653,744,464,16028,78126,2022-05-12 00:28:31.613311
402,45,911,36,47,677,1716,2022-05-12 00:28:33.197319
404,1062,19372,802,1163,10073,32472,2022-05-12 00:28:38.511903
405,1449,75250,759,633,23469,101560,2022-05-12 00:28:41.835994
407,1516,16569,1695,1317,11003,32100,2022-05-12 00:28:47.56222
408,589,52325,317,205,9923,63359,2022-05-12 00:28:50.689401
412,2613,46330,2869,4766,16829,73407,2022-05-12 00:28:53.687461
413,795,49422,289,995,10516,62017,2022-05-12 00:28:56.289761
416,2181,171022,1037,595,34591,209426,2022-05-12 00:29:00.159468
418,232,16211,192,123,3277,20035,2022-05-12 00:29:03.317689
419,2162,30695,2729,3404,13851,52841,2022-05-12 00:29:06.861127
421,394,5444,418,540,3992,10788,2022-05-12 00:29:12.92128
422,82,1962,70,63,990,3167,2022-05-12 00:29:13.466831
424,1953,6839,1344,896,15506,26538,2022-05-12 00:29:17.232877
425,137,4135,94,156,1965,6487,2022-05-12 00:29:19.613239
426,313,8215,356,464,4972,14320,2022-05-12 00:29:20.018835
429,227,9798,129,134,3148,13436,2022-05-12 00:29:28.658495
431,12116,991379,3012,1176,102396,1110079,2022-05-12 00:29:29.452697
433,4976,107259,2424,1377,83482,199518,2022-05-12 00:29:37.263131
434,198,4171,89,97,2386,6941,2022-05-12 00:29:40.71628
435,2736,33673,2684,2440,18949,60482,2022-05-12 00:29:43.149713
437,10693,365520,3430,1377,176934,557954,2022-05-12 00:29:43.557361
439,196,4413,167,155,2858,7789,2022-05-12 00:29:49.557776
440,15134,60790,11371,6179,94181,187655,2022-05-12 00:29:50.013131
441,756,30387,426,302,13496,45367,2022-05-12 00:29:52.941393
442,1993,247057,739,605,13025,263419,2022-05-12 00:29:56.711858
443,543,39255,314,213,5203,45528,2022-05-12 00:29:57.22347
444,823,15627,630,585,7460,25125,2022-05-12 00:30:01.27376
445,534,8044,597,724,6245,16144,2022-05-12 00:30:04.484525
448,707,31441,392,251,7458,40249,2022-05-12 00:30:06.382737
29381,8,40,5,47,56,156,2022-05-12 18:31:27.665792
449,935,71374,605,284,12587,85785,2022-05-12 00:30:06.663477
452,943,80079,604,261,11646,93533,2022-05-12 00:30:07.19485
461,657,62650,406,307,8064,72084,2022-05-12 00:30:08.591078
467,19266,185389,17341,9102,132900,363998,2022-05-12 00:30:09.740089
474,1183,25996,623,448,14440,42690,2022-05-12 00:30:14.040501
476,1491,28841,1502,1659,13096,46589,2022-05-12 00:30:18.427784
477,7914,51820,7544,5866,74375,147519,2022-05-12 00:30:22.51148
29383,8,43,8,48,64,171,2022-05-12 18:31:29.534025
481,22377,269378,20385,21317,19329,352786,2022-05-12 00:30:28.542239
482,10791,144035,11019,14862,12878,193585,2022-05-12 00:30:31.598599
483,1467,8660,1561,1345,15668,28701,2022-05-12 00:30:34.141634
484,172,6080,147,123,2740,9262,2022-05-12 00:30:37.693973
485,407,6463,469,600,2587,10526,2022-05-12 00:30:40.540398
486,14889,99857,9950,5899,141341,271936,2022-05-12 00:30:40.941448
487,2174,63892,1681,2048,15558,85353,2022-05-12 00:30:43.805675
488,4248,38877,2785,2272,39548,87730,2022-05-12 00:30:46.574526
490,3450,22593,4515,4439,23151,58148,2022-05-12 00:30:53.160386
492,296,12799,176,124,3410,16805,2022-05-12 00:30:55.79093
495,1161,7784,1073,1254,8118,19390,2022-05-12 00:30:59.078029
496,160,2600,80,108,3153,6101,2022-05-12 00:31:01.660752
497,1293,12239,1177,1629,11412,27750,2022-05-12 00:31:06.194495
498,240,2626,162,149,2975,6152,2022-05-12 00:31:08.179312
499,533,10973,217,169,7354,19246,2022-05-12 00:31:10.858254
501,735,14013,678,1145,2691,19262,2022-05-12 00:31:13.920347
502,548,52983,322,299,5839,59991,2022-05-12 00:31:14.086238
503,165,2014,137,182,1919,4417,2022-05-12 00:31:18.109942
504,243,9350,117,91,2318,12119,2022-05-12 00:31:20.611209
505,610,4774,695,741,3751,10571,2022-05-12 00:31:23.315954
506,352,3097,362,431,3886,8128,2022-05-12 00:31:25.601755
507,337,25530,246,359,4471,30943,2022-05-12 00:31:28.466485
509,1021,24521,1010,1528,7920,36000,2022-05-12 00:31:35.28325
512,5224,419109,1953,690,61643,488619,2022-05-12 00:31:38.627207
513,4810,346160,1919,817,64077,417783,2022-05-12 00:31:39.059151
514,2092,33321,1729,2003,26165,65310,2022-05-12 00:31:39.456107
519,1075,12874,947,1046,8243,24185,2022-05-12 00:31:44.033084
521,2829,51361,2794,4386,9926,71296,2022-05-12 00:31:47.200141
523,10538,791170,3028,1407,109892,916035,2022-05-12 00:31:55.388588
525,865,4415,918,996,9330,16524,2022-05-12 00:32:03.855123
29617,17,1129,8,52,153,1359,2022-05-12 18:32:59.550026
527,37940,410527,34013,54983,23876,561339,2022-05-12 00:32:04.482089
528,1421,229812,322,361,4616,236532,2022-05-12 00:32:06.095214
529,3338,43229,3352,4027,36618,90564,2022-05-12 00:32:09.924856
530,28359,208094,21431,15659,63122,336665,2022-05-12 00:32:10.339001
532,4525,101806,3024,1902,20087,131344,2022-05-12 00:32:14.179271
533,359,3465,460,542,3025,7851,2022-05-12 00:32:16.882108
534,6144,73886,6059,4775,38485,129349,2022-05-12 00:32:17.0488
535,1885,48520,1477,987,12191,65060,2022-05-12 00:32:17.39807
536,274,17916,216,129,4041,22576,2022-05-12 00:32:20.140562
537,194,11960,91,150,2124,14519,2022-05-12 00:32:23.328176
538,1038,23007,1037,1335,7702,34119,2022-05-12 00:32:26.573721
539,1848,30728,943,702,13334,47555,2022-05-12 00:32:29.895381
541,497,14128,345,295,3964,19229,2022-05-12 00:32:35.411801
543,3315,105240,1102,644,43592,153893,2022-05-12 00:32:35.886844
546,441,5189,375,463,4414,10882,2022-05-12 00:32:41.380895
548,720,19284,363,363,12491,33221,2022-05-12 00:32:44.704189
550,7939,169825,6287,8611,22744,215406,2022-05-12 00:32:44.98145
551,2719,49778,1028,888,11390,65803,2022-05-12 00:32:45.295178
552,10321,319181,8020,9395,20601,367518,2022-05-12 00:32:45.457611
558,1255,56179,578,599,7433,66044,2022-05-12 00:32:46.585534
566,1037,12622,663,457,13061,27840,2022-05-12 00:32:54.67136
567,4078,42083,4575,3378,31254,85368,2022-05-12 00:32:57.942108
29831,406,3702,228,183,5253,9772,2022-05-12 18:35:00.974865
568,1528,17320,1748,1605,12389,34590,2022-05-12 00:33:01.456754
569,2406,16649,1886,1390,21246,43577,2022-05-12 00:33:04.05629
570,3838,83761,1364,734,60031,149728,2022-05-12 00:33:04.478476
571,145,1526,100,185,1425,3381,2022-05-12 00:33:06.461994
572,3845,262821,1827,963,58158,327614,2022-05-12 00:33:08.973851
573,1265,17305,1206,1244,8390,29410,2022-05-12 00:33:09.38921
574,160,1422,154,210,1696,3642,2022-05-12 00:33:12.548381
576,1384,20489,1024,1481,8503,32881,2022-05-12 00:33:15.031137
577,394,3032,396,569,3538,7929,2022-05-12 00:33:17.541988
578,7985,426450,3529,1553,132239,571756,2022-05-12 00:33:17.957918
581,305,5798,177,168,3021,9469,2022-05-12 00:33:30.18311
582,795,3412,734,683,6043,11667,2022-05-12 00:33:30.631543
584,3846,32982,4307,3456,40764,85355,2022-05-12 00:33:32.921608
585,4249,219775,1727,632,71091,297474,2022-05-12 00:33:33.366306
586,2613,27896,2442,1876,31747,66574,2022-05-12 00:33:36.610087
587,2535,58426,1743,1533,30705,94942,2022-05-12 00:33:38.900067
589,859,13176,659,639,8814,24147,2022-05-12 00:33:45.696347
592,73,743,96,170,775,1857,2022-05-12 00:33:52.172913
593,1859,13255,1743,1535,22106,40498,2022-05-12 00:33:54.794835
594,788,73739,454,376,8216,83573,2022-05-12 00:33:55.048728
595,189,8526,118,130,3122,12085,2022-05-12 00:33:57.606976
597,2246,194054,967,394,35250,232911,2022-05-12 00:34:04.552849
598,279,5272,348,440,2660,8999,2022-05-12 00:34:09.125122
599,194,2379,143,127,2451,5294,2022-05-12 00:34:11.363485
602,103,957,112,156,1246,2574,2022-05-12 00:34:17.98627
603,3363,21196,2987,2955,11883,42384,2022-05-12 00:34:18.940115
604,480,4551,510,594,4531,10666,2022-05-12 00:34:21.70173
605,338,2308,393,552,3184,6775,2022-05-12 00:34:24.162053
607,361,1894,400,538,3476,6669,2022-05-12 00:34:29.357691
609,367,11017,330,219,5244,17177,2022-05-12 00:34:32.708303
610,940,11450,988,1752,7456,22586,2022-05-12 00:34:35.406622
611,221,927,121,212,2218,3699,2022-05-12 00:34:37.875597
612,350,2648,288,383,2812,6481,2022-05-12 00:34:40.307399
613,433,2201,383,479,2251,5747,2022-05-12 00:34:43.310647
615,601,7328,504,575,6466,15474,2022-05-12 00:34:48.3886
619,112,2576,63,59,1434,4244,2022-05-12 00:34:57.202463
620,1162,10691,1037,1002,10879,24771,2022-05-12 00:35:00.242312
623,294,1677,309,408,3111,5799,2022-05-12 00:35:07.33812
624,918,10932,571,1245,5177,18843,2022-05-12 00:35:09.852703
625,101,1353,77,108,1170,2809,2022-05-12 00:35:13.039591
627,3161,61078,1993,1627,24266,92125,2022-05-12 00:35:19.210788
629,271,4546,224,235,3289,8565,2022-05-12 00:35:21.433211
630,407,4331,388,424,4505,10055,2022-05-12 00:35:21.769859
632,116,4332,105,127,1672,6352,2022-05-12 00:35:27.744196
633,497,4687,347,374,5385,11290,2022-05-12 00:35:30.290287
634,3175,33974,2122,3059,36810,79140,2022-05-12 00:35:30.555768
642,254,14027,241,149,3507,18178,2022-05-12 00:35:41.177156
644,384,21331,422,267,7167,29571,2022-05-12 00:35:43.7279
645,380,17131,200,188,4389,22288,2022-05-12 00:35:44.162019
646,147,1936,184,248,1568,4083,2022-05-12 00:35:46.855962
648,348,3633,264,326,3026,7597,2022-05-12 00:35:49.932007
649,866,14407,604,764,5314,21955,2022-05-12 00:35:52.152905
650,1583,23707,652,400,17144,43486,2022-05-12 00:35:55.114921
654,63,2202,81,62,1087,3495,2022-05-12 00:36:00.584813
656,410,31123,422,285,6792,39032,2022-05-12 00:36:05.282238
658,4776,47022,3942,2862,34041,92643,2022-05-12 00:36:09.067029
659,310,31284,273,178,6188,38233,2022-05-12 00:36:11.514548
660,124,1735,130,156,1236,3381,2022-05-12 00:36:13.315375
664,700,25703,604,461,13584,41052,2022-05-12 00:36:15.193479
665,2587,43469,1491,1634,22636,71817,2022-05-12 00:36:18.960157
666,4584,61667,2146,2701,32915,104013,2022-05-12 00:36:19.295026
667,1888,27273,1667,2621,13476,46925,2022-05-12 00:36:21.924711
668,929,7101,691,1332,5249,15302,2022-05-12 00:36:24.820641
669,272,7143,259,295,3406,11375,2022-05-12 00:36:27.899577
670,1562,22404,1256,1863,12560,39645,2022-05-12 00:36:30.461037
671,322,3405,385,558,3254,7924,2022-05-12 00:36:32.687185
673,200,8154,221,181,2716,11472,2022-05-12 00:36:35.501591
675,149,1527,124,171,1552,3523,2022-05-12 00:36:37.688149
676,96,1035,64,114,953,2262,2022-05-12 00:36:40.036896
677,183,957,138,154,1680,3112,2022-05-12 00:36:42.134654
678,688,5519,624,636,5487,12954,2022-05-12 00:36:44.811422
679,148,3235,94,107,1617,5201,2022-05-12 00:36:47.379497
683,50,1299,53,56,585,2043,2022-05-12 00:36:53.020531
684,191,3040,147,190,1718,5286,2022-05-12 00:36:54.935763
686,86,1543,77,71,1362,3139,2022-05-12 00:36:58.660302
687,6361,86486,7507,10457,24965,135776,2022-05-12 00:37:02.002953
690,2011,13164,2179,2100,16358,35812,2022-05-12 00:37:07.610569
691,1490,3458,1352,898,10941,18139,2022-05-12 00:37:09.982508
693,410,4222,358,450,3524,8964,2022-05-12 00:37:12.196851
694,1141,14177,1001,1224,8142,25685,2022-05-12 00:37:14.929859
695,187,4206,147,184,2493,7217,2022-05-12 00:37:16.743711
704,185,8309,197,183,4193,13067,2022-05-12 00:37:21.079281
705,58,1490,54,52,706,2360,2022-05-12 00:37:22.968117
706,305,5050,409,491,2880,9135,2022-05-12 00:37:25.382574
707,56,2264,91,59,1129,3599,2022-05-12 00:37:27.096333
708,319,2787,262,290,3626,7284,2022-05-12 00:37:29.394515
709,1398,10965,1209,1033,11872,26477,2022-05-12 00:37:29.821246
711,153,2057,76,120,2264,4670,2022-05-12 00:37:33.002244
712,622,8655,630,673,4265,14845,2022-05-12 00:37:36.289039
713,706,43525,683,595,12760,58269,2022-05-12 00:37:39.083311
714,182,1179,224,264,1545,3394,2022-05-12 00:37:41.191336
715,180,2713,112,122,1875,5002,2022-05-12 00:37:44.956585
718,301,3374,206,273,2620,6774,2022-05-12 00:37:49.531474
721,7419,71543,7743,5633,57702,150040,2022-05-12 00:37:57.78004
722,110,3865,73,119,1636,5803,2022-05-12 00:38:00.020224
723,79,2376,63,88,1045,3651,2022-05-12 00:38:02.067552
725,68,1705,35,57,809,2674,2022-05-12 00:38:04.269961
732,1113,54352,523,444,17424,73856,2022-05-12 00:38:15.82728
733,254,7915,142,232,2337,10880,2022-05-12 00:38:18.891566
740,6359,110807,4039,2109,17743,141057,2022-05-12 00:38:20.625543
746,794,41178,255,792,4386,47405,2022-05-12 00:38:27.168141
748,171,2021,94,111,2230,4627,2022-05-12 00:38:31.694953
749,66,619,47,126,406,1264,2022-05-12 00:38:33.734492
751,213,1668,202,355,1513,3951,2022-05-12 00:38:38.204839
752,110,5958,77,154,1466,7765,2022-05-12 00:38:38.459306
754,248,873,324,276,2255,3976,2022-05-12 00:38:40.641594
756,577,25219,432,487,8501,35216,2022-05-12 00:38:42.950002
757,123,2724,81,91,2437,5456,2022-05-12 00:38:45.909769
759,4405,154602,1820,756,85995,247578,2022-05-12 00:38:47.27253
760,423,14624,271,238,5772,21328,2022-05-12 00:38:50.650866
761,616,69400,430,361,8326,79133,2022-05-12 00:38:51.053081
762,1142,100520,600,426,13066,115754,2022-05-12 00:38:51.212897
763,1617,32228,1949,2724,7453,45971,2022-05-12 00:38:53.900311
766,267,5203,173,179,3233,9055,2022-05-12 00:39:03.436359
769,275,5872,231,242,2650,9270,2022-05-12 00:39:07.952457
773,169,1686,104,129,2118,4206,2022-05-12 00:39:13.429972
776,354,4560,399,520,2829,8662,2022-05-12 00:39:15.47836
777,70172,487478,40043,20911,194032,812636,2022-05-12 00:39:15.91541
779,640,58996,217,255,3803,63911,2022-05-12 00:39:16.321542
780,484,52356,210,256,3502,56808,2022-05-12 00:39:16.72676
781,633,53986,250,287,3896,59052,2022-05-12 00:39:17.147356
786,128,2456,107,228,1481,4400,2022-05-12 00:39:20.450152
788,938,18458,400,1107,7302,28205,2022-05-12 00:39:21.630914
789,1494,23491,1519,1837,15714,44055,2022-05-12 00:39:25.483165
790,35160,241565,30268,21762,240576,569331,2022-05-12 00:39:25.843141
791,177,2731,88,105,2769,5870,2022-05-12 00:39:28.290739
792,232,15635,201,125,3138,19331,2022-05-12 00:39:30.535649
793,878,44388,565,300,15022,61153,2022-05-12 00:39:30.971249
795,2676,9405,1648,1206,23585,38520,2022-05-12 00:39:32.077294
796,54,972,29,69,738,1862,2022-05-12 00:39:34.616681
797,185,6930,148,126,1887,9276,2022-05-12 00:39:36.48255
798,526,4871,427,451,6844,13119,2022-05-12 00:39:38.72007
799,241,2310,275,431,2792,6049,2022-05-12 00:39:40.996244
801,8031,124177,5996,2381,69552,210137,2022-05-12 00:39:44.583378
807,496,32704,434,236,9927,43797,2022-05-12 00:39:47.135048
808,219,3564,158,166,2077,6184,2022-05-12 00:39:49.440492
811,751,15547,622,580,7161,24661,2022-05-12 00:39:53.889883
812,1086,12513,1118,1646,12395,28758,2022-05-12 00:39:56.646701
813,42707,938718,23631,28448,54614,1088118,2022-05-12 00:39:57.076058
814,168,11722,97,139,2326,14452,2022-05-12 00:39:59.97291
815,227,17157,122,139,2584,20229,2022-05-12 00:40:04.496893
816,428,5488,361,671,3292,10240,2022-05-12 00:40:07.128212
818,533,6325,474,663,4916,12911,2022-05-12 00:40:11.447174
30931,8,31,2,62,46,149,2022-05-12 18:49:08.084373
819,747,31068,336,472,7998,40621,2022-05-12 00:40:11.815812
820,30033,62683,17523,7117,160796,278152,2022-05-12 00:40:12.252451
821,568,25519,283,289,6409,33068,2022-05-12 00:40:16.837529
824,355,3794,253,353,2915,7670,2022-05-12 00:40:25.328128
825,220,9216,158,202,2172,11968,2022-05-12 00:40:27.529145
831,945,11922,1379,1900,5915,22061,2022-05-12 00:40:30.494755
832,175,761,128,192,1573,2829,2022-05-12 00:40:32.801299
833,588,6046,517,635,4577,12363,2022-05-12 00:40:34.758865
834,1109,91253,642,400,13874,107278,2022-05-12 00:40:35.201937
835,338,4140,352,494,3261,8585,2022-05-12 00:40:37.368544
836,1513,10236,1202,1949,8110,23010,2022-05-12 00:40:38.406788
837,971,18158,668,654,8885,29336,2022-05-12 00:40:41.552752
838,1456,11206,1164,1368,17534,32728,2022-05-12 00:40:42.470347
839,81,1242,49,56,799,2227,2022-05-12 00:40:44.808474
840,782,9390,614,688,6252,17726,2022-05-12 00:40:44.977291
842,679,5978,392,536,5168,12753,2022-05-12 00:40:52.65684
844,136,5461,117,111,2102,7927,2022-05-12 00:40:55.254239
846,4346,111588,4147,3028,26047,149156,2022-05-12 00:41:01.151101
848,68,1638,58,50,965,2779,2022-05-12 00:41:03.610556
849,33631,542198,27345,22957,215917,842048,2022-05-12 00:41:04.57704
850,2732,39380,2334,4077,14400,62923,2022-05-12 00:41:04.903998
851,1999,10785,1209,725,14296,29014,2022-05-12 00:41:05.303782
852,1924,4503,1295,848,11439,20009,2022-05-12 00:41:07.808318
863,1508,17162,1331,2202,12362,34565,2022-05-12 00:41:27.261016
853,46089,763598,32465,30462,131085,1003699,2022-05-12 00:41:08.236162
854,936,10459,774,1417,7515,21101,2022-05-12 00:41:10.889166
855,6889,63844,6428,8456,43800,129417,2022-05-12 00:41:11.051653
857,12800,218931,11492,16448,68461,328132,2022-05-12 00:41:14.715774
858,255,1446,235,405,2092,4433,2022-05-12 00:41:16.916753
859,2157,62837,2677,4704,8472,80847,2022-05-12 00:41:19.745937
861,15614,135252,15054,12813,107811,286544,2022-05-12 00:41:20.801351
864,201,8060,145,168,3093,11667,2022-05-12 00:41:29.676344
865,343,1039,260,214,3045,4901,2022-05-12 00:41:32.183893
866,260,13222,211,127,4442,18262,2022-05-12 00:41:34.782367
867,274,13132,214,132,4143,17895,2022-05-12 00:41:35.121021
869,266,13940,216,125,4144,18691,2022-05-12 00:41:38.179915
870,362,14188,210,232,4165,19157,2022-05-12 00:41:40.556266
872,1608,6796,1526,1342,16302,27574,2022-05-12 00:41:43.098581
873,2409,44041,3064,3777,17501,70792,2022-05-12 00:41:43.511204
874,4192,154977,4125,4525,12642,180461,2022-05-12 00:41:43.679914
875,1548,33745,770,572,34526,71161,2022-05-12 00:41:46.11768
877,42615,235117,27694,21862,215193,542481,2022-05-12 00:41:50.053282
879,1792,12504,1832,2254,20981,39363,2022-05-12 00:41:54.886677
880,1774,46384,1698,1264,11141,62261,2022-05-12 00:41:57.319556
881,250,23083,216,220,2909,26678,2022-05-12 00:41:59.921942
882,515,19631,329,235,7540,28250,2022-05-12 00:42:03.004627
30938,7,28,1,41,53,130,2022-05-12 18:49:16.166395
883,423,17922,325,205,6970,25845,2022-05-12 00:42:05.737685
886,1276,36273,978,1400,8317,48244,2022-05-12 00:42:12.039919
887,74,3219,41,66,1088,4488,2022-05-12 00:42:14.218999
889,40911,523112,28385,18407,256787,867602,2022-05-12 00:42:15.07957
890,1193,6246,1145,814,9499,18897,2022-05-12 00:42:17.535911
891,522,49478,343,302,5825,56470,2022-05-12 00:42:20.241204
892,404,44461,312,266,5557,51000,2022-05-12 00:42:25.043156
893,495,46828,337,276,6360,54296,2022-05-12 00:42:26.856564
894,678,103637,339,280,5360,110294,2022-05-12 00:42:27.176861
895,599,94823,326,282,5505,101535,2022-05-12 00:42:27.341996
896,841,113944,354,318,5825,121282,2022-05-12 00:42:29.987881
897,652,99465,338,294,5720,106469,2022-05-12 00:42:30.149033
898,835,122533,356,296,5889,129909,2022-05-12 00:42:34.424251
900,644,102110,352,282,5822,109210,2022-05-12 00:42:38.36234
902,613,100287,344,272,5818,107334,2022-05-12 00:42:42.687314
30999,6,25,3,48,65,147,2022-05-12 18:50:14.615672
903,789,110418,366,295,5965,117833,2022-05-12 00:42:44.05927
904,704,101126,360,363,6187,108740,2022-05-12 00:42:44.22507
905,925,124882,370,304,6221,132702,2022-05-12 00:42:48.033936
906,852,107500,380,288,6854,115874,2022-05-12 00:42:50.58055
907,2357,37119,2218,3358,15251,60303,2022-05-12 00:42:51.533474
908,922,47765,868,488,16568,66611,2022-05-12 00:42:51.701038
911,135,4262,124,98,1999,6618,2022-05-12 00:43:03.628106
912,452,1346,519,498,3070,5885,2022-05-12 00:43:05.614817
913,398,1629,337,476,2632,5472,2022-05-12 00:43:08.169331
914,1059,4918,768,1097,8002,15844,2022-05-12 00:43:10.863147
915,492,9127,489,582,3382,14072,2022-05-12 00:43:13.36435
917,496,11017,195,103,6896,18707,2022-05-12 00:43:19.149711
918,181431,284353,107389,47307,317301,937781,2022-05-12 00:43:19.414564
920,88,3488,71,58,1286,4991,2022-05-12 00:43:22.127923
925,180,2166,158,209,953,3666,2022-05-12 00:43:28.25544
926,116,1546,124,143,784,2713,2022-05-12 00:43:30.787316
927,170,3476,135,332,877,4990,2022-05-12 00:43:33.445682
929,764,2294,594,442,6520,10614,2022-05-12 00:43:38.102328
930,905,3739,654,406,8387,14091,2022-05-12 00:43:40.610919
933,1003,14858,640,813,12753,30067,2022-05-12 00:43:47.311851
934,43948,414413,37123,34425,200119,730028,2022-05-12 00:43:47.503754
936,1627,194162,760,613,14105,211267,2022-05-12 00:43:52.249736
938,170,3341,70,122,1553,5256,2022-05-12 00:43:58.225076
35172,7,46,2,61,40,156,2022-05-12 19:49:30.569999
941,1770,11783,1217,1252,13857,29879,2022-05-12 00:44:01.643373
942,926,7421,782,917,7452,17498,2022-05-12 00:44:03.803755
943,352,3021,430,655,3982,8440,2022-05-12 00:44:05.771102
944,1042,8965,1238,1146,7888,20279,2022-05-12 00:44:07.580867
949,4012,56885,2182,1264,46237,110580,2022-05-12 00:44:11.595445
950,162,10805,89,95,1938,13089,2022-05-12 00:44:13.989388
951,872,5240,1023,1309,2278,10722,2022-05-12 00:44:16.675866
953,2153,38990,1716,2001,23284,68144,2022-05-12 00:44:17.721119
957,6247,39061,5342,4389,33241,88280,2022-05-12 00:44:23.301655
959,489,3423,304,462,3742,8420,2022-05-12 00:44:28.832402
960,159,1950,135,174,1167,3585,2022-05-12 00:44:31.050316
961,576,5158,480,417,2958,9589,2022-05-12 00:44:33.442598
962,3841,32445,2974,1672,31176,72108,2022-05-12 00:44:33.862765
963,325,30623,262,172,4893,36275,2022-05-12 00:44:37.737048
964,227,3017,207,315,2132,5898,2022-05-12 00:44:39.987165
965,219,1825,204,323,2151,4722,2022-05-12 00:44:42.376234
966,27581,11,15355,16069,12481,71497,2022-05-12 00:44:42.544188
967,12509,38647,10552,6399,48688,116795,2022-05-12 00:44:43.455384
970,265,2487,285,304,2231,5572,2022-05-12 00:44:53.280452
971,868,12378,1195,1802,4408,20651,2022-05-12 00:44:56.671498
973,525,3870,540,838,5477,11250,2022-05-12 00:44:59.318882
974,1514,47292,689,582,33753,83830,2022-05-12 00:45:02.174509
975,1179,15497,511,290,16068,33545,2022-05-12 00:45:05.691355
976,505,10027,239,145,6507,17423,2022-05-12 00:45:08.730379
978,658,6442,415,349,5515,13379,2022-05-12 00:45:11.360856
980,252,1510,257,425,2297,4741,2022-05-12 00:45:16.815169
982,280,7253,296,504,3499,11832,2022-05-12 00:45:21.529334
984,522,38671,307,302,5477,45279,2022-05-12 00:45:24.113871
985,797,89441,290,287,5102,95917,2022-05-12 00:45:26.987561
986,618,85925,301,260,4716,91820,2022-05-12 00:45:27.157177
987,613,60747,312,391,5680,67743,2022-05-12 00:45:29.320717
988,82,338,61,99,1016,1596,2022-05-12 00:45:32.268511
989,35,342,17,42,440,876,2022-05-12 00:45:34.258709
990,1530,28283,1345,1702,12985,45845,2022-05-12 00:45:37.018578
991,334,3217,154,265,2212,6182,2022-05-12 00:45:37.489833
993,98,3943,74,75,917,5107,2022-05-12 00:45:41.967188
994,71,1632,42,56,1107,2908,2022-05-12 00:45:45.63895
996,2467,74895,2013,1244,20490,101109,2022-05-12 00:45:49.18772
998,1238,12457,1188,1313,10958,27154,2022-05-12 00:45:53.924209
999,150,3654,162,119,1987,6072,2022-05-12 00:45:56.674293
1000,2162,10979,2082,1257,16248,32728,2022-05-12 00:45:58.944559
1001,41,1231,42,29,475,1818,2022-05-12 00:46:00.432551
1002,2326,40893,1409,981,25296,70905,2022-05-12 00:46:04.216201
1003,382,20701,368,219,4091,25761,2022-05-12 00:46:06.341961
1004,1359,67859,494,227,21582,91521,2022-05-12 00:46:07.373233
1005,468,7086,585,825,3203,12167,2022-05-12 00:46:10.205039
1006,432,16817,212,157,4400,22018,2022-05-12 00:46:12.368974
1008,266,13246,215,158,3682,17567,2022-05-12 00:46:16.797039
1009,65,2109,59,94,912,3239,2022-05-12 00:46:20.689301
1010,241,11587,180,121,3193,15322,2022-05-12 00:46:21.006917
1011,356,12844,235,173,3940,17548,2022-05-12 00:46:21.445647
1012,39,1128,17,61,364,1609,2022-05-12 00:46:23.112132
1014,104,3400,114,105,1460,5183,2022-05-12 00:46:29.311192
1015,733,56010,498,269,10893,68403,2022-05-12 00:46:31.720515
1017,2502,18191,2044,2067,15917,40721,2022-05-12 00:46:35.430515
1018,694,9121,594,625,5591,16625,2022-05-12 00:46:37.800663
1020,258,5583,188,232,3759,10020,2022-05-12 00:46:43.471129
1021,719,4388,661,895,5773,12436,2022-05-12 00:46:45.724705
1023,1044,43481,732,490,15217,60964,2022-05-12 00:46:48.956566
1025,1282,8644,1071,1087,16344,28428,2022-05-12 00:46:53.194264
1026,126,1798,76,92,1917,4009,2022-05-12 00:46:53.646234
1028,242,5291,173,142,5692,11540,2022-05-12 00:46:58.053825
1029,1908,80802,1101,809,36670,121290,2022-05-12 00:47:00.357189
1030,1046,69231,658,565,19686,91186,2022-05-12 00:47:03.373651
1031,56,1537,33,71,862,2559,2022-05-12 00:47:05.900047
1032,133,3999,84,73,2787,7076,2022-05-12 00:47:08.279421
1033,3166,86842,1426,595,63582,155611,2022-05-12 00:47:08.731419
1035,199,1323,212,353,1588,3675,2022-05-12 00:47:13.151061
1036,106,2960,80,116,1593,4855,2022-05-12 00:47:15.558686
1037,341,3577,287,556,3887,8648,2022-05-12 00:47:17.596741
1040,294,1170,253,296,2110,4123,2022-05-12 00:47:22.566128
1041,196,8953,93,182,2466,11890,2022-05-12 00:47:24.952485
1042,163,8055,76,179,1673,10146,2022-05-12 00:47:27.515516
1044,128,4710,91,108,2538,7575,2022-05-12 00:47:31.804962
1045,977,12262,883,1226,8175,23523,2022-05-12 00:47:34.141841
1046,337,8321,336,274,2811,12079,2022-05-12 00:47:37.06344
1047,473,22112,178,111,8559,31433,2022-05-12 00:47:39.766419
1048,1052,8931,1193,1845,11246,24267,2022-05-12 00:47:42.112927
1049,230,6327,165,141,6294,13157,2022-05-12 00:47:45.161384
1051,1598,28100,966,1007,19917,51588,2022-05-12 00:47:50.220685
1053,155,1604,71,106,1276,3212,2022-05-12 00:47:52.765308
1056,132,4599,69,87,1487,6374,2022-05-12 00:47:58.558362
1058,73,790,56,77,790,1786,2022-05-12 00:48:02.696571
1059,56,1842,42,105,725,2770,2022-05-12 00:48:04.758306
1060,2966,22063,2232,2171,17664,47096,2022-05-12 00:48:07.954471
1066,494,25673,548,431,6661,33807,2022-05-12 00:48:16.512049
1067,1901,16469,1512,2417,12659,34958,2022-05-12 00:48:20.875932
1068,200,1245,195,206,1323,3169,2022-05-12 00:48:24.474644
1072,1229,18611,1435,854,13844,35973,2022-05-12 00:48:34.945016
1074,658,64297,475,400,8636,74466,2022-05-12 00:48:35.315495
1075,52,1112,28,53,601,1846,2022-05-12 00:48:38.841339
1076,78,1615,34,57,917,2701,2022-05-12 00:48:40.764852
1079,1042,16768,549,500,11536,30395,2022-05-12 00:48:46.907754
1080,801,7483,533,538,7619,16974,2022-05-12 00:48:50.304502
1081,325,3216,224,177,3539,7481,2022-05-12 00:48:52.646325
1083,163,928,150,174,2143,3558,2022-05-12 00:48:55.546048
1085,479,6110,312,307,5726,12934,2022-05-12 00:48:58.332252
1087,3194,12545,2404,1833,21602,41578,2022-05-12 00:49:01.872683
1089,966,25824,442,303,14435,41970,2022-05-12 00:49:05.143129
1091,435,22239,274,204,4932,28084,2022-05-12 00:49:11.262331
1092,477,21507,230,221,5572,28007,2022-05-12 00:49:11.70312
1093,433,378,230,175,1690,2906,2022-05-12 00:49:12.716671
1094,448,25608,330,235,5903,32524,2022-05-12 00:49:12.948496
1096,826,17665,310,179,11528,30508,2022-05-12 00:49:15.957457
1097,604,4038,361,629,4305,9937,2022-05-12 00:49:17.844561
1098,433,5081,459,771,2835,9579,2022-05-12 00:49:19.660576
1099,55,1126,33,80,795,2089,2022-05-12 00:49:21.400282
1100,178,1497,125,134,2652,4586,2022-05-12 00:49:23.876134
1101,252,11206,172,118,2949,14697,2022-05-12 00:49:26.348985
1103,979,5416,673,858,8068,15994,2022-05-12 00:49:32.396475
1105,117,3575,84,111,2165,6052,2022-05-12 00:49:38.017061
1107,1288,22087,444,310,19566,43695,2022-05-12 00:49:43.423936
1109,166,6192,134,197,3380,10069,2022-05-12 00:49:46.958468
1110,1081,31462,1220,1479,4898,40140,2022-05-12 00:49:47.159483
1116,140,2602,71,95,2927,5835,2022-05-12 00:49:57.935295
1117,891,166947,269,290,4151,172548,2022-05-12 00:49:58.410765
1118,858,156997,270,312,4278,162715,2022-05-12 00:50:00.879359
1119,713,134494,290,359,4238,140094,2022-05-12 00:50:02.424957
1120,580,102326,268,287,4406,107867,2022-05-12 00:50:06.014095
1121,370,83208,248,254,4127,88207,2022-05-12 00:50:09.418702
1122,485,97514,280,282,4420,102981,2022-05-12 00:50:12.075854
1123,301,4597,370,381,1675,7324,2022-05-12 00:50:14.937669
1124,167,5418,110,81,2283,8059,2022-05-12 00:50:17.404631
1126,557,3673,653,551,6802,12236,2022-05-12 00:50:19.423503
1127,908,9215,747,998,6808,18676,2022-05-12 00:50:21.899354
1129,97,2305,72,65,994,3533,2022-05-12 00:50:26.211538
1130,185,4603,114,114,3373,8389,2022-05-12 00:50:28.254054
1132,2922,123808,3036,4972,9126,143864,2022-05-12 00:50:28.593249
1133,1160,18438,1008,1369,6673,28648,2022-05-12 00:50:30.854033
1136,667,4742,786,845,6492,13532,2022-05-12 00:50:35.718243
1137,500,9770,587,709,3128,14694,2022-05-12 00:50:38.008166
1138,2031,38811,2412,3265,7132,53651,2022-05-12 00:50:40.638914
1139,36,355,31,104,253,779,2022-05-12 00:50:42.096643
1141,153,3244,96,131,3201,6825,2022-05-12 00:50:46.528461
1142,2262,64224,2056,1375,29739,99656,2022-05-12 00:50:48.11608
1143,268,16182,264,276,5275,22265,2022-05-12 00:50:48.281256
1144,277,11037,192,113,3541,15160,2022-05-12 00:50:50.561268
1145,621,3180,536,566,8094,12997,2022-05-12 00:50:52.895152
1147,227,7476,153,127,2937,10920,2022-05-12 00:50:56.781903
18,8073,114518,3970,1695,22448,150704,2022-05-12 14:20:23.859741
26,13626,54334,11002,9176,129489,217627,2022-05-12 14:20:28.455562
27,8475,93116,9294,9917,50291,171093,2022-05-12 14:20:28.658688
28,5830,43600,6259,5023,28996,89708,2022-05-12 14:20:32.637618
30,96918,1084018,47188,27004,282776,1537904,2022-05-12 14:20:35.956876
31,2592,183618,1348,1186,40541,229285,2022-05-12 14:20:40.028785
32,11631,655987,3296,2003,103393,776310,2022-05-12 14:20:40.185034
33,26701,338756,15317,10697,142284,533755,2022-05-12 14:20:40.525656
43,10171,372490,4194,2219,162074,551148,2022-05-12 14:20:40.947605
46,656,36932,482,270,9909,48249,2022-05-12 14:20:41.510105
71,19748,285882,17539,15646,116866,455681,2022-05-12 14:20:45.385374
94,2569,76594,2421,2956,13670,98210,2022-05-12 14:20:48.742254
102,4086,64169,4217,5377,19297,97146,2022-05-12 14:20:54.437197
104,2313,33184,2629,3643,16072,57841,2022-05-12 14:20:55.343447
106,2852,28514,2410,3472,18499,55747,2022-05-12 14:20:56.382346
111,593,7754,785,1055,4081,14268,2022-05-12 14:20:57.332173
123,5721,58924,6000,6503,31565,108713,2022-05-12 14:21:02.484203
124,299,12398,244,255,3581,16777,2022-05-12 14:21:05.493943
128,248,6150,288,293,2979,9958,2022-05-12 14:21:09.992917
143,2597,35848,2141,3262,21800,65648,2022-05-12 14:21:12.380003
149,4621,87482,4285,9687,26364,132439,2022-05-12 14:21:13.39499
173,2243,16336,2514,2407,15385,38885,2022-05-12 14:21:16.938624
190,879,69730,620,509,9767,81505,2022-05-12 14:21:19.3605
207,3388,26991,2106,1799,25866,60150,2022-05-12 14:21:21.753767
35173,6,23,0,42,37,108,2022-05-12 19:49:31.6433
219,295,10482,195,124,3604,14700,2022-05-12 14:21:23.006281
227,26937,473866,17976,15709,191004,725492,2022-05-12 14:21:24.462925
233,1529,12380,1952,1634,5467,22962,2022-05-12 14:21:28.88077
234,205,1993,179,317,1169,3863,2022-05-12 14:21:33.351999
235,140228,5,65220,42948,57941,306342,2022-05-12 14:21:33.603871
236,690,8566,857,1090,4357,15560,2022-05-12 14:21:37.948685
237,21406,203601,22541,18808,142853,409209,2022-05-12 14:21:38.292469
239,11347,76893,9788,7056,119798,224882,2022-05-12 14:21:41.677778
240,6171,83412,5326,4927,65678,165514,2022-05-12 14:21:42.037163
244,434,2214,544,671,3174,7037,2022-05-12 14:21:42.755912
252,1778,15084,1947,2146,17366,38321,2022-05-12 14:21:44.115288
258,516,7821,407,534,7073,16351,2022-05-12 14:21:45.181178
265,1302,77412,474,370,12282,91840,2022-05-12 14:21:46.246017
35174,6,20,0,36,35,97,2022-05-12 19:49:32.697866
273,1077,8255,1017,1084,13130,24563,2022-05-12 14:21:50.78692
274,1670,23448,2020,2578,13439,43155,2022-05-12 14:21:55.614213
275,775,12316,588,954,6169,20802,2022-05-12 14:22:00.259152
276,2325,32873,1981,1927,19008,58114,2022-05-12 14:22:00.605368
339,44661,277071,29488,18776,256648,626644,2022-05-12 14:22:10.06315
373,362,5653,407,435,3872,10729,2022-05-12 14:22:15.059949
388,1254,13086,993,1130,7351,23814,2022-05-12 14:22:21.458256
389,2228,32987,2350,2079,21418,61062,2022-05-12 14:22:21.802007
391,576,13394,568,402,6935,21875,2022-05-12 14:22:22.303522
403,1256,18215,862,1250,7959,29542,2022-05-12 14:22:24.188035
469,5891,117115,5284,7573,32055,167918,2022-05-12 14:22:37.906774
470,1355,12878,884,1412,9285,25814,2022-05-12 14:22:38.375523
471,872,8955,718,792,8320,19657,2022-05-12 14:22:41.707131
472,1053,11666,947,1251,9918,24835,2022-05-12 14:22:45.869276
478,3254,39123,2650,3625,23207,71859,2022-05-12 14:22:53.294953
493,238,10081,137,135,3055,13646,2022-05-12 14:22:57.8483
517,808,44620,559,351,9880,56218,2022-05-12 14:23:06.609736
518,411,2340,396,423,3564,7134,2022-05-12 14:23:08.235297
520,172,6324,137,101,3155,9889,2022-05-12 14:23:08.696874
521,2832,51602,2813,4401,9993,71641,2022-05-12 14:23:08.868748
526,586,6597,416,383,8972,16954,2022-05-12 14:23:09.85303
547,77,1625,83,80,914,2779,2022-05-12 14:23:17.752717
555,272,7162,279,503,3044,11260,2022-05-12 14:23:21.81569
557,144,4568,111,112,1559,6494,2022-05-12 14:23:27.086955
559,128,4279,119,87,2362,6975,2022-05-12 14:23:31.624964
562,86,1265,78,67,1179,2675,2022-05-12 14:23:40.758303
563,1341,24935,1218,1700,10686,39880,2022-05-12 14:23:43.802485
565,1312,48824,645,389,23363,74533,2022-05-12 14:23:46.734766
591,2984,44905,2700,4906,14825,70320,2022-05-12 14:23:50.428002
681,63,1220,33,44,625,1985,2022-05-12 14:24:02.508908
688,776,11221,807,1118,9817,23739,2022-05-12 14:24:03.727657
696,3057,43535,2380,2230,19984,71186,2022-05-12 14:24:04.895538
710,2776,69693,2171,2295,30421,107356,2022-05-12 14:24:10.280589
734,148,4859,62,125,1455,6649,2022-05-12 14:24:13.25288
758,297,9303,232,164,4558,14554,2022-05-12 14:24:15.682058
765,46,1334,53,53,638,2124,2022-05-12 14:24:16.82826
810,143,1263,167,270,1393,3236,2022-05-12 14:24:22.797385
840,779,9420,618,689,6280,17786,2022-05-12 14:24:26.404108
876,950,17271,864,991,4824,24900,2022-05-12 14:24:31.289921
899,636,106923,349,257,5465,113630,2022-05-12 14:24:39.0326
901,1025,136021,398,325,6276,144045,2022-05-12 14:24:39.563848
921,149,3518,135,98,1885,5785,2022-05-12 14:24:47.693238
940,3116,35326,2768,3647,21540,66397,2022-05-12 14:24:53.578253
956,118,775,101,156,1014,2164,2022-05-12 14:24:55.181554
981,457,20544,364,269,4315,25949,2022-05-12 14:24:58.76863
1050,5545,35861,7309,10242,25482,84439,2022-05-12 14:25:09.585438
1078,266,23719,238,175,5390,29788,2022-05-12 14:25:13.190859
1152,358,5737,263,179,3278,9815,2022-05-12 14:25:28.179613
1153,475,4128,383,431,4757,10174,2022-05-12 14:25:33.165705
1154,46,667,24,42,542,1321,2022-05-12 14:25:36.769807
1156,316,4811,210,290,3981,9608,2022-05-12 14:25:42.048207
1157,1212,18087,1952,3834,9520,34605,2022-05-12 14:25:45.368134
1159,65,944,56,50,575,1690,2022-05-12 14:25:47.90765
1160,138,1907,70,91,1466,3672,2022-05-12 14:25:50.235014
1161,331,2295,378,429,2654,6087,2022-05-12 14:25:52.469307
1162,106,1718,80,96,1107,3107,2022-05-12 14:25:56.232164
1164,957,10550,916,819,6661,19903,2022-05-12 14:26:03.383833
1165,167,2856,127,134,2026,5310,2022-05-12 14:26:07.019058
1166,141,2206,110,103,1673,4233,2022-05-12 14:26:09.308514
1167,475,3189,384,629,3947,8624,2022-05-12 14:26:11.818753
1168,361,4805,355,215,2843,8579,2022-05-12 14:26:14.476042
1170,294,13639,274,144,3896,18247,2022-05-12 14:26:20.330903
1171,321,13992,273,163,4327,19076,2022-05-12 14:26:24.742175
1172,1257,38869,1147,702,9217,51192,2022-05-12 14:26:27.45565
1174,478,10498,273,237,7486,18972,2022-05-12 14:26:31.101183
1175,162,1227,154,210,2099,3852,2022-05-12 14:26:33.451798
1176,95,804,38,69,845,1851,2022-05-12 14:26:35.42981
1177,968,17797,614,676,12970,33025,2022-05-12 14:26:38.279785
1178,182,2983,133,151,2196,5645,2022-05-12 14:26:40.884858
1179,392,2070,359,314,3503,6638,2022-05-12 14:26:43.447796
1180,578,3352,496,525,4623,9574,2022-05-12 14:26:46.155887
1181,281,4223,173,154,2892,7723,2022-05-12 14:26:46.397437
1182,410,5476,368,421,4512,11187,2022-05-12 14:26:48.925047
1183,207,2154,119,165,1758,4403,2022-05-12 14:26:51.246919
1185,187,2843,161,236,2008,5435,2022-05-12 14:26:55.2139
1186,353,4003,341,520,3347,8564,2022-05-12 14:26:57.960193
1188,105,1072,76,145,1095,2493,2022-05-12 14:27:00.497215
1189,282,2849,364,427,2164,6086,2022-05-12 14:27:02.482064
1190,153,12728,91,111,2117,15200,2022-05-12 14:27:05.978124
1191,236,8202,213,158,2138,10947,2022-05-12 14:27:08.872906
1192,489,24712,275,208,9966,35650,2022-05-12 14:27:11.921335
1194,855,9741,1041,1343,6399,19379,2022-05-12 14:27:12.739362
1195,22422,568565,12425,21175,122259,746846,2022-05-12 14:27:13.017343
1206,162,3007,97,85,3755,7106,2022-05-12 14:27:19.060911
1207,136,2320,85,82,2512,5135,2022-05-12 14:27:22.545275
1210,35347,343583,27067,18139,219882,644018,2022-05-12 14:27:26.32981
1212,1499,30543,1406,1320,12217,46985,2022-05-12 14:27:34.439709
1215,373,16064,321,261,4636,21655,2022-05-12 14:27:40.11045
1216,125,6976,72,152,2026,9351,2022-05-12 14:27:43.166756
1218,1728,29119,1294,1941,11931,46013,2022-05-12 14:27:46.040128
1221,1721,14428,2392,4251,7795,30587,2022-05-12 14:27:56.898085
1223,81,6698,59,86,1802,8726,2022-05-12 14:27:59.767946
1225,298,9514,239,201,3277,13529,2022-05-12 14:28:05.463377
1226,373,3451,319,505,3763,8411,2022-05-12 14:28:08.007138
1227,165,1117,83,130,1500,2995,2022-05-12 14:28:10.396888
1228,122,1862,67,97,1280,3428,2022-05-12 14:28:12.531939
1230,1032,12387,1138,1186,9902,25645,2022-05-12 14:28:15.201955
1231,352,9713,418,424,2681,13588,2022-05-12 14:28:16.60585
1233,294,3536,221,283,2787,7121,2022-05-12 14:28:19.343729
1234,128,2476,115,122,1158,3999,2022-05-12 14:28:21.438006
1235,142,4573,129,102,1469,6415,2022-05-12 14:28:23.733682
1236,151,894,198,245,907,2395,2022-05-12 14:28:25.62563
1238,405,20554,313,232,5916,27420,2022-05-12 14:28:26.627511
1239,2821,81034,2225,1342,18424,105846,2022-05-12 14:28:26.831134
1240,383,30799,291,209,6096,37778,2022-05-12 14:28:27.192023
1248,193,5250,117,116,2950,8626,2022-05-12 14:28:30.133788
1250,3932,54685,4253,4728,22930,90528,2022-05-12 14:28:34.042073
1251,3162,20788,2838,1776,29559,58123,2022-05-12 14:28:37.157866
1254,11039,108364,8887,8653,31360,168303,2022-05-12 14:28:44.711031
1256,212,14494,142,123,2667,17638,2022-05-12 14:28:52.751001
1257,1122,43069,582,545,6450,51768,2022-05-12 14:28:56.162947
1258,201,12723,145,126,2701,15896,2022-05-12 14:28:58.938444
1260,214,11781,136,125,2658,14914,2022-05-12 14:29:04.220595
1261,473,5989,845,1264,3592,12163,2022-05-12 14:29:06.697337
1267,65,1158,46,74,812,2155,2022-05-12 14:29:17.894779
1269,318,7009,142,113,4778,12360,2022-05-12 14:29:22.151761
1270,358,8241,134,108,5069,13910,2022-05-12 14:29:24.93575
1271,168,2433,92,118,1652,4463,2022-05-12 14:29:27.161246
1276,332,3219,216,276,3369,7412,2022-05-12 14:29:29.319895
1277,149,2479,109,106,2034,4877,2022-05-12 14:29:32.283896
1278,256,17988,215,178,5039,23676,2022-05-12 14:29:34.863866
1279,400,6467,370,409,3862,11508,2022-05-12 14:29:37.862969
1280,422,5276,426,505,4290,10919,2022-05-12 14:29:39.882561
1281,18197,77267,12645,6574,52589,167272,2022-05-12 14:29:43.066686
1283,77,2425,81,90,1183,3856,2022-05-12 14:29:45.008892
1285,332,9096,154,143,4899,14624,2022-05-12 14:29:50.059496
1286,130,5612,78,73,1591,7484,2022-05-12 14:29:52.138424
1287,95,1460,87,83,1372,3097,2022-05-12 14:29:54.219697
1292,9064,228381,5849,6599,81638,331531,2022-05-12 14:30:01.727375
1293,8161,12383,6497,4303,38422,69766,2022-05-12 14:30:02.173704
1295,143,3024,87,109,1495,4858,2022-05-12 14:30:05.21791
1296,119,3968,63,64,1350,5564,2022-05-12 14:30:07.045423
1297,99,3459,60,54,1231,4903,2022-05-12 14:30:09.043863
1298,91,3254,63,50,1250,4708,2022-05-12 14:30:10.254495
1299,883,4407,987,1029,11618,18924,2022-05-12 14:30:12.738659
1301,396,9067,225,187,7691,17566,2022-05-12 14:30:15.926061
1313,3380,187700,3019,3723,9993,207815,2022-05-12 14:30:25.840266
1316,557,11258,318,601,2346,15080,2022-05-12 14:30:29.127932
1317,155,5446,109,139,2384,8233,2022-05-12 14:30:29.322148
1324,307,4874,265,373,4055,9874,2022-05-12 14:30:32.128092
1325,247,1945,325,481,2988,5986,2022-05-12 14:30:34.641378
1327,733,7208,662,739,3716,13058,2022-05-12 14:30:34.808451
1328,98,2372,46,62,1432,4010,2022-05-12 14:30:37.122956
1333,33,453,51,135,228,900,2022-05-12 14:30:39.342165
1335,415,17066,503,391,6254,24629,2022-05-12 14:30:40.534663
1336,206,5112,168,193,2080,7759,2022-05-12 14:30:42.705903
1337,194,816,202,388,2042,3642,2022-05-12 14:30:45.070708
1338,204,3342,89,104,2711,6450,2022-05-12 14:30:48.08217
1340,80,2019,37,73,1178,3387,2022-05-12 14:30:50.220576
1341,283,6611,124,163,3896,11077,2022-05-12 14:30:52.499969
1343,157,5160,83,123,2185,7708,2022-05-12 14:30:57.266971
1344,127,2132,83,125,1472,3939,2022-05-12 14:30:59.27258
1345,91,2342,43,124,1274,3874,2022-05-12 14:31:01.405773
1346,527,7613,291,280,6512,15223,2022-05-12 14:31:03.514895
1348,298,5804,183,147,3680,10112,2022-05-12 14:31:08.315952
1349,458,5182,362,568,4074,10644,2022-05-12 14:31:10.945988
1350,630,6315,268,229,8285,15727,2022-05-12 14:31:13.440728
1352,1008,11772,434,284,11001,24499,2022-05-12 14:31:16.634159
1355,44,392,28,44,457,965,2022-05-12 14:31:18.341091
1356,986,15471,767,500,10060,27784,2022-05-12 14:31:20.807981
1358,318,14539,189,144,4108,19298,2022-05-12 14:31:27.077122
1361,334,63968,169,302,3554,68327,2022-05-12 14:31:29.693491
1362,367,22504,141,109,3878,26999,2022-05-12 14:31:32.147127
1363,622,50530,242,291,3946,55631,2022-05-12 14:31:32.927022
1364,650,51362,261,301,4141,56715,2022-05-12 14:31:33.345907
1365,1206,60952,413,516,6228,69315,2022-05-12 14:31:36.30578
1366,470,42030,216,234,3496,46446,2022-05-12 14:31:36.720052
1367,554,45372,250,299,4142,50617,2022-05-12 14:31:37.142921
1369,234,15811,128,142,2323,18638,2022-05-12 14:31:40.243036
1371,349,2606,367,366,4915,8603,2022-05-12 14:31:45.260761
1373,126,2924,137,128,1860,5175,2022-05-12 14:31:46.646938
1374,1000,11157,843,948,6476,20424,2022-05-12 14:31:47.687679
1376,321,6372,206,240,2117,9256,2022-05-12 14:31:50.835913
1378,119,3030,73,85,1523,4830,2022-05-12 14:31:53.648192
1379,1072,31342,593,278,18782,52067,2022-05-12 14:31:54.080671
1380,223,6806,150,154,3266,10599,2022-05-12 14:31:56.642691
1381,68,2046,55,90,1249,3508,2022-05-12 14:31:58.608586
1382,282,4898,189,218,3329,8916,2022-05-12 14:32:00.605877
1391,405,2369,274,255,3335,6638,2022-05-12 14:32:05.464041
1393,67,1456,39,76,747,2385,2022-05-12 14:32:09.678014
1394,78,1294,49,67,805,2293,2022-05-12 14:32:11.886944
1396,28,250,17,48,335,678,2022-05-12 14:32:15.617027
1397,1392,13126,1368,1296,10493,27675,2022-05-12 14:32:17.810713
1398,304,6936,247,177,4744,12408,2022-05-12 14:32:19.600708
1399,170,5672,154,125,2376,8497,2022-05-12 14:32:21.585568
1400,144,5678,150,99,2464,8535,2022-05-12 14:32:23.771982
1409,118,2242,104,132,1392,3988,2022-05-12 14:32:25.897062
1411,116,1253,77,125,867,2438,2022-05-12 14:32:28.883854
1412,6311,33006,4994,3070,43422,90803,2022-05-12 14:32:29.073003
1413,132,4045,104,95,2458,6834,2022-05-12 14:32:34.859137
1414,107,3545,97,88,2200,6037,2022-05-12 14:32:36.935743
1418,183,6147,118,118,3085,9651,2022-05-12 14:32:46.735728
1420,125,3551,98,88,2070,5932,2022-05-12 14:32:50.121681
1423,103,3338,93,89,2102,5725,2022-05-12 14:32:55.610796
1426,880,7567,688,439,9506,19080,2022-05-12 14:33:02.537147
1429,104,3140,90,91,2111,5536,2022-05-12 14:33:07.377557
1430,1373,82090,540,354,17599,101956,2022-05-12 14:33:07.559175
1432,164,6351,112,111,3008,9746,2022-05-12 14:33:10.665728
1433,143,4922,111,112,2420,7708,2022-05-12 14:33:12.711075
1434,106,3914,91,97,2100,6308,2022-05-12 14:33:14.587158
1435,211,8194,124,119,3292,11940,2022-05-12 14:33:16.772705
1436,122,4267,89,95,2108,6681,2022-05-12 14:33:18.517121
1437,112,4286,100,102,2435,7035,2022-05-12 14:33:20.041864
1438,138,4185,102,91,2397,6913,2022-05-12 14:33:21.802972
1439,138,4543,115,106,2600,7502,2022-05-12 14:33:23.452772
1441,424,9345,265,214,10224,20472,2022-05-12 14:33:29.07701
1442,277,3575,224,735,2574,7385,2022-05-12 14:33:32.069914
1445,595,7632,872,1548,2931,13578,2022-05-12 14:33:40.087876
1448,555,6471,680,967,2647,11320,2022-05-12 14:33:43.187143
1452,63,1356,23,49,693,2184,2022-05-12 14:33:49.243077
1453,4707,17269,3614,2511,33851,61952,2022-05-12 14:33:49.689658
1454,3183,20910,2457,2443,38797,67790,2022-05-12 14:33:52.40672
1455,148,4129,106,155,1930,6468,2022-05-12 14:33:54.275804
1456,183,1756,198,306,1863,4306,2022-05-12 14:33:57.573911
1458,139,910,119,198,1424,2790,2022-05-12 14:33:59.68673
1460,130,2263,98,110,1330,3931,2022-05-12 14:34:04.708817
1462,4020,46599,1787,700,49415,102521,2022-05-12 14:34:05.1462
1466,228,1085,190,202,2192,3897,2022-05-12 14:34:07.685391
1468,353,9951,150,120,5433,16007,2022-05-12 14:34:10.23605
1469,1336,27912,2003,3345,5897,40493,2022-05-12 14:34:12.926896
1472,528,10742,339,270,6537,18416,2022-05-12 14:34:18.954066
1474,187,4747,123,101,2249,7407,2022-05-12 14:34:25.317424
1475,166,4408,122,95,2247,7038,2022-05-12 14:34:27.360805
1476,161,4186,122,92,2058,6619,2022-05-12 14:34:29.351021
1479,115,3114,109,81,1809,5228,2022-05-12 14:34:34.146957
1481,98,2474,72,88,1397,4129,2022-05-12 14:34:36.97164
1482,58415,284109,58269,46157,189416,636366,2022-05-12 14:34:37.167624
1483,1435,5132,1084,715,14790,23156,2022-05-12 14:34:40.26566
1484,244,4368,109,156,3209,8086,2022-05-12 14:34:43.482894
1485,941,9605,904,643,8245,20338,2022-05-12 14:34:46.401337
1487,291,16127,253,268,5691,22630,2022-05-12 14:34:49.938771
1488,478,7010,335,250,7834,15907,2022-05-12 14:34:52.708181
1489,183,4750,132,82,1779,6926,2022-05-12 14:34:55.756637
1490,557,3434,598,615,5810,11014,2022-05-12 14:34:58.110264
1491,2641,5867,2404,1411,18628,30951,2022-05-12 14:34:58.528281
1492,709,4671,621,684,5665,12350,2022-05-12 14:35:00.98575
1493,244,2879,209,163,2004,5499,2022-05-12 14:35:03.272923
1494,200,5277,132,127,3424,9160,2022-05-12 14:35:06.082691
1496,214,7835,144,172,2915,11280,2022-05-12 14:35:08.746542
1497,73,2263,52,94,1479,3961,2022-05-12 14:35:10.968113
1498,2992,69987,2812,3232,18616,97639,2022-05-12 14:35:14.582677
1500,458,4976,267,325,3715,9741,2022-05-12 14:35:17.050641
1501,98,4727,76,97,1704,6702,2022-05-12 14:35:19.78512
1503,49,713,40,59,699,1560,2022-05-12 14:35:22.283182
1504,125,6023,115,111,2181,8555,2022-05-12 14:35:24.437083
1505,434,39818,210,227,3599,44288,2022-05-12 14:35:24.602808
1506,615,44250,249,291,4409,49814,2022-05-12 14:35:24.857847
1514,171,4381,149,139,1950,6790,2022-05-12 14:35:32.319555
1516,2550,12764,3032,4170,6175,28691,2022-05-12 14:35:32.952996
1519,11792,358162,6971,3378,73463,453766,2022-05-12 14:35:39.097906
1520,2840,12673,1767,1310,16790,35380,2022-05-12 14:35:43.081219
1521,179,8109,157,106,3030,11581,2022-05-12 14:35:45.210111
1524,788,4157,824,643,10253,16665,2022-05-12 14:35:46.346333
1525,174,18799,171,187,3182,22513,2022-05-12 14:35:50.402889
1526,526,99966,280,283,4334,105389,2022-05-12 14:35:53.650828
1527,241,24152,190,209,3262,28054,2022-05-12 14:35:53.845699
1528,71,895,51,77,788,1882,2022-05-12 14:35:58.530722
1529,87,1331,70,107,1167,2762,2022-05-12 14:36:00.703445
1531,490,24642,394,210,7947,33683,2022-05-12 14:36:07.520712
1532,1688,30384,1394,2353,11307,47126,2022-05-12 14:36:07.801107
1533,836,11865,1060,1887,4971,20619,2022-05-12 14:36:07.967043
1534,574,6320,576,538,3711,11719,2022-05-12 14:36:10.75703
1535,165765,2808055,96924,103536,209157,3383437,2022-05-12 14:36:11.005725
35175,7,23,0,39,35,104,2022-05-12 19:49:33.782436
1536,7138,97864,6887,8936,42231,163056,2022-05-12 14:36:14.463888
1538,1859,19298,1949,2376,13450,38932,2022-05-12 14:36:17.596157
1539,63,2004,45,88,815,3015,2022-05-12 14:36:20.63872
1541,719,4172,466,539,5129,11025,2022-05-12 14:36:23.50356
1542,454,2945,434,639,4687,9159,2022-05-12 14:36:25.820978
1543,1896,20049,1299,1363,13198,37805,2022-05-12 14:36:30.134156
1546,4608,45387,4077,5164,27695,86931,2022-05-12 14:36:34.93346
1547,30,219,32,149,268,698,2022-05-12 14:36:36.469993
1549,109,1794,91,117,2079,4190,2022-05-12 14:36:39.463012
1550,420,3977,446,680,2576,8099,2022-05-12 14:36:42.400254
1553,247,3064,212,156,2983,6662,2022-05-12 14:36:47.346197
1555,1799,18506,1502,1856,11616,35279,2022-05-12 14:36:50.361906
1556,739,8354,469,448,9220,19230,2022-05-12 14:36:52.705109
1557,3287,24185,2631,2434,20035,52572,2022-05-12 14:36:56.398133
1559,14788,185745,8901,7630,59093,276157,2022-05-12 14:37:00.180247
1561,359,3454,352,659,3171,7995,2022-05-12 14:37:05.650055
1563,852,20934,862,640,6642,29930,2022-05-12 14:37:12.112424
1564,3855,144492,4082,6832,10136,169397,2022-05-12 14:37:12.404342
1566,1713,60895,964,418,28892,92882,2022-05-12 14:37:16.426351
1567,891,9050,1006,820,6240,18007,2022-05-12 14:37:18.866471
1568,4016,28756,2905,3995,21697,61369,2022-05-12 14:37:22.628629
1569,2645,32472,1876,2479,20191,59663,2022-05-12 14:37:25.351938
1570,1523,20032,1273,1977,9627,34432,2022-05-12 14:37:28.090496
1572,287,3369,439,616,2347,7058,2022-05-12 14:37:35.668763
1575,92122,1486956,53165,38936,304342,1975521,2022-05-12 14:37:40.49534
1576,2463,12963,2731,2325,16646,37128,2022-05-12 14:37:43.248263
1578,569,4912,360,483,4558,10882,2022-05-12 14:37:49.026532
1579,3492,62435,2932,3985,20179,93023,2022-05-12 14:37:49.473315
1580,89,895,49,67,932,2032,2022-05-12 14:37:52.482294
1581,1185,17885,910,1378,8924,30282,2022-05-12 14:37:55.058921
1582,104,1539,58,83,966,2750,2022-05-12 14:37:56.866013
1583,974,7562,823,1433,8251,19043,2022-05-12 14:37:57.272457
1584,69,1591,63,55,931,2709,2022-05-12 14:37:59.655347
1586,116,2031,63,107,1147,3464,2022-05-12 14:38:03.627835
1587,833,5170,860,1017,7957,15837,2022-05-12 14:38:06.238146
1588,1716,12748,1435,1644,7960,25503,2022-05-12 14:38:09.71026
1589,4422,27944,4606,5052,39226,81250,2022-05-12 14:38:12.572002
1590,172,1078,142,240,1138,2770,2022-05-12 14:38:15.018425
1592,1051,8411,895,1146,11824,23327,2022-05-12 14:38:20.426186
1593,273,23309,237,190,5484,29493,2022-05-12 14:38:23.367292
1594,6942,82684,5759,4265,50468,150118,2022-05-12 14:38:25.992796
1596,274,2884,197,369,2697,6421,2022-05-12 14:38:28.561844
1598,218,4097,164,199,3114,7792,2022-05-12 14:38:31.883294
1600,182,2048,276,420,2109,5035,2022-05-12 14:38:36.851851
1603,356,3413,358,450,2742,7319,2022-05-12 14:38:42.80107
1604,50304,258516,39366,39135,130009,517330,2022-05-12 14:38:43.272296
1607,1273,13861,1335,1987,9834,28290,2022-05-12 14:38:47.618729
1608,487,3485,326,413,4242,8953,2022-05-12 14:38:51.144762
1609,393,13930,407,265,3394,18389,2022-05-12 14:38:52.613346
1613,43,1874,22,60,592,2591,2022-05-12 14:38:56.741806
1614,1315,43502,929,1398,4084,51228,2022-05-12 14:38:59.409903
1617,137,1236,101,110,1941,3525,2022-05-12 14:39:01.691966
1618,255,1233,251,249,2811,4799,2022-05-12 14:39:04.392824
1620,109,995,72,114,952,2242,2022-05-12 14:39:06.731926
1621,48,1123,49,53,696,1969,2022-05-12 14:39:08.523111
1622,126,4619,77,131,2386,7339,2022-05-12 14:39:11.591509
1623,222,1851,179,275,1784,4311,2022-05-12 14:39:14.03889
1624,95,1870,84,75,1539,3663,2022-05-12 14:39:15.983854
1625,79,1592,56,68,947,2742,2022-05-12 14:39:18.438241
1628,427,4205,310,466,3895,9303,2022-05-12 14:39:24.736668
1629,1182,6735,855,1098,11949,21819,2022-05-12 14:39:25.200221
1630,85,2251,79,104,1289,3808,2022-05-12 14:39:27.283537
1631,206,7311,166,202,4014,11899,2022-05-12 14:39:30.144824
1637,236,8747,120,177,4159,13439,2022-05-12 14:39:30.485263
1638,144,2420,167,225,1180,4136,2022-05-12 14:39:32.441148
1640,366,13822,292,777,4417,19674,2022-05-12 14:39:32.854399
1641,96,1338,46,50,961,2491,2022-05-12 14:39:33.191151
1642,2068,20283,2076,2098,9811,36336,2022-05-12 14:39:33.603307
1644,75,993,45,62,831,2006,2022-05-12 14:39:35.916655
1645,198,2931,138,143,2342,5752,2022-05-12 14:39:38.869171
1647,361,4825,147,323,4457,10113,2022-05-12 14:39:40.911044
1648,132,3666,106,95,1717,5716,2022-05-12 14:39:42.16045
1650,1286,7750,1058,729,13808,24631,2022-05-12 14:39:42.568062
1651,279,3414,210,200,3482,7585,2022-05-12 14:39:42.986441
1652,176,2257,146,155,2762,5496,2022-05-12 14:39:44.92074
1654,185,11436,150,137,2624,14532,2022-05-12 14:39:47.448194
1657,452,6361,460,718,6587,14578,2022-05-12 14:39:54.326395
1658,225,3366,113,75,3074,6853,2022-05-12 14:39:56.81427
1659,93,4073,108,91,1548,5913,2022-05-12 14:39:58.754476
1660,269,1698,235,283,2909,5394,2022-05-12 14:40:00.551015
1662,86,1316,50,60,1363,2875,2022-05-12 14:40:04.776282
1663,352,4021,359,366,4249,9347,2022-05-12 14:40:07.308168
1664,173,1315,124,230,1378,3220,2022-05-12 14:40:09.946296
1666,87,537,95,163,789,1671,2022-05-12 14:40:12.349017
1668,647,38609,658,1305,3213,44432,2022-05-12 14:40:16.600594
1669,1008,54293,877,1906,3420,61504,2022-05-12 14:40:17.060327
1670,113,8348,94,159,1485,10199,2022-05-12 14:40:20.551096
1671,90,995,60,57,999,2201,2022-05-12 14:40:22.278885
1674,507,22883,399,649,2587,27025,2022-05-12 14:40:25.749637
1676,198,2275,181,241,2122,5017,2022-05-12 14:40:30.482229
1677,51,1175,55,68,872,2221,2022-05-12 14:40:31.83055
1678,1571,13591,2552,2437,10083,30234,2022-05-12 14:40:32.234272
1679,205,7772,175,147,2072,10371,2022-05-12 14:40:34.446608
1681,808,24875,451,293,14045,40472,2022-05-12 14:40:36.787203
1682,474,9135,443,542,5789,16383,2022-05-12 14:40:38.888334
1684,173,1846,155,236,1291,3701,2022-05-12 14:40:44.944261
1685,534,15496,644,2482,2482,21638,2022-05-12 14:40:47.389597
1686,2230,228865,960,614,17838,250507,2022-05-12 14:40:50.218391
1688,823,10729,849,1258,7871,21530,2022-05-12 14:40:53.205385
1689,14982,629851,7500,5758,183298,841389,2022-05-12 14:40:53.455046
1690,8010,55308,6826,6221,96587,172952,2022-05-12 14:40:56.608236
1691,18428,292539,13496,17810,80367,422640,2022-05-12 14:41:00.9892
1693,433,3164,417,724,3529,8267,2022-05-12 14:41:05.994216
1694,1108,7242,1120,1789,10388,21647,2022-05-12 14:41:10.068522
1695,1305,9885,1292,1048,12154,25684,2022-05-12 14:41:13.580376
1696,1790,35656,1583,1644,13851,54524,2022-05-12 14:41:14.730381
1698,12545,148076,10192,7628,112477,290918,2022-05-12 14:41:14.895278
1699,8349,86983,8631,8740,59318,172021,2022-05-12 14:41:15.30751
1701,175,2398,99,113,1848,4633,2022-05-12 14:41:17.836945
1704,526,3491,387,517,4909,9830,2022-05-12 14:41:21.273221
1705,74,728,68,157,744,1771,2022-05-12 14:41:22.921297
1706,409,4109,457,436,4069,9480,2022-05-12 14:41:25.986521
1708,150,818,84,152,1106,2310,2022-05-12 14:41:31.391212
1709,407,65906,216,208,3891,70628,2022-05-12 14:41:33.912306
1710,1581,24086,1838,2626,5216,35347,2022-05-12 14:41:37.286803
1711,132,1080,106,179,1168,2665,2022-05-12 14:41:39.027445
1713,97,623,70,105,887,1782,2022-05-12 14:41:42.47424
1721,797,9173,763,1085,7366,19184,2022-05-12 14:41:50.695183
1722,6101,52531,4273,4390,27436,94731,2022-05-12 14:41:51.673069
1724,378,1089,409,583,3525,5984,2022-05-12 14:41:54.529893
1725,218,2600,124,197,2024,5163,2022-05-12 14:41:55.4915
1726,10504,198983,8922,12710,54356,285475,2022-05-12 14:41:55.892404
1729,619,12679,418,345,6558,20619,2022-05-12 14:41:59.527604
1731,1890,28767,1491,1207,16753,50108,2022-05-12 14:42:03.047635
1732,316,12148,240,170,4216,17090,2022-05-12 14:42:06.537486
1733,87,2568,48,62,1153,3918,2022-05-12 14:42:09.331461
1735,410758,1305672,127665,141594,112914,2098603,2022-05-12 14:42:12.109238
1737,122,560,83,135,1143,2043,2022-05-12 14:42:15.3681
1739,57,125,64,112,291,649,2022-05-12 14:42:17.335312
1740,87,297,66,139,838,1427,2022-05-12 14:42:18.247281
1742,145,945,105,146,1534,2875,2022-05-12 14:42:21.908288
1743,131,2104,189,608,1183,4215,2022-05-12 14:42:23.931386
1744,1058,9211,1592,1759,3840,17460,2022-05-12 14:42:26.431238
1745,47,309,39,86,472,953,2022-05-12 14:42:27.855954
1747,834,8868,650,580,11493,22425,2022-05-12 14:42:34.191881
1752,63,2200,43,73,879,3258,2022-05-12 14:42:43.021173
1753,29,1370,25,52,579,2055,2022-05-12 14:42:44.367449
1754,74,2215,42,79,647,3057,2022-05-12 14:42:45.374799
1755,55,1869,41,71,699,2735,2022-05-12 14:42:47.067448
1757,49,2625,32,69,592,3367,2022-05-12 14:42:48.877925
1761,250,5244,132,98,3387,9111,2022-05-12 14:42:54.565117
1764,258,12394,174,144,3917,16887,2022-05-12 14:42:55.628753
1765,116,2472,53,96,1211,3948,2022-05-12 14:42:57.604341
1766,96,1372,45,58,1137,2708,2022-05-12 14:42:59.437429
1769,211,2714,214,680,1218,5037,2022-05-12 14:43:05.32866
1771,108,933,60,96,850,2047,2022-05-12 14:43:07.257253
1772,79,926,43,102,803,1953,2022-05-12 14:43:08.776113
1773,283,6503,152,129,3561,10628,2022-05-12 14:43:11.018794
1774,49,1490,52,49,789,2429,2022-05-12 14:43:13.539031
1775,348,1573,235,353,3940,6449,2022-05-12 14:43:14.655945
1776,31,685,13,45,353,1127,2022-05-12 14:43:16.41049
1777,150,2788,71,68,2334,5411,2022-05-12 14:43:18.466052
1778,191,1706,155,210,1532,3794,2022-05-12 14:43:21.021116
1789,57,2347,76,75,1063,3618,2022-05-12 14:43:25.348947
1790,52,1106,48,51,520,1777,2022-05-12 14:43:27.230294
1792,673,4022,662,638,5609,11604,2022-05-12 14:43:29.898427
1793,389,9023,193,186,6944,16735,2022-05-12 14:43:33.033723
1794,114,2710,79,59,1457,4419,2022-05-12 14:43:34.861945
1796,224,4450,121,84,3345,8224,2022-05-12 14:43:39.816496
1797,151,5926,101,96,2826,9100,2022-05-12 14:43:42.331847
1799,162,7276,96,74,2003,9611,2022-05-12 14:43:45.829033
1800,151,6809,85,61,1527,8633,2022-05-12 14:43:48.171162
1804,392,3516,284,318,4580,9090,2022-05-12 14:43:53.899237
1805,193,2979,151,192,1815,5330,2022-05-12 14:43:55.808141
1807,961,10961,875,1397,7389,21583,2022-05-12 14:44:01.630005
1810,1992,18112,1526,2613,16520,40763,2022-05-12 14:44:07.331316
1811,118,1814,83,78,1388,3481,2022-05-12 14:44:09.266083
1813,584,38400,474,258,8353,48069,2022-05-12 14:44:14.472213
1816,3362,49308,3834,6282,6315,69101,2022-05-12 14:44:17.607873
1818,25983,363340,21854,22240,177331,610748,2022-05-12 14:44:20.649207
1822,340,2570,254,317,4619,8100,2022-05-12 14:44:31.847671
1823,253,2790,190,220,2323,5776,2022-05-12 14:44:33.939957
1824,935,21563,509,281,21519,44807,2022-05-12 14:44:34.345965
1825,212,6174,175,99,4452,11112,2022-05-12 14:44:37.152357
1826,1753,12728,1821,1895,8296,26493,2022-05-12 14:44:39.871074
1829,1295,100493,901,634,25197,128520,2022-05-12 14:44:43.940218
1830,312,10581,403,197,3173,14666,2022-05-12 14:44:47.07891
1831,92,1384,49,54,1021,2600,2022-05-12 14:44:49.057616
1832,186,2824,112,133,1984,5239,2022-05-12 14:44:50.974747
1833,55,823,22,60,594,1554,2022-05-12 14:44:52.599635
1835,623,7252,620,683,3049,12227,2022-05-12 14:44:54.976436
1836,1404,32901,1286,2094,15022,52707,2022-05-12 14:44:57.427462
1838,668,17973,278,527,5143,24589,2022-05-12 14:45:01.532522
1839,50,720,78,170,354,1372,2022-05-12 14:45:04.438247
1840,10307,399577,5629,6300,44070,465883,2022-05-12 14:45:07.991644
1841,108,5926,82,69,1467,7652,2022-05-12 14:45:10.230966
1842,1217,53846,564,575,7423,63625,2022-05-12 14:45:10.659364
1844,609,6055,827,817,4718,13026,2022-05-12 14:45:13.81311
1848,186,740,156,211,1573,2866,2022-05-12 14:45:22.2985
1849,58,433,43,65,609,1208,2022-05-12 14:45:24.218915
1850,34,332,24,42,393,825,2022-05-12 14:45:26.484671
1851,28,325,21,46,363,783,2022-05-12 14:45:27.644954
1853,488,2696,530,514,4563,8791,2022-05-12 14:45:34.139179
1855,42,913,28,58,555,1596,2022-05-12 14:45:36.447717
1856,141,4033,144,141,1709,6168,2022-05-12 14:45:38.586126
1857,113,1032,75,80,1574,2874,2022-05-12 14:45:40.381485
1860,5475,32235,3607,3877,37041,82235,2022-05-12 14:45:42.200629
1861,232,10637,174,157,3495,14695,2022-05-12 14:45:45.175781
1863,37,86,12,69,359,563,2022-05-12 14:45:49.828859
1865,390,2454,397,648,3664,7553,2022-05-12 14:45:55.126464
1866,160,1124,65,92,1749,3190,2022-05-12 14:45:58.13787
1867,69,773,27,51,852,1772,2022-05-12 14:46:00.312983
1868,397,3495,334,522,2988,7736,2022-05-12 14:46:02.483724
1869,335,12598,288,281,3467,16969,2022-05-12 14:46:05.152993
1873,155,1466,147,197,1463,3428,2022-05-12 14:46:09.377287
1878,236,2936,216,267,2883,6538,2022-05-12 14:46:14.292297
1880,129,3531,58,58,1369,5145,2022-05-12 14:46:18.14822
1881,329,3091,298,366,3227,7311,2022-05-12 14:46:20.55426
1883,86,984,79,188,668,2005,2022-05-12 14:46:25.473738
1884,134,1011,140,250,924,2459,2022-05-12 14:46:27.10629
1885,117,523,119,249,893,1901,2022-05-12 14:46:28.702869
1886,305,2620,331,278,1779,5313,2022-05-12 14:46:31.094032
1887,35746,334249,36068,42178,149417,597658,2022-05-12 14:46:31.528081
1888,413,17708,302,192,4518,23133,2022-05-12 14:46:31.931066
1900,55,958,46,61,562,1682,2022-05-12 14:46:53.443519
1889,18436,289732,13617,10914,108536,441235,2022-05-12 14:46:32.353726
1891,94,927,69,137,743,1970,2022-05-12 14:46:37.856324
1892,38,588,25,69,324,1044,2022-05-12 14:46:39.747393
1893,131,1237,129,252,911,2660,2022-05-12 14:46:42.479944
1894,469,63721,221,247,4241,68899,2022-05-12 14:46:45.941208
1897,120,643,83,133,721,1700,2022-05-12 14:46:47.74709
1898,111,1940,60,59,956,3126,2022-05-12 14:46:49.93801
1899,186,1048,150,204,1361,2949,2022-05-12 14:46:51.753168
1902,88,4550,98,76,1460,6272,2022-05-12 14:46:55.926939
1904,114,1342,77,90,1515,3138,2022-05-12 14:46:58.56242
1905,91,1361,61,92,1049,2654,2022-05-12 14:47:01.53612
1908,152,5597,88,124,2767,8728,2022-05-12 14:47:06.822933
1911,374,5071,320,219,6349,12333,2022-05-12 14:47:14.149148
1913,1857,21434,1216,879,15056,40442,2022-05-12 14:47:20.283541
1914,2235,21582,2128,1224,10843,38012,2022-05-12 14:47:23.761288
1917,301,9530,240,291,3825,14187,2022-05-12 14:47:31.9725
1919,242,2948,190,135,2280,5795,2022-05-12 14:47:36.110053
1920,165,5829,116,108,2843,9061,2022-05-12 14:47:37.933824
1921,396,9328,185,205,5534,15648,2022-05-12 14:47:38.338883
1922,145,3953,104,100,2212,6514,2022-05-12 14:47:40.538211
1926,33,1770,27,54,489,2373,2022-05-12 14:47:47.190599
1928,95,1908,62,71,1134,3270,2022-05-12 14:47:51.114737
1929,766,9823,719,665,4124,16097,2022-05-12 14:47:53.479425
1930,123,3874,88,125,1713,5923,2022-05-12 14:47:55.740201
1931,114,3713,98,111,1700,5736,2022-05-12 14:47:57.716078
1932,907,7999,895,754,4420,14975,2022-05-12 14:48:00.416946
1933,54,874,37,48,637,1650,2022-05-12 14:48:00.866522
1935,1127,5141,718,473,10194,17653,2022-05-12 14:48:03.504438
1937,56,888,46,52,734,1776,2022-05-12 14:48:06.4556
1939,85,1345,75,155,1051,2711,2022-05-12 14:48:09.992651
1940,240,4088,108,89,2497,7022,2022-05-12 14:48:11.954361
1942,321,3255,287,346,3705,7914,2022-05-12 14:48:16.611359
1943,8129,292663,3424,1747,146588,452551,2022-05-12 14:48:17.091449
1944,536,7938,307,370,4150,13301,2022-05-12 14:48:20.653146
1946,1543,13021,1812,1478,10696,28550,2022-05-12 14:48:23.221282
1947,123,469,89,142,1089,1912,2022-05-12 14:48:24.890961
1949,50,2425,33,47,661,3216,2022-05-12 14:48:26.94624
1952,583,8579,400,365,6553,16480,2022-05-12 14:48:32.333172
1953,847,33938,924,837,11612,48158,2022-05-12 14:48:35.325568
1954,306,9416,308,253,4207,14490,2022-05-12 14:48:37.426475
1956,2770,48039,1959,2483,18110,73361,2022-05-12 14:48:38.387894
1958,78,5799,49,57,1345,7328,2022-05-12 14:48:42.034874
1959,99,756,49,74,1259,2237,2022-05-12 14:48:44.413673
1960,787,1,400,914,917,3019,2022-05-12 14:48:47.087264
1961,386,13229,229,257,7349,21450,2022-05-12 14:48:49.749196
1962,106,652,67,128,928,1881,2022-05-12 14:48:51.61807
1964,113,1763,92,106,1546,3620,2022-05-12 14:48:54.145522
1965,3382,55172,3177,3262,31081,96074,2022-05-12 14:48:54.406713
1967,207,7822,158,165,3257,11609,2022-05-12 14:48:58.652546
1968,171,7032,131,150,2896,10380,2022-05-12 14:49:01.237313
1972,664,4201,635,475,4197,10172,2022-05-12 14:49:04.287557
1973,78,1633,39,76,1419,3245,2022-05-12 14:49:06.532302
1977,68,1485,46,40,1380,3019,2022-05-12 14:49:13.416976
1978,154,5741,90,68,3128,9181,2022-05-12 14:49:15.531444
1979,73,2584,34,53,1118,3862,2022-05-12 14:49:17.595834
1980,392,7736,234,209,6359,14930,2022-05-12 14:49:20.040453
1981,176,3128,104,104,3371,6883,2022-05-12 14:49:22.424635
1982,29,2762,22,61,419,3293,2022-05-12 14:49:24.33231
1983,93,2554,86,86,1699,4518,2022-05-12 14:49:26.156414
1985,446,6220,408,584,2513,10171,2022-05-12 14:49:26.935455
1986,90,450,66,131,775,1512,2022-05-12 14:49:28.522555
1988,470,4915,472,439,4260,10556,2022-05-12 14:49:30.980737
1989,34,1977,25,64,381,2481,2022-05-12 14:49:32.94231
1990,33,754,22,42,409,1260,2022-05-12 14:49:34.286896
1992,88,903,53,80,787,1911,2022-05-12 14:49:37.942184
1995,282,4149,130,196,2666,7423,2022-05-12 14:49:42.163151
1998,201,5691,162,171,2658,8883,2022-05-12 14:49:46.801999
2001,84417,935499,65808,50316,299568,1435608,2022-05-12 14:49:49.223506
2002,5884,54760,4998,5538,32809,103989,2022-05-12 14:49:53.490518
2003,69,980,30,60,821,1960,2022-05-12 14:49:55.270347
2006,611,41808,332,375,5447,48573,2022-05-12 14:50:01.584535
2008,64,933,41,64,939,2041,2022-05-12 14:50:03.387036
2011,214,3194,156,125,2214,5903,2022-05-12 14:50:12.073919
2012,1132,6697,1138,918,8055,17940,2022-05-12 14:50:14.349993
2013,200,4646,124,93,2709,7772,2022-05-12 14:50:16.787824
2014,369,5331,300,231,3360,9591,2022-05-12 14:50:18.919366
2015,68,1268,53,56,899,2344,2022-05-12 14:50:20.386379
2016,120,3993,103,87,2298,6601,2022-05-12 14:50:22.934815
2017,150,3919,115,75,2945,7204,2022-05-12 14:50:25.703763
2019,89,1140,71,63,1465,2828,2022-05-12 14:50:30.099812
2020,369,23180,324,254,5228,29355,2022-05-12 14:50:30.292249
2022,50,663,28,34,496,1271,2022-05-12 14:50:31.858514
2023,138,1271,101,151,1437,3098,2022-05-12 14:50:33.742041
2024,65,191,57,134,277,724,2022-05-12 14:50:35.204425
2025,44187,498195,36358,25515,253583,857838,2022-05-12 14:50:35.383949
2027,56,1093,43,47,670,1909,2022-05-12 14:50:43.556223
2029,124,2168,83,105,2345,4825,2022-05-12 14:50:46.747943
2031,1561,15431,1283,2069,12413,32757,2022-05-12 14:50:50.712965
2032,453,3060,411,607,4215,8746,2022-05-12 14:50:53.081699
2033,212,3621,136,146,4698,8813,2022-05-12 14:50:55.844424
2034,22619,330217,16549,17416,135731,522532,2022-05-12 14:50:58.700023
2035,729,14429,502,416,8027,24103,2022-05-12 14:51:02.089357
2036,215,1593,290,304,1389,3791,2022-05-12 14:51:03.636605
2037,482,3171,493,482,3575,8203,2022-05-12 14:51:06.25989
2038,303,1461,253,236,1982,4235,2022-05-12 14:51:08.229136
2039,169,738,195,167,1402,2671,2022-05-12 14:51:10.05178
2042,292,5780,141,101,5411,11725,2022-05-12 14:51:16.636169
2043,1140,7696,1129,1111,6659,17735,2022-05-12 14:51:19.566948
2044,1138,3974,901,640,5843,12496,2022-05-12 14:51:21.786191
2046,41,517,30,61,575,1224,2022-05-12 14:51:25.179173
2047,48,2857,22,69,824,3820,2022-05-12 14:51:26.972347
2048,496,3079,295,192,4535,8597,2022-05-12 14:51:29.233999
2049,54,1040,37,65,766,1962,2022-05-12 14:51:30.903738
2050,149,3550,88,94,2275,6156,2022-05-12 14:51:32.819792
2052,72,598,38,69,875,1652,2022-05-12 14:51:34.771663
2053,82,1459,57,63,1129,2790,2022-05-12 14:51:36.528364
2054,43,623,31,66,674,1437,2022-05-12 14:51:37.887588
2055,72,914,42,53,967,2048,2022-05-12 14:51:39.539572
2056,49,1367,33,63,800,2312,2022-05-12 14:51:40.942405
2058,40,793,24,58,487,1402,2022-05-12 14:51:43.009356
2059,69,693,52,92,764,1670,2022-05-12 14:51:45.582678
2061,75,1866,51,51,916,2959,2022-05-12 14:51:47.54426
2064,104,1246,70,73,1093,2586,2022-05-12 14:51:52.846344
2065,74,1120,54,73,785,2106,2022-05-12 14:51:54.690538
2066,65,720,56,52,788,1681,2022-05-12 14:51:56.421303
2067,69,2755,59,57,1203,4143,2022-05-12 14:51:58.204162
2068,121,1078,65,87,1378,2729,2022-05-12 14:51:59.826219
2069,56,688,30,40,599,1413,2022-05-12 14:52:01.642386
2071,134,4438,104,96,2809,7581,2022-05-12 14:52:02.063267
2073,48,205,30,49,546,878,2022-05-12 14:52:05.371287
2074,64,385,70,108,612,1239,2022-05-12 14:52:06.957154
2075,64,284,55,106,538,1047,2022-05-12 14:52:08.534284
2076,2873,6090,2246,1297,13823,26329,2022-05-12 14:52:10.982081
2078,58,1202,54,75,754,2143,2022-05-12 14:52:15.402084
2080,44,506,19,52,499,1120,2022-05-12 14:52:17.503491
2082,59,623,39,56,729,1506,2022-05-12 14:52:19.767287
2083,109,1386,64,65,1184,2808,2022-05-12 14:52:21.431209
2084,188,1063,145,183,1444,3023,2022-05-12 14:52:23.164555
2085,46,424,27,55,514,1066,2022-05-12 14:52:24.657714
2087,159,1098,127,168,1021,2573,2022-05-12 14:52:28.265937
2091,33,527,16,44,368,988,2022-05-12 14:52:35.65617
2093,41,537,14,50,494,1136,2022-05-12 14:52:37.772496
2094,65,949,27,51,706,1798,2022-05-12 14:52:39.306759
2096,40,521,15,48,452,1076,2022-05-12 14:52:42.707185
2097,86,1674,48,72,1017,2897,2022-05-12 14:52:44.650979
2098,215,4641,131,123,2758,7868,2022-05-12 14:52:46.800771
2100,91,1547,67,59,1171,2935,2022-05-12 14:52:51.143763
2103,90,1459,33,64,1483,3129,2022-05-12 14:52:56.354303
2104,18552,162131,15963,16874,90091,303611,2022-05-12 14:52:58.739967
2105,1134,4567,1205,1782,10034,18722,2022-05-12 14:53:02.045583
2106,813,2997,695,810,4683,9998,2022-05-12 14:53:02.292244
2107,609,50153,466,413,7685,59326,2022-05-12 14:53:02.451998
2108,560,10969,673,662,3110,15974,2022-05-12 14:53:05.700128
2110,259,4305,266,274,2396,7500,2022-05-12 14:53:12.784077
2112,1521,25155,1234,1625,12664,42199,2022-05-12 14:53:18.103709
2113,454,5454,392,495,3076,9871,2022-05-12 14:53:20.448187
2114,77,872,40,69,756,1814,2022-05-12 14:53:22.424448
2116,2519,60685,2447,4398,7124,77173,2022-05-12 14:53:22.616339
2117,195,9115,154,215,1567,11246,2022-05-12 14:53:27.038201
2118,101,4314,63,111,974,5563,2022-05-12 14:53:29.40843
2119,90,3516,65,117,924,4712,2022-05-12 14:53:31.791142
2120,75,3312,58,112,904,4461,2022-05-12 14:53:33.717051
2121,91,3496,57,107,932,4683,2022-05-12 14:53:35.570611
2122,73,3271,63,108,884,4399,2022-05-12 14:53:37.217564
2126,259,7216,195,187,4232,12089,2022-05-12 14:53:47.72753
2129,6873,119095,4332,4493,69611,204404,2022-05-12 14:53:54.323023
2130,4905,34577,4145,4792,25521,73940,2022-05-12 14:53:54.506768
2131,1333,83958,934,956,13792,100973,2022-05-12 14:53:59.774532
2132,279,11768,228,141,4085,16501,2022-05-12 14:54:02.052089
2133,88,1436,57,82,1744,3407,2022-05-12 14:54:05.289147
2141,140,2298,77,85,3488,6088,2022-05-12 14:54:08.014917
2142,2335,31487,2777,5328,7651,49578,2022-05-12 14:54:12.059108
2143,494,6223,317,229,5174,12437,2022-05-12 14:54:15.739449
2144,1361,170142,724,600,12932,185759,2022-05-12 14:54:15.908939
2146,52,1214,40,67,669,2042,2022-05-12 14:54:18.082178
2147,179,6314,97,101,2663,9354,2022-05-12 14:54:20.258322
2150,2029,12289,1569,905,5779,22571,2022-05-12 14:54:21.138441
2151,142,4261,161,327,999,5890,2022-05-12 14:54:23.61705
2152,618,4872,709,813,4773,11785,2022-05-12 14:54:26.435208
2153,291,2753,269,419,2731,6463,2022-05-12 14:54:27.348241
2154,2124,51511,1061,597,44471,99764,2022-05-12 14:54:28.047137
2155,1403,7135,983,1522,8968,20011,2022-05-12 14:54:30.749232
2156,2598,79238,1925,4855,5996,94612,2022-05-12 14:54:33.450166
2157,329,2844,258,287,2344,6062,2022-05-12 14:54:35.933313
2158,2473,20198,2321,2013,30736,57741,2022-05-12 14:54:39.501745
2159,5090,46963,4330,2919,34147,93449,2022-05-12 14:54:42.737513
2161,1397,9657,1136,1427,15264,28881,2022-05-12 14:54:45.519004
2162,586,2529,621,931,4062,8729,2022-05-12 14:54:48.2083
2163,896,12634,586,656,7483,22255,2022-05-12 14:54:48.547147
2164,7469,44920,7297,4796,70171,134653,2022-05-12 14:54:51.403383
2165,335,1461,346,418,2379,4939,2022-05-12 14:54:55.379407
2166,903,15960,982,1132,7760,26737,2022-05-12 14:54:59.041741
2167,58149,831216,43457,43062,310737,1286621,2022-05-12 14:54:59.202641
2656,74,5763,45,113,582,6577,2022-05-12 15:05:48.377044
2169,269,4234,224,435,2928,8090,2022-05-12 14:55:04.432387
2170,252,6366,243,164,3274,10299,2022-05-12 14:55:06.661306
2171,336,35424,200,191,3474,39625,2022-05-12 14:55:09.747137
2172,74,2000,42,107,709,2932,2022-05-12 14:55:11.849402
2174,236,5675,134,133,3022,9200,2022-05-12 14:55:14.96234
2176,121,2202,109,121,2099,4652,2022-05-12 14:55:17.298435
2178,448,10498,173,157,5641,16917,2022-05-12 14:55:20.952968
2179,90,1278,64,109,1211,2752,2022-05-12 14:55:22.491013
2180,124,1090,89,100,1501,2904,2022-05-12 14:55:24.581062
2181,86,1406,53,73,977,2595,2022-05-12 14:55:26.251511
2183,145,3063,79,107,1515,4909,2022-05-12 14:55:29.296951
2196,167,2839,68,87,2587,5748,2022-05-12 14:55:32.321568
2198,367,18364,308,204,4974,24217,2022-05-12 14:55:35.747758
2199,197,6421,127,108,4204,11057,2022-05-12 14:55:38.406935
2201,405,72809,273,286,4325,78098,2022-05-12 14:55:41.48492
2203,326,2783,228,209,2608,6154,2022-05-12 14:55:44.74746
2204,560,3419,602,584,5652,10817,2022-05-12 14:55:47.272907
2205,293,9623,223,158,4736,15033,2022-05-12 14:55:50.146642
2206,50,1877,59,62,971,3019,2022-05-12 14:55:52.480887
2207,50,1369,49,53,830,2351,2022-05-12 14:55:53.97948
2211,49,3441,27,46,752,4315,2022-05-12 14:55:58.1894
2214,469,6625,409,375,4316,12194,2022-05-12 14:56:05.244964
2216,5552,39326,3614,3916,57772,110180,2022-05-12 14:56:08.680158
2217,118,6558,94,80,1392,8242,2022-05-12 14:56:11.138207
2218,124,5429,71,178,1569,7371,2022-05-12 14:56:13.832659
2219,111,2136,73,121,1769,4210,2022-05-12 14:56:15.754944
2221,364,3931,412,460,2460,7627,2022-05-12 14:56:21.128167
2223,114,1017,125,214,866,2336,2022-05-12 14:56:24.191047
2224,218,1892,171,232,2203,4716,2022-05-12 14:56:26.747103
2225,1002,22668,1049,1267,6078,32064,2022-05-12 14:56:27.786435
2226,20,329,21,97,192,659,2022-05-12 14:56:29.123385
2229,1175,12559,935,1021,5976,21666,2022-05-12 14:56:38.173194
2231,261,944,203,237,1940,3585,2022-05-12 14:56:41.985021
2233,67,518,56,104,385,1130,2022-05-12 14:56:43.965047
2235,314,17426,123,125,5355,23343,2022-05-12 14:56:47.053444
2236,11262,536317,4077,1907,165964,719527,2022-05-12 14:56:47.492107
2237,207,12460,197,156,4339,17359,2022-05-12 14:56:50.515357
2238,486,13703,279,386,5160,20014,2022-05-12 14:56:53.299978
2243,139,483,95,170,1365,2252,2022-05-12 14:56:55.740623
2245,211,1420,174,240,2648,4693,2022-05-12 14:56:58.756855
2246,17730,88187,11694,5922,151821,275354,2022-05-12 14:56:59.213826
2248,640,64202,392,310,6479,72023,2022-05-12 14:56:59.452751
2249,130,2900,80,116,1941,5167,2022-05-12 14:57:02.012316
2250,99,1613,38,65,1062,2877,2022-05-12 14:57:04.522308
2251,39929,408901,34089,21119,320881,824919,2022-05-12 14:57:04.956611
2252,1529,7862,1004,1351,15595,27341,2022-05-12 14:57:07.499187
2253,973,7141,968,999,5425,15506,2022-05-12 14:57:10.483118
2255,326,1276,239,232,2503,4576,2022-05-12 14:57:16.457181
2257,339,1026,271,205,2766,4607,2022-05-12 14:57:19.612487
2258,28,452,20,66,318,884,2022-05-12 14:57:21.50679
2260,73,780,83,97,996,2029,2022-05-12 14:57:25.082099
2262,109,3426,50,86,1258,4929,2022-05-12 14:57:27.311754
2263,263,14322,110,140,2179,17014,2022-05-12 14:57:30.274897
2264,85,2497,43,88,1123,3836,2022-05-12 14:57:32.882394
2267,131,4486,119,119,2886,7741,2022-05-12 14:57:36.162891
2269,217,6642,169,212,2806,10046,2022-05-12 14:57:38.332228
2273,619,47036,309,241,6580,54785,2022-05-12 14:57:40.984313
2277,156,1493,135,232,1547,3563,2022-05-12 14:57:45.443765
2278,36,1186,32,47,597,1898,2022-05-12 14:57:47.083191
2279,61,2597,28,78,978,3742,2022-05-12 14:57:49.142305
2280,56,381,72,171,452,1132,2022-05-12 14:57:50.815805
2281,239,5646,380,945,1517,8727,2022-05-12 14:57:53.907611
2283,191,1508,178,277,1325,3479,2022-05-12 14:57:58.797183
2284,168,3155,147,295,787,4552,2022-05-12 14:58:01.643335
2287,207,2419,254,618,1067,4565,2022-05-12 14:58:06.609108
2288,289,3069,337,517,2530,6742,2022-05-12 14:58:09.132971
2289,63,1278,58,71,792,2262,2022-05-12 14:58:10.693416
2290,80,5917,36,42,1468,7543,2022-05-12 14:58:13.399398
2291,281,3683,146,161,3265,7536,2022-05-12 14:58:15.570269
2292,103,1446,72,91,982,2694,2022-05-12 14:58:17.297635
2293,137,3665,72,74,1988,5936,2022-05-12 14:58:19.118214
2298,177,10917,140,133,3167,14534,2022-05-12 14:58:22.699534
2299,52,1134,34,64,735,2019,2022-05-12 14:58:24.209009
2300,64,2146,53,90,1348,3701,2022-05-12 14:58:26.004441
2302,82,2690,64,166,1189,4191,2022-05-12 14:58:29.377842
2304,76,1660,63,132,1115,3046,2022-05-12 14:58:32.627521
2305,72,1744,71,148,1081,3116,2022-05-12 14:58:34.578371
2307,140,1521,94,84,1223,3062,2022-05-12 14:58:37.53636
2308,307,1146,174,269,2312,4208,2022-05-12 14:58:39.495484
2309,83,1977,57,88,1000,3205,2022-05-12 14:58:41.047873
2310,51,614,32,55,652,1404,2022-05-12 14:58:42.499628
2311,62,830,40,67,1224,2223,2022-05-12 14:58:44.286215
2312,72,1689,44,67,1041,2913,2022-05-12 14:58:46.042623
2313,165,6374,83,142,2274,9038,2022-05-12 14:58:48.692075
2314,54,355,19,48,590,1066,2022-05-12 14:58:50.223468
2316,99,705,76,233,772,1885,2022-05-12 14:58:52.169402
2317,231,2661,92,165,1997,5146,2022-05-12 14:58:54.635048
2319,54,1953,49,41,997,3094,2022-05-12 14:58:57.787809
2332,393,8098,172,134,5043,13840,2022-05-12 14:59:07.382218
2333,191,1995,203,244,1870,4503,2022-05-12 14:59:09.122411
2334,45,722,39,71,473,1350,2022-05-12 14:59:10.65292
2335,380,4766,431,428,2330,8335,2022-05-12 14:59:12.771768
2336,113,7161,107,103,1763,9247,2022-05-12 14:59:14.924438
2337,286,1151,242,204,2650,4533,2022-05-12 14:59:16.798244
2346,236,5893,105,126,3367,9727,2022-05-12 14:59:19.544545
2354,485,18487,200,175,7024,26371,2022-05-12 14:59:22.782085
2356,397,13224,174,221,5731,19747,2022-05-12 14:59:26.302655
2361,232,2723,242,326,1522,5045,2022-05-12 14:59:30.933573
2362,130,607,64,203,1266,2270,2022-05-12 14:59:32.724301
2363,470,21997,732,771,4109,28079,2022-05-12 14:59:33.039708
2365,63,811,35,52,821,1782,2022-05-12 14:59:37.332243
2369,3585,25012,3501,4207,22337,58642,2022-05-12 14:59:44.463692
2382,86,276,62,143,764,1331,2022-05-12 14:59:46.130292
2383,382,3943,315,300,3782,8722,2022-05-12 14:59:47.643765
2384,68,1323,43,59,756,2249,2022-05-12 14:59:49.40953
2385,301,30178,258,250,4923,35910,2022-05-12 14:59:52.280929
2387,117,1794,80,90,2264,4345,2022-05-12 14:59:54.758928
2389,556,3517,764,792,3527,9156,2022-05-12 14:59:56.792112
2390,1518,16055,2300,3562,5041,28476,2022-05-12 15:00:00.441092
2392,128,11035,49,130,817,12159,2022-05-12 15:00:06.350961
2393,86,7244,46,117,637,8130,2022-05-12 15:00:08.271586
2397,662,64242,285,320,5514,71023,2022-05-12 15:00:08.6853
2402,6131,19989,4229,2699,42294,75342,2022-05-12 15:00:15.91727
2404,5221,80220,5159,7913,33866,132379,2022-05-12 15:00:20.141503
2406,1820,0,621,1562,3091,7094,2022-05-12 15:00:20.741256
2407,103,4690,71,85,1231,6180,2022-05-12 15:00:21.939391
2415,239,2435,143,220,1195,4232,2022-05-12 15:00:25.027457
2416,134,1254,59,129,642,2218,2022-05-12 15:00:26.749196
2417,164,10965,83,157,1779,13148,2022-05-12 15:00:30.350713
2418,7249,184964,2253,736,106723,301925,2022-05-12 15:00:30.690147
2420,128,1511,69,63,1749,3520,2022-05-12 15:00:33.142356
2421,36,499,8,35,321,899,2022-05-12 15:00:35.070302
2424,321,20467,298,183,5522,26791,2022-05-12 15:00:39.575497
2427,107,2836,49,93,1852,4937,2022-05-12 15:00:41.473609
2428,42,854,13,58,405,1372,2022-05-12 15:00:43.143584
2429,56,1709,28,71,858,2722,2022-05-12 15:00:44.937672
2448,586,16210,388,280,10078,27542,2022-05-12 15:00:47.498172
2450,196,6258,73,192,1407,8126,2022-05-12 15:00:48.322398
2451,1286,7238,950,666,9154,19294,2022-05-12 15:00:50.891408
2452,242,4875,143,102,3719,9081,2022-05-12 15:00:53.233649
2453,85,1086,65,94,1173,2503,2022-05-12 15:00:55.073878
2455,70,579,64,83,533,1329,2022-05-12 15:00:57.477771
2456,38,1188,18,51,465,1760,2022-05-12 15:01:00.052884
2457,121,1472,87,103,1093,2876,2022-05-12 15:01:02.722293
2458,226,4389,174,136,2053,6978,2022-05-12 15:01:03.138296
2459,123,2939,81,75,1644,4862,2022-05-12 15:01:05.759987
2460,115,4046,99,91,2098,6449,2022-05-12 15:01:08.26568
2461,207,3072,75,64,2770,6188,2022-05-12 15:01:10.428944
2462,105,2489,65,105,1121,3885,2022-05-12 15:01:12.462878
2463,318,357,143,82,1678,2578,2022-05-12 15:01:14.742035
2464,30,701,31,48,432,1242,2022-05-12 15:01:16.665634
2466,57,757,38,42,493,1387,2022-05-12 15:01:19.772832
2470,144,2715,83,93,2012,5047,2022-05-12 15:01:26.734177
2472,2817,241833,829,648,17847,263974,2022-05-12 15:01:29.812473
2474,89,1403,53,61,992,2598,2022-05-12 15:01:33.649069
2476,15185,444544,8667,27467,109833,605696,2022-05-12 15:01:34.573273
2482,71,909,42,52,704,1778,2022-05-12 15:01:36.210421
2483,77,1179,65,74,885,2280,2022-05-12 15:01:38.288543
2484,178,1341,166,202,1228,3115,2022-05-12 15:01:39.432155
2487,94,657,77,97,755,1680,2022-05-12 15:01:43.736287
2488,333,10522,213,159,7621,18848,2022-05-12 15:01:46.395104
2489,1448,4151,976,728,5053,12356,2022-05-12 15:01:46.662185
2490,310,26105,252,239,4967,31873,2022-05-12 15:01:46.904302
2491,51,1209,44,89,803,2196,2022-05-12 15:01:47.239571
2495,202,2282,220,362,2116,5182,2022-05-12 15:01:49.782638
2497,442,3916,318,261,3931,8868,2022-05-12 15:01:52.045138
2498,231,10579,170,159,3624,14763,2022-05-12 15:01:52.421088
2499,254,10472,176,170,3746,14818,2022-05-12 15:01:52.577534
2500,441,5840,203,137,5195,11816,2022-05-12 15:01:58.006207
2501,102,523,130,233,624,1612,2022-05-12 15:01:59.877665
2508,2098,54914,1850,1362,18011,78235,2022-05-12 15:02:03.971429
2510,147,717,113,141,1467,2585,2022-05-12 15:02:05.778213
2512,162,12940,114,131,2145,15492,2022-05-12 15:02:10.80902
2513,154,12024,117,126,2007,14428,2022-05-12 15:02:11.090802
2514,198,13484,126,138,2300,16246,2022-05-12 15:02:11.337055
2515,125,10835,113,131,1980,13184,2022-05-12 15:02:11.503408
2523,745,4534,490,660,5312,11741,2022-05-12 15:02:19.105096
2524,288,3548,146,235,2223,6440,2022-05-12 15:02:21.540752
2526,144,2233,78,77,1512,4044,2022-05-12 15:02:24.134405
2527,105,1450,63,81,1112,2811,2022-05-12 15:02:26.067255
2528,118,1147,72,74,1228,2639,2022-05-12 15:02:28.39825
2535,80,1240,71,139,1165,2695,2022-05-12 15:02:34.148371
2536,95,1419,81,137,1310,3042,2022-05-12 15:02:35.987058
2537,55,488,49,103,764,1459,2022-05-12 15:02:37.469186
2538,51,527,41,63,551,1233,2022-05-12 15:02:39.017236
2542,366,5259,362,368,2732,9087,2022-05-12 15:02:41.49397
2543,271,4951,275,350,1965,7812,2022-05-12 15:02:43.76061
2544,231,3102,188,232,1864,5617,2022-05-12 15:02:45.903103
2545,54,889,54,134,559,1690,2022-05-12 15:02:47.777409
2546,130,2102,122,211,1159,3724,2022-05-12 15:02:50.124322
2548,289,3743,292,318,3144,7786,2022-05-12 15:02:55.47097
2550,35,2153,19,48,369,2624,2022-05-12 15:02:59.118503
2552,199,494,183,251,1283,2410,2022-05-12 15:03:00.84534
2553,254,2084,227,256,3622,6443,2022-05-12 15:03:03.500296
2554,183,2522,184,260,1775,4924,2022-05-12 15:03:05.440076
2555,189,1734,141,188,1616,3868,2022-05-12 15:03:08.180066
2557,317,3871,259,250,2422,7119,2022-05-12 15:03:12.242364
2559,1815,19585,1120,791,20705,44016,2022-05-12 15:03:13.286185
2560,244,4331,149,158,4762,9644,2022-05-12 15:03:16.226571
2562,1378,12384,1461,1568,13420,30211,2022-05-12 15:03:22.643216
2563,604,20774,525,344,12457,34704,2022-05-12 15:03:25.525117
2564,696,9482,754,1207,5204,17343,2022-05-12 15:03:27.867452
2565,90,1160,62,197,824,2333,2022-05-12 15:03:30.017786
2566,41,374,41,131,261,848,2022-05-12 15:03:31.992709
2568,27,334,28,98,286,773,2022-05-12 15:03:34.344183
2570,85,1403,82,151,838,2559,2022-05-12 15:03:36.990116
2572,88,1716,98,226,817,2945,2022-05-12 15:03:41.618218
2573,88,850,92,128,904,2062,2022-05-12 15:03:43.279366
2576,107,1027,84,195,1092,2505,2022-05-12 15:03:46.037033
2577,268,4398,265,379,2262,7572,2022-05-12 15:03:46.96089
2578,36,685,37,159,184,1101,2022-05-12 15:03:48.650097
2579,85,3713,70,204,570,4642,2022-05-12 15:03:50.870069
2580,155,8424,136,90,2460,11265,2022-05-12 15:03:53.218024
2581,9133,140503,6354,4877,41709,202576,2022-05-12 15:03:53.380178
2583,85,2382,49,72,1105,3693,2022-05-12 15:03:58.30911
2585,93,2276,62,67,1390,3888,2022-05-12 15:04:02.67928
2586,89,1841,65,66,1203,3264,2022-05-12 15:04:04.863069
2589,278,14387,273,187,5699,20824,2022-05-12 15:04:05.142537
2591,76,2162,47,66,1082,3433,2022-05-12 15:04:07.409605
2592,152,4402,103,149,2050,6856,2022-05-12 15:04:09.765421
2593,10919,216139,4098,1783,152513,385452,2022-05-12 15:04:10.013095
2594,1555,34252,808,720,25040,62375,2022-05-12 15:04:13.313143
2595,1027,21584,838,1123,10586,35158,2022-05-12 15:04:16.699106
2596,7656,47369,7016,6007,68561,136609,2022-05-12 15:04:17.018903
2597,152,10594,119,120,2106,13091,2022-05-12 15:04:17.447662
2600,34,335,18,52,417,856,2022-05-12 15:04:19.425082
2601,43,477,24,53,523,1120,2022-05-12 15:04:22.403789
2602,1695,20491,1213,1514,11762,36675,2022-05-12 15:04:24.688886
2604,1110,10463,1142,1425,8649,22789,2022-05-12 15:04:29.518134
2606,188,9178,170,172,2940,12648,2022-05-12 15:04:32.875355
2607,154,2688,77,104,2862,5885,2022-05-12 15:04:35.010463
2608,3651,15571,2078,2210,11326,34836,2022-05-12 15:04:38.982385
2609,373,1299,244,272,3156,5344,2022-05-12 15:04:41.670827
2613,74,726,57,107,1086,2050,2022-05-12 15:04:48.264383
2615,144,8908,105,108,2044,11309,2022-05-12 15:04:51.221771
2620,156,2944,122,166,935,4323,2022-05-12 15:04:59.906262
2621,139,2552,74,135,2531,5431,2022-05-12 15:05:02.14933
2622,74,1709,37,63,849,2732,2022-05-12 15:05:04.27316
2623,552,6558,275,197,12522,20104,2022-05-12 15:05:04.715813
2624,60,745,52,99,920,1876,2022-05-12 15:05:06.338217
2625,31,1333,21,93,416,1894,2022-05-12 15:05:08.343175
2626,25,844,21,83,339,1312,2022-05-12 15:05:10.707431
2628,25,718,20,81,349,1193,2022-05-12 15:05:12.540728
2629,28,1091,25,90,355,1589,2022-05-12 15:05:14.69403
2631,28,889,21,88,337,1363,2022-05-12 15:05:18.582252
2632,28,923,27,100,354,1432,2022-05-12 15:05:19.813997
2633,27,903,24,89,392,1435,2022-05-12 15:05:21.177474
2634,60,1904,35,104,462,2565,2022-05-12 15:05:22.962283
2636,16,208,14,44,133,415,2022-05-12 15:05:24.313199
2639,15,207,12,41,122,397,2022-05-12 15:05:25.512942
2645,25,838,26,80,347,1316,2022-05-12 15:05:29.154016
2648,71,3507,37,105,759,4479,2022-05-12 15:05:32.684263
2649,43,2108,29,89,450,2719,2022-05-12 15:05:34.344043
2650,35,1239,25,96,426,1821,2022-05-12 15:05:36.462338
2651,31,1608,30,90,435,2194,2022-05-12 15:05:37.72173
2652,38,2255,29,89,428,2839,2022-05-12 15:05:39.683005
2653,27,1078,22,78,399,1604,2022-05-12 15:05:41.157142
2655,76,6797,52,116,686,7727,2022-05-12 15:05:45.906145
2657,50,3546,39,110,575,4320,2022-05-12 15:05:50.290923
2658,46,3304,45,112,605,4112,2022-05-12 15:05:52.398947
2659,57,4439,42,102,499,5139,2022-05-12 15:05:54.33181
2660,39,2064,28,83,451,2665,2022-05-12 15:05:56.139013
2662,54,3249,42,110,587,4042,2022-05-12 15:05:59.721583
2665,82,5852,79,124,637,6774,2022-05-12 15:06:03.957126
2667,56,3713,81,104,602,4556,2022-05-12 15:06:07.465627
2669,56,4472,47,104,556,5235,2022-05-12 15:06:10.378141
2671,65,4360,41,109,572,5147,2022-05-12 15:06:13.319709
2673,99,6268,46,126,702,7241,2022-05-12 15:06:15.609621
2674,59,2771,84,103,798,3815,2022-05-12 15:06:17.545375
2675,66,5710,38,110,623,6547,2022-05-12 15:06:19.623412
2676,64,4867,39,109,519,5598,2022-05-12 15:06:21.457225
2678,43,2580,76,98,515,3312,2022-05-12 15:06:25.330568
2679,86,588,59,112,764,1609,2022-05-12 15:06:26.642264
2680,372,21633,285,294,4456,27040,2022-05-12 15:06:29.305934
2682,72,1377,52,80,723,2304,2022-05-12 15:06:29.660113
2683,1438,18184,1080,816,13089,34607,2022-05-12 15:06:30.602236
2685,2216,59806,1427,983,24797,89229,2022-05-12 15:06:31.37892
2689,39,642,33,57,499,1270,2022-05-12 15:06:33.277937
2690,59,903,25,58,776,1821,2022-05-12 15:06:34.719225
2692,127,1652,100,127,1096,3102,2022-05-12 15:06:37.092456
2693,117,1348,81,116,1624,3286,2022-05-12 15:06:39.009211
2694,158,559,109,136,1970,2932,2022-05-12 15:06:41.590254
2695,192,4677,135,146,3178,8328,2022-05-12 15:06:42.002346
2696,100,1506,61,68,1312,3047,2022-05-12 15:06:43.901372
2697,69,330,62,76,788,1325,2022-05-12 15:06:45.947297
2698,131,1796,69,73,2137,4206,2022-05-12 15:06:48.212076
2699,127,867,96,167,1100,2357,2022-05-12 15:06:50.043775
2700,68,552,56,86,531,1293,2022-05-12 15:06:51.561305
2701,15,86,10,71,95,277,2022-05-12 15:06:52.755032
2702,49,640,36,113,377,1215,2022-05-12 15:06:54.16935
2703,231,3105,160,281,1206,4983,2022-05-12 15:06:56.317087
2704,209,1160,251,278,2305,4203,2022-05-12 15:06:58.24769
2705,383,7124,278,558,1532,9875,2022-05-12 15:07:00.590073
2706,174,4274,120,245,750,5563,2022-05-12 15:07:03.562465
2707,75,477,62,125,392,1131,2022-05-12 15:07:05.62295
2708,13,75,10,80,98,276,2022-05-12 15:07:06.753818
2710,30,290,9,71,201,601,2022-05-12 15:07:08.687167
2712,20,135,10,61,256,482,2022-05-12 15:07:09.932223
2713,240,2900,267,194,2190,5791,2022-05-12 15:07:12.323067
2717,171,1303,164,136,1887,3661,2022-05-12 15:07:19.331479
2719,264,1290,350,1219,1447,4570,2022-05-12 15:07:23.692767
2722,233,2749,107,90,3915,7094,2022-05-12 15:07:26.251417
2723,152,1048,139,230,1256,2825,2022-05-12 15:07:28.269106
2724,259,14337,127,141,3385,18249,2022-05-12 15:07:30.525548
2725,195,6350,116,108,2240,9009,2022-05-12 15:07:32.883733
2727,122,1178,108,256,1193,2857,2022-05-12 15:07:35.07984
2728,23,2138,8,27,203,2399,2022-05-12 15:07:36.706701
2730,365,5753,176,382,2429,9105,2022-05-12 15:07:38.848564
2732,44,356,36,102,286,824,2022-05-12 15:07:40.873402
2733,59,1687,66,74,1165,3051,2022-05-12 15:07:42.702983
2737,51,459,26,52,496,1084,2022-05-12 15:07:51.44812
2738,34,150,31,79,229,523,2022-05-12 15:07:53.409793
2739,34,229,15,56,357,691,2022-05-12 15:07:55.432075
2740,107,385,58,143,769,1462,2022-05-12 15:07:56.844712
2742,38,114,19,83,227,481,2022-05-12 15:07:59.470114
2743,144,5080,116,159,2201,7700,2022-05-12 15:08:01.807486
2744,591,7518,700,988,5870,15667,2022-05-12 15:08:04.562964
2745,121,1447,67,63,1231,2929,2022-05-12 15:08:07.09451
2746,257,13823,158,167,3837,18242,2022-05-12 15:08:08.115603
2748,223,2942,201,349,1165,4880,2022-05-12 15:08:12.711031
2749,43,445,41,96,333,958,2022-05-12 15:08:14.079071
2751,294,5158,183,177,5985,11797,2022-05-12 15:08:17.51133
2752,639,29095,303,274,4273,34584,2022-05-12 15:08:20.439671
2753,276,4347,164,140,6189,11116,2022-05-12 15:08:20.849655
2754,109,1187,65,110,1472,2943,2022-05-12 15:08:22.927768
2755,153,2409,86,152,2298,5098,2022-05-12 15:08:25.761943
2756,234,7811,156,199,4956,13356,2022-05-12 15:08:28.544042
2758,91,407,68,142,537,1245,2022-05-12 15:08:31.909766
2759,6735,391320,2757,1266,81439,483517,2022-05-12 15:08:32.36506
2761,226,3784,92,135,3927,8164,2022-05-12 15:08:35.098324
2762,403,4589,355,434,4117,9898,2022-05-12 15:08:35.549553
2765,66,1380,35,85,701,2267,2022-05-12 15:08:38.178436
2766,160,1603,194,365,1318,3640,2022-05-12 15:08:40.082799
2767,116,1957,76,110,2757,5016,2022-05-12 15:08:42.138565
2768,200,15798,89,100,3044,19231,2022-05-12 15:08:44.271128
2769,97,376,91,118,876,1558,2022-05-12 15:08:45.949271
2770,80,1650,45,79,1167,3021,2022-05-12 15:08:48.54979
2771,109,333,126,181,1119,1868,2022-05-12 15:08:50.104963
2772,1905,11043,1741,1995,8568,25252,2022-05-12 15:08:52.670114
2776,103,1330,58,108,1174,2773,2022-05-12 15:08:55.191816
2777,55,795,40,67,562,1519,2022-05-12 15:08:56.828827
2778,53,639,39,65,555,1351,2022-05-12 15:08:59.482605
2780,125,1911,60,75,1475,3646,2022-05-12 15:09:03.266825
2781,120,998,109,184,1402,2813,2022-05-12 15:09:05.000278
2782,300,7321,184,223,4260,12288,2022-05-12 15:09:05.443904
2783,65,743,53,104,610,1575,2022-05-12 15:09:07.206139
2784,134,4987,104,97,1812,7134,2022-05-12 15:09:09.740132
2785,75,574,35,50,1021,1755,2022-05-12 15:09:11.285205
2786,271,1015,163,251,1370,3070,2022-05-12 15:09:13.934354
2789,356,9199,386,1099,1388,12428,2022-05-12 15:09:19.290774
2790,62,1125,24,57,690,1958,2022-05-12 15:09:21.853772
2792,58,1752,34,65,874,2783,2022-05-12 15:09:24.044644
2793,94,1900,54,77,1520,3645,2022-05-12 15:09:25.844398
2795,4226,39127,3638,6085,18306,71382,2022-05-12 15:09:28.912454
2799,174,3663,177,316,1219,5549,2022-05-12 15:09:34.54252
2800,1410,15965,1603,1870,6121,26969,2022-05-12 15:09:37.12153
2801,62,1179,45,76,734,2096,2022-05-12 15:09:39.247276
2802,65,1317,46,86,830,2344,2022-05-12 15:09:41.36414
2803,165,1289,161,221,1995,3831,2022-05-12 15:09:43.023664
2804,131,917,99,180,1175,2502,2022-05-12 15:09:45.406189
2805,43,493,36,115,314,1001,2022-05-12 15:09:46.820348
2806,69,360,68,150,599,1246,2022-05-12 15:09:49.184264
2808,169,8297,87,112,2300,10965,2022-05-12 15:09:51.638758
2810,144,3249,132,212,1398,5135,2022-05-12 15:09:54.783986
2811,81,3419,39,80,1208,4827,2022-05-12 15:09:57.198086
2813,194,3820,242,419,780,5455,2022-05-12 15:09:59.42431
2814,28,607,33,117,185,970,2022-05-12 15:10:00.961301
2815,46,1042,71,141,274,1574,2022-05-12 15:10:02.502943
2816,204,3417,165,266,1121,5173,2022-05-12 15:10:03.461311
2818,134,835,103,159,925,2156,2022-05-12 15:10:06.074107
2819,366,1655,297,292,2916,5526,2022-05-12 15:10:08.220728
2820,83,1036,89,160,660,2028,2022-05-12 15:10:10.509125
2823,72,1735,82,343,296,2528,2022-05-12 15:10:13.489233
2825,209,4392,196,389,1199,6385,2022-05-12 15:10:16.140492
2826,121,1124,123,179,693,2240,2022-05-12 15:10:18.653332
2827,77,2742,110,380,504,3813,2022-05-12 15:10:20.760395
2828,641,5145,534,433,6363,13116,2022-05-12 15:10:23.003507
2830,31,390,23,89,352,885,2022-05-12 15:10:24.76532
2831,31,538,25,78,493,1165,2022-05-12 15:10:26.183343
2832,456,13389,433,263,6780,21321,2022-05-12 15:10:28.722942
2833,30,702,20,82,531,1365,2022-05-12 15:10:30.178604
2834,220,1575,248,280,2098,4421,2022-05-12 15:10:31.20468
2835,777,1008,698,489,3872,6844,2022-05-12 15:10:32.226695
2836,76,2137,99,295,486,3093,2022-05-12 15:10:32.63899
2837,58,676,47,65,608,1454,2022-05-12 15:10:34.070359
2839,61,728,45,76,866,1776,2022-05-12 15:10:35.273372
2840,35,1124,32,74,636,1901,2022-05-12 15:10:36.834859
2842,126,11455,112,133,2092,13918,2022-05-12 15:10:39.784237
2847,573,96253,263,285,4534,101908,2022-05-12 15:10:44.155126
2848,309,8906,189,147,5749,15300,2022-05-12 15:10:47.348384
2851,42,913,33,59,532,1579,2022-05-12 15:10:49.079339
2876,27,314,13,58,457,869,2022-05-12 15:10:50.584715
2881,79,866,48,60,1080,2133,2022-05-12 15:10:52.388877
2882,86,1060,107,274,532,2059,2022-05-12 15:10:54.297298
2884,167,5693,115,226,3234,9435,2022-05-12 15:10:56.480579
2889,1919,199379,977,542,19073,221890,2022-05-12 15:10:58.499948
2890,4594,426798,1564,731,47668,481355,2022-05-12 15:10:58.936033
2891,444,9741,277,226,10050,20738,2022-05-12 15:11:02.208135
2892,55,998,85,234,430,1802,2022-05-12 15:11:04.528051
2895,107,604,80,113,2593,3497,2022-05-12 15:11:07.747993
2897,34,2153,26,49,791,3053,2022-05-12 15:11:09.823609
2901,63,1001,32,77,728,1901,2022-05-12 15:11:15.91003
2903,1013,3188,674,466,6669,12010,2022-05-12 15:11:16.601843
2904,48480,1295207,22041,15441,176707,1557876,2022-05-12 15:11:17.020398
2905,507,15072,362,294,5484,21719,2022-05-12 15:11:17.428853
2906,40,367,14,49,397,867,2022-05-12 15:11:19.796371
2910,71,1277,52,76,801,2277,2022-05-12 15:11:22.310542
2911,170,2771,131,124,2125,5321,2022-05-12 15:11:25.21988
2912,64,1445,78,199,364,2150,2022-05-12 15:11:27.053315
2915,49,660,29,50,753,1541,2022-05-12 15:11:30.086142
2920,142,2415,76,155,2318,5106,2022-05-12 15:11:33.954103
2921,1955,19110,879,967,18308,41219,2022-05-12 15:11:34.421857
2922,116,2010,61,136,1930,4253,2022-05-12 15:11:36.783458
2923,11176,124353,10827,15875,40622,202853,2022-05-12 15:11:39.840934
2924,9073,124195,8080,6981,91636,239965,2022-05-12 15:11:44.555188
2926,5257,118548,3663,4810,45284,177562,2022-05-12 15:11:48.488198
2927,4075,48180,3115,3492,27050,85912,2022-05-12 15:11:52.980651
35177,8,63,4,40,58,173,2022-05-12 19:49:36.387722
2928,354,13671,270,303,6061,20659,2022-05-12 15:11:53.301941
2929,194,2071,176,150,1994,4585,2022-05-12 15:11:55.294819
2930,16,58,10,70,113,267,2022-05-12 15:11:56.435309
2931,765,3128,729,933,8538,14093,2022-05-12 15:11:58.686526
2933,143,515,125,159,1163,2105,2022-05-12 15:12:00.261398
2937,204,11939,183,136,3809,16271,2022-05-12 15:12:01.076244
2938,312,1851,269,243,2245,4920,2022-05-12 15:12:03.758846
2941,29,927,19,62,319,1356,2022-05-12 15:12:06.328837
2942,1307,10089,1400,1329,13530,27655,2022-05-12 15:12:07.270168
2948,68,2976,60,85,1281,4470,2022-05-12 15:12:11.123564
2951,756,39554,431,341,10494,51576,2022-05-12 15:12:14.451949
2952,1379,108826,456,333,13769,124763,2022-05-12 15:12:17.329216
2953,91,10963,52,58,1715,12879,2022-05-12 15:12:17.737181
2954,91,4865,121,111,1642,6830,2022-05-12 15:12:19.973191
2959,170,1246,93,126,824,2459,2022-05-12 15:12:20.214404
2961,815,98978,303,359,5231,105686,2022-05-12 15:12:23.090252
2962,336,38715,226,223,3739,43239,2022-05-12 15:12:26.051356
2964,1242,13865,1223,1838,10540,28708,2022-05-12 15:12:26.844093
2965,713,2363,731,906,4655,9368,2022-05-12 15:12:32.424673
2966,35493,436424,29097,18957,218639,738610,2022-05-12 15:12:32.86066
2969,446,29713,294,249,6746,37448,2022-05-12 15:12:36.326147
2970,1916,18085,1718,2531,11021,35271,2022-05-12 15:12:39.842331
2971,749,13998,588,379,6672,22386,2022-05-12 15:12:43.679586
2972,69,1002,34,61,1028,2194,2022-05-12 15:12:46.832112
2974,73,1238,30,67,875,2283,2022-05-12 15:12:51.303925
2980,75,417,77,110,657,1336,2022-05-12 15:12:55.580394
2985,3247,31479,3176,3433,22260,63595,2022-05-12 15:13:05.100343
2986,4196,47115,4757,4875,23738,84681,2022-05-12 15:13:07.894397
2987,212,821,161,157,2275,3626,2022-05-12 15:13:09.994101
2993,20780,480664,12607,28025,82061,624137,2022-05-12 15:13:10.166437
2994,4280,122050,3188,2426,51561,183505,2022-05-12 15:13:10.614958
36015,5,25,2,26,55,113,2022-05-12 20:01:17.23332
2997,85,1569,56,67,1433,3210,2022-05-12 15:13:12.661133
2999,50,1162,42,58,968,2280,2022-05-12 15:13:16.694886
3000,530,3767,511,473,3603,8884,2022-05-12 15:13:18.10323
3001,3023,33399,2633,2604,26908,68567,2022-05-12 15:13:22.455535
3002,17879,161592,11387,7719,111691,310268,2022-05-12 15:13:23.377338
3003,51,1861,19,45,871,2847,2022-05-12 15:13:25.628046
3004,113,1834,73,92,1520,3632,2022-05-12 15:13:27.566759
3005,171,2834,91,98,2238,5432,2022-05-12 15:13:29.945921
3007,101,3515,56,134,1407,5213,2022-05-12 15:13:34.650057
3008,191,2588,232,432,1220,4663,2022-05-12 15:13:36.831522
3009,385,4660,334,538,3265,9182,2022-05-12 15:13:38.993608
3010,369,7155,394,522,2204,10644,2022-05-12 15:13:39.965254
3012,260,3915,227,429,1063,5894,2022-05-12 15:13:43.037317
3014,605,24938,303,211,8745,34802,2022-05-12 15:13:43.47025
3015,281,7344,211,171,5437,13444,2022-05-12 15:13:43.887432
3016,572,19673,342,262,9756,30605,2022-05-12 15:13:44.296543
3019,99,3189,90,86,2015,5479,2022-05-12 15:13:47.262644
3020,58,249,52,131,378,868,2022-05-12 15:13:48.767866
3023,144,415,136,184,996,1875,2022-05-12 15:13:52.215251
3024,270,1366,337,396,1999,4368,2022-05-12 15:13:54.411981
3026,81,1103,59,87,994,2324,2022-05-12 15:13:57.787439
3028,49,428,45,63,712,1297,2022-05-12 15:14:02.25395
3031,227,14964,201,190,3684,19266,2022-05-12 15:14:05.027051
3032,238,16071,198,167,3613,20287,2022-05-12 15:14:08.236119
3035,171,549,121,144,1742,2727,2022-05-12 15:14:12.554154
3037,116,1501,67,68,1139,2891,2022-05-12 15:14:15.653627
3043,107,3128,52,103,1556,4946,2022-05-12 15:14:18.167493
3051,93,3220,72,120,1443,4948,2022-05-12 15:14:24.147339
3053,139,7370,114,287,767,8677,2022-05-12 15:14:26.790523
3054,103,1060,93,167,913,2336,2022-05-12 15:14:29.036433
3057,335,11853,212,371,5094,17865,2022-05-12 15:14:29.460418
3065,76,799,49,55,811,1790,2022-05-12 15:14:38.896824
3067,119,1690,81,105,1827,3822,2022-05-12 15:14:40.901084
3069,105,1489,67,100,1502,3263,2022-05-12 15:14:42.731361
3070,35,930,17,47,367,1396,2022-05-12 15:14:44.341408
3071,110,1588,75,95,1582,3450,2022-05-12 15:14:46.702672
3073,26,69,9,69,128,301,2022-05-12 15:14:49.831331
3075,58,657,58,161,423,1357,2022-05-12 15:14:51.776357
3077,662,873,468,530,2968,5501,2022-05-12 15:14:54.603845
3080,143,7667,66,98,2267,10241,2022-05-12 15:14:57.754506
3081,287,3678,270,457,1659,6351,2022-05-12 15:14:58.037051
3085,813,12235,510,531,5716,19805,2022-05-12 15:15:00.94747
3088,653,13689,332,237,9751,24662,2022-05-12 15:15:07.718057
3089,1003,28982,558,455,20663,51661,2022-05-12 15:15:10.88729
3090,451,19059,341,237,5612,25700,2022-05-12 15:15:13.573707
3091,4374,82752,3238,2291,37584,130239,2022-05-12 15:15:14.013453
3092,8372,185822,4462,8621,28503,235780,2022-05-12 15:15:14.34334
3098,88,824,63,136,541,1652,2022-05-12 15:15:19.07002
3100,31,868,17,39,352,1307,2022-05-12 15:15:23.407131
3101,541,2591,547,698,4084,8461,2022-05-12 15:15:25.809395
3104,88,294,86,129,899,1496,2022-05-12 15:15:27.644234
3110,121,1364,131,178,1552,3346,2022-05-12 15:15:30.288333
3111,93,1998,38,65,1283,3477,2022-05-12 15:15:33.709251
3112,248,1226,147,272,1863,3756,2022-05-12 15:15:34.145468
3113,34,598,19,60,390,1101,2022-05-12 15:15:36.301597
3116,88,1067,67,138,450,1810,2022-05-12 15:15:40.30665
3120,86,1763,46,76,1634,3605,2022-05-12 15:15:42.207406
3125,623,2428,504,403,4320,8278,2022-05-12 15:15:48.509899
3127,108,3048,53,73,2048,5330,2022-05-12 15:15:49.441951
3131,29,346,16,124,230,745,2022-05-12 15:15:52.704111
3135,289,4342,102,96,4192,9021,2022-05-12 15:15:55.565557
3136,89,1731,102,177,618,2717,2022-05-12 15:15:57.539148
3137,225,2139,199,313,1407,4283,2022-05-12 15:15:59.467973
3138,70,2427,61,44,1104,3706,2022-05-12 15:16:01.367027
3146,143,696,130,158,2112,3239,2022-05-12 15:16:03.129169
3147,49,603,17,44,464,1177,2022-05-12 15:16:04.705145
3151,57,404,60,153,530,1204,2022-05-12 15:16:06.064428
3152,92,1153,28,50,1333,2656,2022-05-12 15:16:06.497797
3153,53,689,36,90,696,1564,2022-05-12 15:16:08.092189
3154,149,1532,96,121,1887,3785,2022-05-12 15:16:09.875866
3155,22,347,9,47,230,655,2022-05-12 15:16:11.329955
3157,108,1955,107,97,1290,3557,2022-05-12 15:16:13.455278
3159,204,446,237,227,1593,2707,2022-05-12 15:16:15.836399
3164,34,139,19,63,227,482,2022-05-12 15:16:17.751321
3166,1120,15205,1119,1800,8411,27655,2022-05-12 15:16:23.145973
3167,5746,91094,3275,1676,68448,170239,2022-05-12 15:16:23.43372
3174,220,11374,240,163,2885,14882,2022-05-12 15:16:26.112499
3175,47,646,16,57,554,1320,2022-05-12 15:16:27.503502
3176,94,256,63,99,1119,1631,2022-05-12 15:16:29.049363
3178,69,627,43,56,800,1595,2022-05-12 15:16:30.554154
3180,21,186,11,74,149,441,2022-05-12 15:16:31.825758
3183,38,423,18,51,511,1041,2022-05-12 15:16:33.763109
3192,78,893,39,66,1138,2214,2022-05-12 15:16:40.988176
3194,72,776,55,140,518,1561,2022-05-12 15:16:43.330487
3196,105,983,60,158,1170,2476,2022-05-12 15:16:45.191368
3199,167,2565,163,288,1997,5180,2022-05-12 15:16:47.694482
3201,33,356,32,115,253,789,2022-05-12 15:16:49.045178
3203,40,1196,29,73,479,1817,2022-05-12 15:16:53.056137
3205,234,996,156,233,1880,3499,2022-05-12 15:16:55.106057
3210,843,35402,295,385,5280,42205,2022-05-12 15:16:58.612754
3213,98,713,83,169,1182,2245,2022-05-12 15:17:00.358441
3215,90,1874,58,85,1910,4017,2022-05-12 15:17:04.102586
3219,96,4647,99,62,1588,6492,2022-05-12 15:17:07.200195
3220,1082,15010,471,403,18073,35039,2022-05-12 15:17:09.929843
3221,281,16676,287,238,6236,23718,2022-05-12 15:17:12.555521
3222,120,2004,101,108,2017,4350,2022-05-12 15:17:14.629225
3223,112,1923,105,110,2067,4317,2022-05-12 15:17:17.6964
3225,2201,49378,2112,1941,13339,68971,2022-05-12 15:17:19.972189
3226,1377,50503,641,581,7077,60179,2022-05-12 15:17:20.401964
3227,110,1556,69,81,1556,3372,2022-05-12 15:17:23.389769
3228,5991,70184,5827,3089,38400,123491,2022-05-12 15:17:24.318081
3229,5340,68046,3053,3491,30182,110112,2022-05-12 15:17:26.919445
3230,4954,63830,3323,5067,34727,111901,2022-05-12 15:17:29.360213
3231,1966,32748,2292,3106,17178,57290,2022-05-12 15:17:32.37123
3232,55,984,48,50,577,1714,2022-05-12 15:17:34.793551
3234,143,2788,92,116,1736,4875,2022-05-12 15:17:35.115197
3235,63,293,43,94,573,1066,2022-05-12 15:17:36.709159
3243,17,87,6,67,100,277,2022-05-12 15:17:38.22082
3245,86,1232,59,60,968,2405,2022-05-12 15:17:40.396445
3248,107,1216,133,109,1169,2734,2022-05-12 15:17:45.195536
3251,35,140,20,66,225,486,2022-05-12 15:17:46.442662
3252,31,427,12,55,303,828,2022-05-12 15:17:48.518322
3256,216,2453,169,170,1696,4704,2022-05-12 15:17:50.634258
3258,186,3976,69,68,3073,7372,2022-05-12 15:17:53.132814
3259,84,537,57,98,888,1664,2022-05-12 15:17:55.136163
3265,100,3519,98,114,1708,5539,2022-05-12 15:17:55.974081
3267,60,194,40,66,662,1022,2022-05-12 15:18:02.121737
3269,551,20809,402,465,8770,30997,2022-05-12 15:18:06.931553
3270,693,10617,637,871,5715,18533,2022-05-12 15:18:09.893761
3271,131,1807,113,197,557,2805,2022-05-12 15:18:12.102283
3272,768,3679,729,809,4338,10323,2022-05-12 15:18:12.551259
3273,44,554,22,84,518,1222,2022-05-12 15:18:12.972673
3275,27,323,20,70,338,778,2022-05-12 15:18:16.215753
3276,28,317,17,73,342,777,2022-05-12 15:18:17.946019
3279,30,266,17,69,308,690,2022-05-12 15:18:22.520195
3281,135,1378,87,166,1147,2913,2022-05-12 15:18:25.892709
3287,581,25606,172,591,6640,33590,2022-05-12 15:18:30.298342
3288,383,5535,400,267,3509,10094,2022-05-12 15:18:30.503304
3290,60,213,46,107,494,920,2022-05-12 15:18:32.286412
3292,105,2652,121,88,725,3691,2022-05-12 15:18:34.122114
3295,263,1299,327,455,1916,4260,2022-05-12 15:18:38.097525
3297,4381,34938,2794,2771,69605,114489,2022-05-12 15:18:38.563454
3299,2975,58812,2626,4167,23026,91606,2022-05-12 15:18:43.735373
3305,204,1275,167,188,1389,3223,2022-05-12 15:18:45.483333
3312,697,8627,937,1481,4668,16410,2022-05-12 15:18:48.736958
3313,70,828,50,163,580,1691,2022-05-12 15:18:49.164891
3315,70,253,61,101,629,1114,2022-05-12 15:18:50.477955
3318,1065,17956,882,782,6959,27644,2022-05-12 15:18:54.986807
3320,54,868,39,56,749,1766,2022-05-12 15:18:56.646192
3322,2050,13594,1925,1970,11269,30808,2022-05-12 15:18:57.08915
3325,171,704,127,162,1113,2277,2022-05-12 15:18:59.37325
3326,331,10776,165,120,7964,19356,2022-05-12 15:18:59.841245
3328,459,33129,412,448,7302,41750,2022-05-12 15:19:04.37098
3335,308,886,269,245,3508,5216,2022-05-12 15:19:08.056803
3342,8858,82502,5842,5144,66570,168916,2022-05-12 15:19:10.560466
3349,1013,7380,803,1155,6622,16973,2022-05-12 15:19:14.181731
3352,762,27787,662,294,11348,40853,2022-05-12 15:19:17.221942
3355,48,296,38,90,576,1048,2022-05-12 15:19:23.264511
3356,175,1116,255,332,1611,3489,2022-05-12 15:19:25.360724
3358,3534,44817,2753,2668,32078,85850,2022-05-12 15:19:28.214933
3359,2829,31350,2932,3391,15006,55508,2022-05-12 15:19:30.651587
3363,1673,5717,1534,2097,13512,24533,2022-05-12 15:19:35.175447
3369,417,3551,279,251,4149,8647,2022-05-12 15:19:41.041574
3371,903,9691,668,321,9802,21385,2022-05-12 15:19:41.767695
3372,17,72,5,63,131,288,2022-05-12 15:19:42.897373
3389,475,19213,444,671,5657,26460,2022-05-12 15:19:53.430125
3391,344,417,260,382,1857,3260,2022-05-12 15:19:57.099332
3392,277,18106,163,157,3397,22100,2022-05-12 15:19:57.578403
3394,109,2405,62,75,1311,3962,2022-05-12 15:19:59.717977
3398,72,934,35,72,884,1997,2022-05-12 15:20:01.816702
3406,114,1054,115,142,2085,3510,2022-05-12 15:20:08.22696
3407,3976,33757,3761,6585,30805,78884,2022-05-12 15:20:12.438972
3414,21,99,10,80,130,340,2022-05-12 15:20:14.231444
3417,201,2658,179,273,1880,5191,2022-05-12 15:20:17.29729
3418,172,593,122,164,1232,2283,2022-05-12 15:20:19.380088
3419,326,7996,199,129,3103,11753,2022-05-12 15:20:22.328135
3420,3380,36493,2934,2579,40043,85429,2022-05-12 15:20:25.715455
3421,144,3400,86,94,2074,5798,2022-05-12 15:20:29.949028
3424,139,546,132,160,1792,2769,2022-05-12 15:20:31.641266
3425,82,430,62,92,731,1397,2022-05-12 15:20:33.807064
3430,182,5950,112,120,3334,9698,2022-05-12 15:20:36.797184
3435,59,441,48,123,610,1281,2022-05-12 15:20:42.355522
3436,37,313,38,114,225,727,2022-05-12 15:20:44.324311
3437,429,947,364,296,2224,4260,2022-05-12 15:20:46.498384
3444,159,930,107,223,1334,2753,2022-05-12 15:20:49.441413
3446,306,30113,116,119,3002,33656,2022-05-12 15:20:52.335415
3447,177,7002,162,165,4471,11977,2022-05-12 15:20:54.42229
3448,481,4281,301,264,4320,9647,2022-05-12 15:20:54.823122
3449,195,7642,206,106,2264,10413,2022-05-12 15:20:57.215057
3451,24,153,10,62,168,417,2022-05-12 15:20:58.576206
3455,30769,370415,20724,32276,120859,575043,2022-05-12 15:20:58.740627
3456,419,23386,215,201,5695,29916,2022-05-12 15:20:59.057577
3457,18654,426684,12417,29280,69523,556558,2022-05-12 15:20:59.460367
3463,68,877,51,131,836,1963,2022-05-12 15:21:04.630838
3465,51,296,28,57,647,1079,2022-05-12 15:21:07.41909
3467,4705,84808,2983,3999,30656,127151,2022-05-12 15:21:11.299815
3472,47,1303,24,74,637,2085,2022-05-12 15:21:21.796232
3473,24,1251,12,64,308,1659,2022-05-12 15:21:24.778228
3474,31,1724,10,40,277,2082,2022-05-12 15:21:26.981809
3480,58,722,38,53,781,1652,2022-05-12 15:21:28.814371
3482,57,795,42,83,792,1769,2022-05-12 15:21:33.691086
3483,75,1625,61,76,1270,3107,2022-05-12 15:21:35.252165
3484,93,1784,66,70,1513,3526,2022-05-12 15:21:37.237295
3488,275,2856,138,127,5209,8605,2022-05-12 15:21:40.957788
3490,36,852,13,39,479,1419,2022-05-12 15:21:42.952073
3493,218,3859,163,182,1654,6076,2022-05-12 15:21:43.995379
3496,38,352,16,48,349,803,2022-05-12 15:21:46.244332
3498,37,534,29,55,453,1108,2022-05-12 15:21:49.305501
3500,18,102,11,67,128,326,2022-05-12 15:21:51.053142
3501,226,1904,203,178,2322,4833,2022-05-12 15:21:53.109505
3503,11071,145508,6714,13256,54234,230783,2022-05-12 15:21:53.547128
3505,110,602,97,137,1022,1968,2022-05-12 15:21:55.639373
3506,45,3575,25,40,490,4175,2022-05-12 15:21:58.211093
3507,40,2965,15,34,536,3590,2022-05-12 15:22:00.599587
3508,1302,14964,1003,521,16977,34767,2022-05-12 15:22:03.284855
3509,108,1941,38,58,1299,3444,2022-05-12 15:22:05.952872
3512,99,2014,45,64,1683,3905,2022-05-12 15:22:10.618748
3514,44,163,28,102,645,982,2022-05-12 15:22:13.983303
3515,642,31271,403,260,5090,37666,2022-05-12 15:22:16.711242
3516,20,309,17,62,209,617,2022-05-12 15:22:18.118108
3517,16,158,7,50,124,355,2022-05-12 15:22:19.919598
3518,65,1583,35,45,1053,2781,2022-05-12 15:22:22.1599
3522,104,1383,65,73,1619,3244,2022-05-12 15:22:24.468395
3525,66,3671,24,47,607,4415,2022-05-12 15:22:26.707787
3533,57,411,51,96,811,1426,2022-05-12 15:22:28.17444
3535,115,2035,69,128,1142,3489,2022-05-12 15:22:30.361437
3546,52,425,33,87,426,1023,2022-05-12 15:22:35.516636
3547,39,522,25,61,480,1127,2022-05-12 15:22:37.558454
3549,2111,16423,2523,2950,16572,40579,2022-05-12 15:22:40.323095
3561,140,1096,107,178,778,2299,2022-05-12 15:22:42.998717
3565,63,588,47,87,417,1202,2022-05-12 15:22:44.619927
3568,164,1166,111,192,1497,3130,2022-05-12 15:22:45.503125
3571,119,1817,133,256,1261,3586,2022-05-12 15:22:50.884979
3572,7082,77487,5667,4753,43278,138267,2022-05-12 15:22:53.541548
3573,60,191,53,151,595,1050,2022-05-12 15:22:55.002783
3574,824,13613,581,450,10194,25662,2022-05-12 15:22:58.050547
3577,1844,11382,1915,2275,10135,27551,2022-05-12 15:23:00.824625
3579,471,1875,436,393,3773,6948,2022-05-12 15:23:02.897987
3588,106720,889351,91281,79654,290172,1457178,2022-05-12 15:23:03.354729
3593,794,12631,457,328,5372,19582,2022-05-12 15:23:04.360614
3595,129,870,72,82,1326,2479,2022-05-12 15:23:08.093549
3600,79,799,48,80,1167,2173,2022-05-12 15:23:14.956714
3602,112,2084,92,68,1822,4178,2022-05-12 15:23:17.759639
3603,1906,37694,820,1232,19234,60886,2022-05-12 15:23:20.494752
3605,53,532,27,52,667,1331,2022-05-12 15:23:24.425831
3609,113,1028,110,158,871,2280,2022-05-12 15:23:24.868368
3615,1776,18797,1537,2268,11161,35539,2022-05-12 15:23:31.622811
3616,1959,22537,1659,2572,10273,39000,2022-05-12 15:23:34.381049
3619,78,582,65,139,893,1757,2022-05-12 15:23:37.15815
3620,74,1757,63,85,893,2872,2022-05-12 15:23:39.142732
3624,56,1745,60,110,427,2398,2022-05-12 15:23:41.133316
3625,174,3586,73,119,2967,6919,2022-05-12 15:23:43.538665
3630,44,226,37,108,337,752,2022-05-12 15:23:48.509882
3631,73,957,49,164,537,1780,2022-05-12 15:23:51.835118
3637,68,295,37,100,384,884,2022-05-12 15:23:53.321377
3640,57,792,29,64,626,1568,2022-05-12 15:23:57.405279
3642,198,2406,71,113,2386,5174,2022-05-12 15:24:03.170994
3646,66,821,40,59,1265,2251,2022-05-12 15:24:05.011304
3652,4729,126088,2796,2103,43151,178867,2022-05-12 15:24:05.194801
3653,2226,21658,1870,3652,11396,40802,2022-05-12 15:24:08.562686
3655,9631,75669,9555,10503,52885,158243,2022-05-12 15:24:14.123523
3656,3631,25052,3283,4838,19878,56682,2022-05-12 15:24:18.010302
3659,21,281,18,53,241,614,2022-05-12 15:24:19.33927
3661,48,769,21,42,577,1457,2022-05-12 15:24:21.555384
3685,22,2636,13,55,329,3055,2022-05-12 15:24:49.081073
3667,7280,81562,5001,9597,55878,159318,2022-05-12 15:24:25.635369
3668,568,2430,624,994,3932,8548,2022-05-12 15:24:27.74647
3669,41,679,24,86,415,1245,2022-05-12 15:24:29.412565
3672,69,1506,78,169,711,2533,2022-05-12 15:24:35.680112
3673,1840,12776,1559,1526,14815,32516,2022-05-12 15:24:37.929057
3674,268,9110,253,176,5867,15674,2022-05-12 15:24:41.561705
3675,70,789,29,71,850,1809,2022-05-12 15:24:43.010562
3676,113,393,107,131,985,1729,2022-05-12 15:24:44.414107
3686,110,3006,100,89,1266,4571,2022-05-12 15:24:51.295452
3689,46,377,31,90,317,861,2022-05-12 15:24:52.653368
3695,40,339,22,48,446,895,2022-05-12 15:24:59.259806
3701,6624,45096,4678,3241,74506,134145,2022-05-12 15:24:59.712177
3702,6558,122315,4666,5122,56564,195225,2022-05-12 15:25:03.076535
3704,99,239,88,211,348,985,2022-05-12 15:25:04.630269
3712,8397,352864,4929,5154,41939,413283,2022-05-12 15:25:05.664583
3713,4056,50759,3710,2667,35367,96559,2022-05-12 15:25:09.000173
3720,40,1061,17,63,390,1571,2022-05-12 15:25:11.534421
3723,35,420,31,112,203,801,2022-05-12 15:25:13.432501
3724,72,338,65,108,364,947,2022-05-12 15:25:13.851373
3726,47,682,20,47,502,1298,2022-05-12 15:25:16.733146
3727,86,6302,51,125,710,7274,2022-05-12 15:25:19.189881
3731,10213,173437,6966,11668,58472,260756,2022-05-12 15:25:22.610943
3735,63,436,33,62,718,1312,2022-05-12 15:25:25.322002
3736,289,1130,275,407,1424,3525,2022-05-12 15:25:26.419448
3737,96,5027,80,249,1047,6499,2022-05-12 15:25:29.04939
3738,54,4190,39,118,332,4733,2022-05-12 15:25:31.799538
3743,28,1555,14,55,319,1971,2022-05-12 15:25:33.752283
3744,75,3373,43,101,786,4378,2022-05-12 15:25:36.906283
3751,41,1185,22,53,675,1976,2022-05-12 15:25:43.09518
3752,35,1235,19,65,349,1703,2022-05-12 15:25:44.799469
3755,23,547,11,59,279,919,2022-05-12 15:25:48.592074
3759,619,40900,454,461,8591,51025,2022-05-12 15:25:53.053661
3760,45,769,28,56,840,1738,2022-05-12 15:25:54.969255
3762,46,391,25,44,440,946,2022-05-12 15:25:56.770054
3763,45,420,28,41,459,993,2022-05-12 15:25:58.025185
3768,60,214,42,111,494,921,2022-05-12 15:26:06.040938
3772,115,3065,125,547,360,4212,2022-05-12 15:26:09.277451
3778,39,405,23,58,403,928,2022-05-12 15:26:12.204484
3782,2962,174636,1510,543,40515,220166,2022-05-12 15:26:12.641624
3783,2760,164565,1330,530,39787,208972,2022-05-12 15:26:13.04535
3784,6383,374061,2495,1062,80830,464831,2022-05-12 15:26:13.457023
3785,4817,289505,2076,820,77387,374605,2022-05-12 15:26:13.69224
3806,80,404,63,141,634,1322,2022-05-12 15:26:17.169664
3807,168,1140,136,176,1374,2994,2022-05-12 15:26:19.080065
3808,55,244,35,98,450,882,2022-05-12 15:26:20.871191
3809,122,1821,87,177,952,3159,2022-05-12 15:26:23.283738
3812,30,429,24,103,196,782,2022-05-12 15:26:29.905445
3816,55,846,35,53,564,1553,2022-05-12 15:26:33.999699
3817,29,310,14,41,339,733,2022-05-12 15:26:35.526383
3819,119,406,64,152,823,1564,2022-05-12 15:26:38.607373
3821,37,1909,25,40,757,2768,2022-05-12 15:26:42.535757
3822,45,185,19,93,395,737,2022-05-12 15:26:43.78338
3823,30,447,17,104,224,822,2022-05-12 15:26:45.167444
3827,77,420,57,127,704,1385,2022-05-12 15:26:47.399663
3828,16,85,10,61,150,322,2022-05-12 15:26:48.599366
3834,30,301,23,93,186,633,2022-05-12 15:26:53.856076
3835,101,842,73,189,991,2196,2022-05-12 15:26:54.87016
3839,51,299,25,79,434,888,2022-05-12 15:27:00.535914
3840,845,5856,837,1501,7006,16045,2022-05-12 15:27:02.692358
3841,5855,25577,6452,5210,16820,59914,2022-05-12 15:27:05.866536
3842,52,1030,37,65,924,2108,2022-05-12 15:27:07.452636
3843,45,858,29,88,473,1493,2022-05-12 15:27:09.136236
3844,50,239,24,118,406,837,2022-05-12 15:27:10.841676
3846,39,170,26,92,254,581,2022-05-12 15:27:12.830672
3847,49,1061,21,75,607,1813,2022-05-12 15:27:15.140573
3848,652,46651,487,400,8705,56895,2022-05-12 15:27:15.330827
3853,43,1366,27,81,523,2040,2022-05-12 15:27:18.393971
3854,76,909,72,90,1191,2338,2022-05-12 15:27:20.991052
3864,68,1390,49,70,883,2460,2022-05-12 15:27:31.495059
3868,92,1190,77,108,1791,3258,2022-05-12 15:27:34.475136
3870,47,252,41,125,413,878,2022-05-12 15:27:37.355626
3873,50,340,47,95,467,999,2022-05-12 15:27:38.696892
3874,125,891,92,161,698,1967,2022-05-12 15:27:40.395016
3875,55,699,60,120,468,1402,2022-05-12 15:27:41.811697
3877,88,437,65,120,711,1421,2022-05-12 15:27:44.694368
3878,81,611,81,150,915,1838,2022-05-12 15:27:46.100672
3879,67,356,41,113,516,1093,2022-05-12 15:27:48.006782
3880,70,315,39,101,599,1124,2022-05-12 15:27:49.304385
3881,70,371,47,116,560,1164,2022-05-12 15:27:50.651275
3884,44,540,35,42,437,1098,2022-05-12 15:27:53.681635
3885,43,202,33,86,505,869,2022-05-12 15:27:55.191072
3886,85,3360,43,95,1272,4855,2022-05-12 15:27:57.518181
3887,107,10255,94,101,1908,12465,2022-05-12 15:28:00.432935
3889,265,4459,99,131,2644,7598,2022-05-12 15:28:02.774743
3900,137,473,127,192,1065,1994,2022-05-12 15:28:05.389185
3901,2183,136081,1647,965,27046,167922,2022-05-12 15:28:08.070915
3905,48,1000,32,86,1046,2212,2022-05-12 15:28:10.294444
3909,33,204,31,98,318,684,2022-05-12 15:28:16.661152
3914,261,6495,129,202,5199,12286,2022-05-12 15:28:21.982364
3915,113,701,117,243,1056,2230,2022-05-12 15:28:23.614698
3923,53,676,34,71,401,1235,2022-05-12 15:28:25.402817
3927,4631,111817,2539,1624,18237,138848,2022-05-12 15:28:25.818066
3930,12,1126,6,40,132,1316,2022-05-12 15:28:29.469261
3931,457,20431,223,244,5543,26898,2022-05-12 15:28:32.238079
3932,66,337,64,121,493,1081,2022-05-12 15:28:33.709426
3937,22,171,11,89,114,407,2022-05-12 15:28:38.663703
3946,78,1903,66,79,1564,3690,2022-05-12 15:28:40.329246
3948,425,5707,272,200,4828,11432,2022-05-12 15:28:43.978453
3954,109,5343,115,89,2539,8195,2022-05-12 15:28:49.90547
3956,629,30810,562,400,8267,40668,2022-05-12 15:28:51.136307
3958,7540,81951,4937,4406,56873,155707,2022-05-12 15:28:53.886006
3963,109,2119,117,134,2043,4522,2022-05-12 15:29:02.001131
3965,239,21640,215,122,5164,27380,2022-05-12 15:29:06.667986
3968,68,701,48,64,846,1727,2022-05-12 15:29:08.517815
3969,57,358,40,118,452,1025,2022-05-12 15:29:09.919221
3972,9245,83198,8805,10521,13388,125157,2022-05-12 15:29:13.071218
3974,4451,41111,3307,2815,36981,88665,2022-05-12 15:29:17.034541
3975,46,164,31,116,273,630,2022-05-12 15:29:18.159134
3989,94,1132,42,40,1245,2553,2022-05-12 15:29:22.905277
4003,494,1937,224,217,3958,6830,2022-05-12 15:29:27.888566
4013,43,406,32,98,291,870,2022-05-12 15:29:30.254175
4015,825,45301,733,430,11746,59035,2022-05-12 15:29:32.664285
4021,1618,18159,1439,2127,11937,35280,2022-05-12 15:29:35.53588
4023,60,934,47,117,446,1604,2022-05-12 15:29:37.750315
4025,35,710,34,127,369,1275,2022-05-12 15:29:41.954519
4026,404,75393,256,259,4185,80497,2022-05-12 15:29:45.580188
4028,1187,23526,1236,1144,7968,35061,2022-05-12 15:29:48.474839
4031,71,1266,37,56,906,2336,2022-05-12 15:29:48.907719
4039,3551,9969,2820,2579,19691,38610,2022-05-12 15:29:55.999521
4044,96,553,92,170,806,1717,2022-05-12 15:29:58.303475
4049,39,392,35,117,301,884,2022-05-12 15:29:59.919759
4050,162,1533,151,206,1105,3157,2022-05-12 15:30:02.11877
4052,497,13250,485,909,2997,18138,2022-05-12 15:30:04.299185
4053,677,27234,384,346,4951,33592,2022-05-12 15:30:08.056005
4054,30,385,22,103,227,767,2022-05-12 15:30:09.68536
4056,100,1636,71,117,770,2694,2022-05-12 15:30:11.613386
4058,53,952,40,55,757,1857,2022-05-12 15:30:13.329944
4059,2255,257700,1022,780,25236,286993,2022-05-12 15:30:13.752557
4061,79,1332,79,118,745,2353,2022-05-12 15:30:19.661322
4062,155,541,137,163,1237,2233,2022-05-12 15:30:22.920203
4063,15428,257259,8155,12761,79122,372725,2022-05-12 15:30:23.081171
4066,1116,7354,1003,1659,7302,18434,2022-05-12 15:30:25.954238
4067,122,457,82,152,1510,2323,2022-05-12 15:30:28.505348
4068,91,347,58,118,1112,1726,2022-05-12 15:30:30.03427
4069,199,6143,255,416,875,7888,2022-05-12 15:30:33.283898
4070,45,1152,49,78,810,2134,2022-05-12 15:30:35.845379
4071,69,1440,63,81,1164,2817,2022-05-12 15:30:37.701487
4074,37,612,11,72,559,1291,2022-05-12 15:30:40.978887
4075,66,1393,52,54,926,2491,2022-05-12 15:30:42.80172
4080,2171,16956,1709,1019,9767,31622,2022-05-12 15:30:47.759027
4081,29345,204066,19873,10980,215743,480007,2022-05-12 15:30:48.125357
4082,250,7443,152,107,2984,10936,2022-05-12 15:30:48.288728
4083,52,380,49,110,403,994,2022-05-12 15:30:51.996392
4085,43,334,30,56,815,1278,2022-05-12 15:30:53.881613
4088,49,217,85,180,364,895,2022-05-12 15:30:58.554105
4095,72,2838,47,50,1679,4686,2022-05-12 15:31:05.957096
4096,13,182,6,37,98,336,2022-05-12 15:31:07.468807
4098,42,271,23,53,626,1015,2022-05-12 15:31:12.435622
4101,73,139,59,99,562,932,2022-05-12 15:31:14.875432
4103,49,1161,17,53,530,1810,2022-05-12 15:31:16.786363
4106,1935,91263,823,374,30341,124736,2022-05-12 15:31:21.723747
4107,2617,105026,1350,827,38503,148323,2022-05-12 15:31:22.180483
4113,73,540,77,158,807,1655,2022-05-12 15:31:24.518228
4114,233,2020,182,208,1944,4587,2022-05-12 15:31:24.76736
4119,138,349,92,122,1109,1810,2022-05-12 15:31:26.774468
4121,41,166,24,78,338,647,2022-05-12 15:31:28.480126
4129,18,388,15,45,266,732,2022-05-12 15:31:33.106246
4130,745,12515,751,1571,8937,24519,2022-05-12 15:31:35.785351
4131,37,150,10,48,290,535,2022-05-12 15:31:37.082416
4134,946,47885,521,488,10741,60581,2022-05-12 15:31:39.374735
4138,38,2326,25,66,396,2851,2022-05-12 15:31:45.829758
4149,109,1460,61,89,928,2647,2022-05-12 15:31:49.250309
4151,4058,29171,2871,3774,24032,63906,2022-05-12 15:31:54.878579
4154,71,1116,58,166,467,1878,2022-05-12 15:31:56.759061
4155,3066,187596,893,658,20511,212724,2022-05-12 15:32:00.099551
4156,115,11457,106,72,2162,13912,2022-05-12 15:32:03.512391
4162,108,2786,79,55,1487,4515,2022-05-12 15:32:07.179994
4163,1193,37935,659,373,10103,50263,2022-05-12 15:32:07.623942
4166,238,3368,147,123,2452,6328,2022-05-12 15:32:10.3586
4173,160,1850,216,190,1615,4031,2022-05-12 15:32:12.69511
4181,34370,735855,19216,15309,269457,1074207,2022-05-12 15:32:18.067561
4182,1357,108612,757,430,20701,131857,2022-05-12 15:32:22.402067
4183,58,354,46,114,495,1067,2022-05-12 15:32:22.854528
4188,1484,15394,750,530,11428,29586,2022-05-12 15:32:30.944532
4189,1240,5388,1034,1548,13210,22420,2022-05-12 15:32:33.645696
5196,251,6596,214,168,3527,10756,2022-05-12 15:44:38.808675
4190,45,682,30,55,577,1389,2022-05-12 15:32:37.633957
4191,135,1054,145,191,1394,2919,2022-05-12 15:32:39.600561
4196,2291,38141,1456,1695,17337,60920,2022-05-12 15:32:42.168445
4198,179,1164,169,214,1178,2904,2022-05-12 15:32:48.999818
4199,65,568,66,131,618,1448,2022-05-12 15:32:50.471264
4200,288,3399,200,130,2519,6536,2022-05-12 15:32:52.986531
4201,54,346,26,48,828,1302,2022-05-12 15:32:54.850045
4208,100,831,84,166,686,1867,2022-05-12 15:33:02.150255
4209,357,2559,326,483,1846,5571,2022-05-12 15:33:05.044939
4211,188,323,76,117,1242,1946,2022-05-12 15:33:09.695913
4213,98,1337,68,60,1149,2712,2022-05-12 15:33:11.73308
4214,9157,327617,5623,7994,36133,386524,2022-05-12 15:33:14.909602
4218,9,213,3,37,113,375,2022-05-12 15:33:17.026363
4220,12,158,7,42,171,390,2022-05-12 15:33:19.336233
4224,87555,1497838,51788,56925,268778,1962884,2022-05-12 15:33:19.597514
4232,290,7507,193,195,3141,11326,2022-05-12 15:33:24.465518
4240,143,533,143,138,1188,2145,2022-05-12 15:33:27.807039
4242,71,248,64,92,609,1084,2022-05-12 15:33:31.02393
4246,673,29640,526,444,12148,43431,2022-05-12 15:33:35.624231
4250,37,909,11,61,281,1299,2022-05-12 15:33:37.105229
4252,62,666,39,49,631,1447,2022-05-12 15:33:39.402346
4262,2395,23571,1752,2551,14927,45196,2022-05-12 15:33:41.930866
4264,389,1335,373,629,3648,6374,2022-05-12 15:33:43.960686
4280,2502,154656,1304,455,38220,197137,2022-05-12 15:33:46.415105
4282,4078,154416,1890,812,56494,217690,2022-05-12 15:33:46.754152
4306,85,1236,55,74,1840,3290,2022-05-12 15:33:49.303351
4312,204,4708,122,109,2613,7756,2022-05-12 15:33:52.616439
4316,19,243,12,54,205,533,2022-05-12 15:33:55.088848
4318,73,990,35,65,824,1987,2022-05-12 15:33:56.211928
4320,141,5084,111,99,2343,7778,2022-05-12 15:33:58.885353
4331,63,214,44,199,193,713,2022-05-12 15:34:02.262459
4332,35,305,36,99,366,841,2022-05-12 15:34:05.250067
4334,2419,15199,2486,5629,11469,37202,2022-05-12 15:34:08.237327
4339,96,793,67,176,788,1920,2022-05-12 15:34:10.262899
4353,134,4881,109,181,1781,7086,2022-05-12 15:34:13.339325
4361,208,3053,182,117,2491,6051,2022-05-12 15:34:16.305529
4371,55,650,25,63,535,1328,2022-05-12 15:34:19.611407
4382,15639,351184,10866,10108,96434,484231,2022-05-12 15:34:23.09093
4383,38,852,29,59,517,1495,2022-05-12 15:34:24.927603
4385,61,1302,40,80,687,2170,2022-05-12 15:34:27.83548
4389,97,1891,51,130,1016,3185,2022-05-12 15:34:33.892198
4390,27,955,8,65,187,1242,2022-05-12 15:34:35.792395
4391,37,1204,17,58,223,1539,2022-05-12 15:34:38.226416
4394,24,788,10,58,147,1027,2022-05-12 15:34:42.742453
4396,14,926,5,41,116,1102,2022-05-12 15:34:45.227813
4398,36,2334,21,75,732,3198,2022-05-12 15:34:49.714466
4411,78,592,67,132,560,1429,2022-05-12 15:34:51.753874
4415,2278,29135,1889,2637,13760,49699,2022-05-12 15:34:54.705041
4416,134,1313,114,138,1744,3443,2022-05-12 15:34:57.203164
4419,76,1231,54,97,1149,2607,2022-05-12 15:35:02.895769
4427,84,335,76,125,658,1278,2022-05-12 15:35:09.72874
4437,2248,212629,846,628,18503,234854,2022-05-12 15:35:10.013685
4439,92,626,66,157,799,1740,2022-05-12 15:35:11.867994
4440,29,191,13,64,305,602,2022-05-12 15:35:13.571847
4443,127,3458,123,321,915,4944,2022-05-12 15:35:16.492666
4444,75,1337,50,190,733,2385,2022-05-12 15:35:18.202584
4447,420,37492,221,245,3746,42124,2022-05-12 15:35:18.835145
4450,206,5416,240,241,4266,10369,2022-05-12 15:35:21.541714
4451,108,909,62,73,1021,2173,2022-05-12 15:35:23.902581
4452,36,420,13,39,334,842,2022-05-12 15:35:26.213442
4454,216,8324,138,146,3269,12093,2022-05-12 15:35:28.319435
4458,21,2232,20,44,508,2825,2022-05-12 15:35:30.460764
4459,495,0,189,461,498,1643,2022-05-12 15:35:32.549617
4460,126,5793,51,74,2307,8351,2022-05-12 15:35:35.136233
4461,33,1447,14,28,508,2030,2022-05-12 15:35:38.6166
4462,17,1256,5,43,107,1428,2022-05-12 15:35:40.833863
4467,26,1665,10,36,393,2130,2022-05-12 15:35:42.609902
4468,38,409,22,74,249,792,2022-05-12 15:35:44.287559
4469,165,6406,168,225,3341,10305,2022-05-12 15:35:45.103688
4470,36,162,26,78,355,657,2022-05-12 15:35:46.851515
4471,47,759,29,51,676,1562,2022-05-12 15:35:48.683433
4475,54,1809,24,43,958,2888,2022-05-12 15:35:50.960653
4476,141,2208,96,94,1808,4347,2022-05-12 15:35:53.012265
4477,2857,91403,2144,1248,19259,116911,2022-05-12 15:35:56.596239
4484,75,538,35,62,967,1677,2022-05-12 15:36:04.337786
4485,111,844,63,81,1431,2530,2022-05-12 15:36:06.693447
4503,255,3772,250,259,2539,7075,2022-05-12 15:36:08.430378
4504,41,269,27,83,315,735,2022-05-12 15:36:10.44019
4508,184,3223,153,143,2846,6549,2022-05-12 15:36:12.760829
4509,26,479,19,63,277,864,2022-05-12 15:36:14.330451
4511,30,353,42,100,314,839,2022-05-12 15:36:15.850618
4513,122,2501,62,111,2054,4850,2022-05-12 15:36:18.362064
4514,63,1349,48,159,358,1977,2022-05-12 15:36:19.274794
4515,48,848,42,127,391,1456,2022-05-12 15:36:21.087237
4521,22,322,18,55,243,660,2022-05-12 15:36:22.297805
4522,44,658,24,46,411,1183,2022-05-12 15:36:23.761066
4524,85,804,41,60,856,1846,2022-05-12 15:36:25.719282
4531,105,2657,58,127,1351,4298,2022-05-12 15:36:27.87516
4532,161,710,144,139,1988,3142,2022-05-12 15:36:28.921956
4535,3114,40442,2080,2556,21922,70114,2022-05-12 15:36:34.188567
4536,69,432,49,116,501,1167,2022-05-12 15:36:36.048012
4537,70,783,35,77,638,1603,2022-05-12 15:36:37.826643
4540,115,2846,71,112,1739,4883,2022-05-12 15:36:39.822138
4548,8925,43560,5524,6033,77420,141462,2022-05-12 15:36:42.889206
4550,1795,23529,1828,2676,12852,42680,2022-05-12 15:36:49.97915
4551,5032,69612,3954,4528,32025,115151,2022-05-12 15:36:54.321011
4554,61,287,56,112,574,1090,2022-05-12 15:36:56.908628
4563,99,891,65,146,653,1854,2022-05-12 15:36:59.155389
4565,4268,128264,1716,1106,57826,193180,2022-05-12 15:36:59.397531
4578,74,706,46,101,977,1904,2022-05-12 15:37:08.314355
4581,5583,53628,4052,4639,47214,115116,2022-05-12 15:37:08.586414
4584,44,1342,34,155,243,1818,2022-05-12 15:37:11.082351
4586,49,1010,60,181,296,1596,2022-05-12 15:37:13.821438
4591,298,1379,213,334,2517,4741,2022-05-12 15:37:16.40169
4596,749,23837,617,535,13133,38871,2022-05-12 15:37:19.705962
4597,52,314,41,98,421,926,2022-05-12 15:37:21.51726
4598,18,142,13,104,126,403,2022-05-12 15:37:22.596392
4599,28,471,24,102,217,842,2022-05-12 15:37:24.655696
4615,59,532,62,146,535,1334,2022-05-12 15:37:29.304676
4616,23,598,15,93,159,888,2022-05-12 15:37:30.909293
4617,72,1013,43,54,1124,2306,2022-05-12 15:37:32.666183
4618,1864,24775,1725,2014,14763,45141,2022-05-12 15:37:35.166388
4621,13,72,4,69,109,267,2022-05-12 15:37:36.737851
4640,54,358,23,61,748,1244,2022-05-12 15:37:39.065847
4650,169,3830,70,91,2147,6307,2022-05-12 15:37:42.465355
4651,263,1008,234,241,1685,3431,2022-05-12 15:37:44.756007
4654,46098,442185,33960,32579,183171,737993,2022-05-12 15:37:49.066852
4657,1298,6199,1178,1833,5229,15737,2022-05-12 15:37:52.673786
4660,13,322,5,33,199,572,2022-05-12 15:37:53.912504
4662,719,12011,593,637,5228,19188,2022-05-12 15:37:56.95758
4663,151,2468,105,152,1175,4051,2022-05-12 15:38:00.390332
4664,243,6362,194,188,4289,11276,2022-05-12 15:38:01.410546
4672,1417,52958,790,658,27623,83446,2022-05-12 15:38:04.729581
4681,30,410,16,59,385,900,2022-05-12 15:38:07.530294
4682,16,288,9,51,184,548,2022-05-12 15:38:08.731354
4684,17,103,24,78,179,401,2022-05-12 15:38:10.087377
4688,89,1323,49,66,989,2516,2022-05-12 15:38:11.119326
4690,423,3677,531,535,3774,8940,2022-05-12 15:38:14.947447
4693,63,531,37,80,353,1064,2022-05-12 15:38:17.073454
4703,99,2952,77,118,1508,4754,2022-05-12 15:38:18.566282
4705,584,23480,497,452,7270,32283,2022-05-12 15:38:21.806913
4709,17,240,19,127,163,566,2022-05-12 15:38:23.286377
4712,148,4487,114,175,2184,7108,2022-05-12 15:38:26.147504
4713,666,15101,371,544,13322,30004,2022-05-12 15:38:26.589011
4715,167,12904,122,80,3122,16395,2022-05-12 15:38:29.114447
4718,186,4564,104,123,1990,6967,2022-05-12 15:38:31.731956
4719,5782,40440,3720,7605,30828,88375,2022-05-12 15:38:34.817522
4720,5569,41057,3853,6325,54014,110818,2022-05-12 15:38:38.110888
4722,8863,169798,6183,7193,55221,247258,2022-05-12 15:38:38.528866
4725,9558,112464,7493,7730,87152,224397,2022-05-12 15:38:44.23499
4726,2363,49998,1765,1654,15201,70981,2022-05-12 15:38:45.18489
4737,66,360,52,145,412,1035,2022-05-12 15:38:47.180791
36278,16,291,2,19,105,433,2022-05-12 20:05:33.892964
4744,5416,103176,3248,5347,27196,144383,2022-05-12 15:38:52.432204
4752,8198,288444,5109,8301,32715,342767,2022-05-12 15:38:52.710937
4760,936,20881,570,525,7997,30909,2022-05-12 15:38:59.171995
4761,54,655,46,57,1008,1820,2022-05-12 15:39:01.146417
4765,413,13443,351,274,7711,22192,2022-05-12 15:39:03.803498
4773,129,622,78,138,1199,2166,2022-05-12 15:39:11.145211
4782,52,222,40,91,297,702,2022-05-12 15:39:12.497467
36280,12,352,3,31,64,462,2022-05-12 20:05:37.137643
4786,238,8050,201,194,3018,11701,2022-05-12 15:39:15.646333
4790,28,234,8,54,363,687,2022-05-12 15:39:18.137456
4792,158,20937,133,190,2083,23501,2022-05-12 15:39:20.9205
4794,147,11823,122,178,2237,14507,2022-05-12 15:39:26.241078
4795,152,15080,135,189,2397,17953,2022-05-12 15:39:29.257535
4798,290,9577,185,172,4126,14350,2022-05-12 15:39:32.025934
4800,55,883,60,112,498,1608,2022-05-12 15:39:34.079148
4801,56,221,29,94,330,730,2022-05-12 15:39:35.636459
4804,213,2742,147,95,2171,5368,2022-05-12 15:39:35.805275
4807,63,524,43,80,443,1153,2022-05-12 15:39:40.392539
4808,114,697,94,184,1015,2104,2022-05-12 15:39:43.046119
4814,4115,145394,1798,2118,14258,167683,2022-05-12 15:39:51.157497
4827,60,2220,54,85,707,3126,2022-05-12 15:39:55.791527
4851,104,2767,89,85,1971,5016,2022-05-12 15:39:58.301696
4854,118,943,84,100,1142,2387,2022-05-12 15:40:03.891895
4856,58,632,26,45,518,1279,2022-05-12 15:40:08.677295
4872,1420,39686,1012,522,18403,61043,2022-05-12 15:40:11.486406
4874,131,11050,121,161,2047,13510,2022-05-12 15:40:14.341351
4879,3399,16032,3211,3131,32141,57914,2022-05-12 15:40:21.268883
4886,825,23650,447,340,9404,34666,2022-05-12 15:40:24.313559
4890,26,1869,13,26,313,2247,2022-05-12 15:40:26.268673
4896,11756,99869,9382,11942,71172,204121,2022-05-12 15:40:29.9104
4898,65263,681914,47485,57428,208411,1060501,2022-05-12 15:40:30.153344
36311,5,15,2,38,27,87,2022-05-12 20:06:09.797173
4901,8266,188207,3816,1690,52924,254903,2022-05-12 15:40:30.589378
4903,1707,16718,1395,1634,12455,33909,2022-05-12 15:40:32.21674
4908,175,1619,146,344,2153,4437,2022-05-12 15:40:38.045531
4910,96,7308,104,144,1982,9634,2022-05-12 15:40:41.491112
4918,1468,44815,781,426,17472,64962,2022-05-12 15:40:44.87066
4921,148,4094,68,110,1682,6102,2022-05-12 15:40:45.316643
4926,71,1238,60,73,931,2373,2022-05-12 15:40:49.31064
4927,60,431,28,62,597,1178,2022-05-12 15:40:51.207834
4928,90,278,61,117,806,1352,2022-05-12 15:40:52.924194
4929,81,380,44,114,796,1415,2022-05-12 15:40:54.42587
4933,53,420,34,94,637,1238,2022-05-12 15:40:56.003797
4934,42,680,21,70,390,1203,2022-05-12 15:40:57.819207
4935,112,922,143,272,466,1915,2022-05-12 15:40:59.947674
4938,1303,40990,829,500,15223,58845,2022-05-12 15:41:06.425883
4939,146,1046,209,299,1341,3041,2022-05-12 15:41:08.878594
4941,29,359,14,43,425,870,2022-05-12 15:41:16.257188
4943,61,760,46,73,1064,2004,2022-05-12 15:41:17.898495
4948,51,881,23,75,590,1620,2022-05-12 15:41:19.421231
4961,76,704,43,80,707,1610,2022-05-12 15:41:21.239928
4966,20,1899,13,43,238,2213,2022-05-12 15:41:25.723393
4970,1247,74241,679,525,17097,93789,2022-05-12 15:41:26.531148
4981,8871,58836,8885,8791,64195,149578,2022-05-12 15:41:36.409925
4985,521,19507,365,297,8625,29315,2022-05-12 15:41:40.519233
4991,30,564,15,72,387,1068,2022-05-12 15:41:42.961755
4997,128,3825,98,100,1591,5742,2022-05-12 15:41:46.384335
5002,50,336,26,69,729,1210,2022-05-12 15:41:50.757468
5005,1240,6782,1088,1226,10591,20927,2022-05-12 15:41:53.812851
5006,34,806,14,61,284,1199,2022-05-12 15:41:56.006825
5013,46,314,12,64,318,754,2022-05-12 15:41:57.428516
5014,50,837,28,44,650,1609,2022-05-12 15:41:59.466357
5016,66,2352,34,51,1022,3525,2022-05-12 15:42:01.742126
5017,13,900,6,30,209,1158,2022-05-12 15:42:03.312013
5018,32,172,24,68,341,637,2022-05-12 15:42:04.746828
5019,99,2841,81,83,1816,4920,2022-05-12 15:42:07.570166
5020,710,8214,447,969,5604,15944,2022-05-12 15:42:09.99607
5022,51,331,55,108,370,915,2022-05-12 15:42:11.283554
5027,212,2910,209,537,1748,5616,2022-05-12 15:42:16.182327
5028,1912,50745,762,751,10985,65155,2022-05-12 15:42:16.644954
5029,331,14585,169,245,3657,18987,2022-05-12 15:42:20.056559
5032,402,4071,311,501,2859,8144,2022-05-12 15:42:25.8014
5034,2523,41453,1677,1352,25626,72631,2022-05-12 15:42:28.438365
5036,67,1075,49,56,770,2017,2022-05-12 15:42:30.667926
5037,59,1407,59,66,1124,2715,2022-05-12 15:42:32.443205
5040,10493,123959,7376,5634,65665,213127,2022-05-12 15:42:35.507484
5042,30284,195523,15730,15161,42027,298725,2022-05-12 15:42:36.538193
5043,65,1152,54,60,795,2126,2022-05-12 15:42:38.501459
5051,76,1499,57,80,1165,2877,2022-05-12 15:42:42.107225
36324,6,18,2,39,30,95,2022-05-12 20:06:28.334515
5052,73,447,100,230,746,1596,2022-05-12 15:42:44.613005
5053,147,2485,88,122,2954,5796,2022-05-12 15:42:46.593978
5060,19390,134381,17262,21782,49931,242746,2022-05-12 15:42:50.118632
5070,136,1290,93,163,765,2447,2022-05-12 15:42:56.040878
5071,79,398,59,124,399,1059,2022-05-12 15:42:57.679158
5072,200,6225,132,125,2429,9111,2022-05-12 15:43:01.534148
5074,1765,29636,1248,732,15240,48621,2022-05-12 15:43:04.194348
36325,6,14,3,39,31,93,2022-05-12 20:06:29.357851
5079,7680,50156,6601,8514,41338,114289,2022-05-12 15:43:07.990481
5081,86314,782045,56479,41741,305936,1272515,2022-05-12 15:43:10.648533
5082,224,1168,130,243,1429,3194,2022-05-12 15:43:14.493909
5085,125,4880,51,119,2149,7324,2022-05-12 15:43:20.346852
5088,36,255,32,106,308,737,2022-05-12 15:43:23.146442
5089,17,105,14,66,157,359,2022-05-12 15:43:24.553361
5091,62,828,40,128,348,1406,2022-05-12 15:43:26.850819
5098,27,431,15,81,358,912,2022-05-12 15:43:32.412071
5104,41,506,37,104,328,1016,2022-05-12 15:43:34.04276
5112,4745,74519,3929,9150,25388,117731,2022-05-12 15:43:37.511023
5114,217381,2066696,97420,44410,425421,2851328,2022-05-12 15:43:37.698746
5116,347,19650,195,167,4886,25245,2022-05-12 15:43:41.052939
5129,46,497,36,105,291,975,2022-05-12 15:43:44.123748
5132,332,2212,127,183,2532,5386,2022-05-12 15:43:48.991682
5136,45,657,38,49,784,1573,2022-05-12 15:43:53.424044
36679,5,103,1,15,25,149,2022-05-12 20:12:39.215466
5140,20,131,15,57,207,430,2022-05-12 15:43:54.743801
5143,76,279,44,117,675,1191,2022-05-12 15:43:57.175311
5147,80,1707,89,62,1207,3145,2022-05-12 15:43:59.392484
5151,36,208,36,65,712,1057,2022-05-12 15:44:02.097479
5152,444,41756,252,245,4751,47448,2022-05-12 15:44:04.86427
5153,189,852,133,158,1705,3037,2022-05-12 15:44:06.743268
5155,680,3660,645,843,7669,13497,2022-05-12 15:44:09.288204
5157,75,782,48,106,1213,2224,2022-05-12 15:44:11.886909
5162,1798,44653,1451,1167,14326,63395,2022-05-12 15:44:15.097603
5165,62,1966,52,85,1154,3319,2022-05-12 15:44:20.731637
5167,93,507,78,86,999,1763,2022-05-12 15:44:22.548783
5168,69,3606,35,49,1325,5084,2022-05-12 15:44:24.923226
5177,5086,77590,2123,1463,53715,139977,2022-05-12 15:44:27.713845
5178,871,24778,406,497,11809,38361,2022-05-12 15:44:30.547499
5192,16,160,15,44,199,434,2022-05-12 15:44:34.604813
5193,9,171,9,43,96,328,2022-05-12 15:44:36.572702
5197,67,639,56,123,661,1546,2022-05-12 15:44:41.286378
5199,239,3779,206,154,3488,7866,2022-05-12 15:44:43.82737
5200,179,1530,121,203,1163,3196,2022-05-12 15:44:44.837857
5201,40,571,29,93,201,934,2022-05-12 15:44:46.381684
5204,2503,132062,1455,474,39485,175979,2022-05-12 15:44:51.236852
5205,3550,132209,1800,693,51355,189607,2022-05-12 15:44:51.673315
5207,16,158,10,51,116,351,2022-05-12 15:44:53.512793
5216,334,10121,260,197,4245,15157,2022-05-12 15:44:53.76163
5220,3409,20291,3744,5533,22744,55721,2022-05-12 15:44:59.693222
5225,150,6263,93,111,2658,9275,2022-05-12 15:45:04.906672
5226,1426,4064,1055,1118,9790,17453,2022-05-12 15:45:08.510758
5228,586,26484,268,196,6887,34421,2022-05-12 15:45:11.641648
5231,10875,135651,8067,10280,17277,182150,2022-05-12 15:45:11.880365
5232,46,431,36,100,821,1434,2022-05-12 15:45:13.660754
5234,26,158,18,115,349,666,2022-05-12 15:45:16.787528
5237,36,529,34,47,393,1039,2022-05-12 15:45:21.001593
5238,42,506,63,78,1296,1985,2022-05-12 15:45:22.688437
5240,22,126,14,57,450,669,2022-05-12 15:45:24.183802
5241,29,199,20,67,226,541,2022-05-12 15:45:26.035434
5244,220,10125,236,148,4616,15345,2022-05-12 15:45:28.28143
5246,46,587,25,76,496,1230,2022-05-12 15:45:29.794951
5250,113,788,91,160,1118,2270,2022-05-12 15:45:33.126173
5256,102,8318,113,144,2093,10770,2022-05-12 15:45:41.884745
5258,8542,183571,3251,1788,42192,239344,2022-05-12 15:45:42.076573
5260,26,128,7,43,147,351,2022-05-12 15:45:43.619428
5262,4492,72408,3437,3898,12622,96857,2022-05-12 15:45:46.819715
5263,9,595,5,23,136,768,2022-05-12 15:45:48.191775
5267,237,1199,179,178,1596,3389,2022-05-12 15:45:49.758292
5270,84,3547,60,117,1118,4926,2022-05-12 15:45:52.545208
5272,32,344,12,60,223,671,2022-05-12 15:45:54.391704
5274,94,350,67,119,819,1449,2022-05-12 15:45:57.510946
5276,104,456,73,126,756,1515,2022-05-12 15:45:59.48566
5277,6944,174107,3228,3063,34983,222325,2022-05-12 15:46:02.245671
5278,63,156,25,89,478,811,2022-05-12 15:46:03.808147
5279,761,42617,442,253,8631,52704,2022-05-12 15:46:06.76083
5287,19,315,24,94,212,664,2022-05-12 15:46:08.456395
5288,86,1913,93,89,1643,3824,2022-05-12 15:46:10.473423
5291,291,6025,145,128,3591,10180,2022-05-12 15:46:17.801008
5296,71,1094,51,48,927,2191,2022-05-12 15:46:22.266013
5298,159,6808,109,163,2347,9586,2022-05-12 15:46:22.60978
5299,10,616,6,28,158,818,2022-05-12 15:46:24.066928
5300,7737,148653,4236,1875,63630,226131,2022-05-12 15:46:24.469997
5303,43,288,24,79,412,846,2022-05-12 15:46:25.427262
5304,84,1218,68,243,651,2264,2022-05-12 15:46:27.679715
5305,204,6900,147,99,2586,9936,2022-05-12 15:46:30.898061
5306,1356,17738,830,515,9925,30364,2022-05-12 15:46:33.672359
5307,1677,8708,1495,1966,10355,24201,2022-05-12 15:46:36.677233
5310,529,20159,268,247,7606,28809,2022-05-12 15:46:37.508185
5311,74,619,58,153,434,1338,2022-05-12 15:46:38.989991
5314,22,271,23,63,326,705,2022-05-12 15:46:41.152052
5322,61,570,38,96,438,1203,2022-05-12 15:46:42.513889
5330,104,1002,59,84,1202,2451,2022-05-12 15:46:44.842351
5332,114,7249,105,94,2013,9575,2022-05-12 15:46:47.972745
5333,473,11237,319,263,5091,17383,2022-05-12 15:46:50.573147
5337,1387,51390,867,2016,3739,59399,2022-05-12 15:46:53.432228
5341,14638,319320,10106,5013,99350,448427,2022-05-12 15:46:53.751706
5342,4419,59820,3786,5815,22605,96445,2022-05-12 15:46:56.934224
5343,116,558,74,133,1087,1968,2022-05-12 15:47:00.638796
5344,46,265,36,120,396,863,2022-05-12 15:47:02.801488
5348,182,9413,141,158,2396,12290,2022-05-12 15:47:03.042914
5351,154,3845,116,177,2675,6967,2022-05-12 15:47:04.066945
5353,137,531,127,106,743,1644,2022-05-12 15:47:06.09657
5356,10459,99002,8405,8197,83969,210032,2022-05-12 15:47:10.621998
5365,1136,62226,467,291,24234,88354,2022-05-12 15:47:11.070354
5369,157,5393,83,82,1836,7551,2022-05-12 15:47:15.089274
5372,86,881,58,80,990,2095,2022-05-12 15:47:15.494563
5374,30,125,9,67,171,402,2022-05-12 15:47:16.797719
5386,178,2095,84,130,3576,6063,2022-05-12 15:47:19.712066
5395,73,381,56,83,624,1217,2022-05-12 15:47:21.574838
5396,26,307,24,57,352,766,2022-05-12 15:47:23.361849
5397,63,3708,32,122,356,4281,2022-05-12 15:47:26.327313
5419,148,6401,130,97,2498,9274,2022-05-12 15:47:28.894032
5420,4810,20951,3776,2680,46141,78358,2022-05-12 15:47:29.333646
5421,42,588,17,73,420,1140,2022-05-12 15:47:31.02406
5447,72,1556,46,96,1124,2894,2022-05-12 15:47:33.291382
5449,31,716,25,68,430,1270,2022-05-12 15:47:35.529405
5454,1331,10310,1112,1737,9575,24065,2022-05-12 15:47:38.178073
5458,237,13724,150,191,3081,17383,2022-05-12 15:47:41.184795
5460,907,45757,313,378,5873,53228,2022-05-12 15:47:41.428733
5462,117,6113,110,144,1230,7714,2022-05-12 15:47:43.847058
5469,27,1225,11,48,530,1841,2022-05-12 15:47:47.559158
5472,13,402,19,34,272,740,2022-05-12 15:47:49.554482
5474,27,356,35,115,284,817,2022-05-12 15:47:51.668495
5476,87,391,72,154,672,1376,2022-05-12 15:47:53.642577
5477,28,152,14,73,269,536,2022-05-12 15:47:55.863677
5478,18,151,14,89,162,434,2022-05-12 15:47:57.704608
5484,179,1327,225,151,1283,3165,2022-05-12 15:47:59.57723
5485,901,5562,779,841,6095,14178,2022-05-12 15:48:02.403104
5493,253,8887,204,136,3174,12654,2022-05-12 15:48:06.287375
5494,339,2301,330,297,3254,6521,2022-05-12 15:48:08.758833
5501,86,1462,79,163,1164,2954,2022-05-12 15:48:13.018574
5503,22,273,16,79,341,731,2022-05-12 15:48:14.373792
5504,1230,11766,836,836,8825,23493,2022-05-12 15:48:15.284751
5505,464,4751,406,683,3413,9717,2022-05-12 15:48:17.636475
5507,7658,62401,5864,5979,43215,125117,2022-05-12 15:48:20.196385
5520,129,1076,134,171,1278,2788,2022-05-12 15:48:22.20663
5521,602,27157,382,245,8302,36688,2022-05-12 15:48:24.87759
5525,10973,122587,9607,13818,43431,200416,2022-05-12 15:48:25.055617
5526,164,30273,114,171,2053,32775,2022-05-12 15:48:30.042867
5530,23214,203659,20217,19274,135051,401415,2022-05-12 15:48:32.47867
5534,40,260,46,110,310,766,2022-05-12 15:48:35.437368
5535,46,352,12,43,380,833,2022-05-12 15:48:37.918809
5538,239,8898,194,136,4441,13908,2022-05-12 15:48:40.723198
5539,111,2058,74,107,1711,4061,2022-05-12 15:48:43.090766
5554,75,801,36,79,891,1882,2022-05-12 15:48:45.664992
5564,67,500,51,127,347,1092,2022-05-12 15:48:45.946247
5581,28,248,9,47,219,551,2022-05-12 15:48:50.463284
5583,81,6777,38,60,864,7820,2022-05-12 15:48:53.135928
5584,73,921,36,42,798,1870,2022-05-12 15:48:55.02473
5593,1719,36851,1091,985,17963,58609,2022-05-12 15:48:58.141607
5600,32,284,21,87,233,657,2022-05-12 15:49:05.484088
5618,125,319,155,217,634,1450,2022-05-12 15:49:09.864653
5620,45,739,26,93,410,1313,2022-05-12 15:49:11.497971
5622,56,1915,32,86,1035,3124,2022-05-12 15:49:14.135485
5624,60,3036,46,59,1029,4230,2022-05-12 15:49:16.757552
5628,43,320,44,136,314,857,2022-05-12 15:49:18.129155
5629,44,446,35,44,524,1093,2022-05-12 15:49:19.814567
5630,19968,299738,14482,10897,178651,523736,2022-05-12 15:49:20.248574
5647,71,464,48,91,772,1446,2022-05-12 15:49:30.075093
5648,86,455,40,91,615,1287,2022-05-12 15:49:31.660938
5652,44,752,41,46,656,1539,2022-05-12 15:49:33.345169
5656,46,2165,54,105,734,3104,2022-05-12 15:49:36.058998
5661,24,1010,6,65,176,1281,2022-05-12 15:49:40.389756
5667,3950,133617,1840,1351,21976,162734,2022-05-12 15:49:43.302397
5671,4950,42999,3720,4883,30691,87243,2022-05-12 15:49:49.771567
5673,62,795,49,68,973,1947,2022-05-12 15:49:52.275948
5675,2922,19557,2694,4286,14185,43644,2022-05-12 15:49:54.802914
5678,8582,69021,7925,8057,61410,154995,2022-05-12 15:49:59.36641
5680,45013,621611,29883,30050,217182,943739,2022-05-12 15:49:59.702781
5681,7810,350519,2863,1450,116872,479514,2022-05-12 15:50:00.112483
5682,16484,139523,12083,10667,129640,308397,2022-05-12 15:50:00.515329
5688,354,891,348,310,2025,3928,2022-05-12 15:50:04.331397
5689,45,385,32,69,651,1182,2022-05-12 15:50:06.034904
5690,3174,86294,1905,1048,28525,120946,2022-05-12 15:50:11.218652
5691,163,3634,126,81,2495,6499,2022-05-12 15:50:13.736501
5693,21,113,14,46,155,349,2022-05-12 15:50:14.921725
5702,1586,18136,1132,1186,14940,36980,2022-05-12 15:50:15.340262
5712,173,3755,127,207,1501,5763,2022-05-12 15:50:22.38288
5715,53,1244,42,59,656,2054,2022-05-12 15:50:27.882274
5717,697,25654,406,331,5180,32268,2022-05-12 15:50:28.332205
5719,1047,22701,392,486,4013,28639,2022-05-12 15:50:28.738676
5723,88,1358,61,101,1365,2973,2022-05-12 15:50:30.672029
5725,228,6397,169,276,1318,8388,2022-05-12 15:50:34.007595
5734,3806,38437,2434,2898,18875,66450,2022-05-12 15:50:34.346687
5742,55,1214,26,65,601,1961,2022-05-12 15:50:36.688741
5751,327,10389,177,192,3170,14255,2022-05-12 15:50:39.163664
5755,72,886,34,71,728,1791,2022-05-12 15:50:41.414813
5760,1041,5878,743,846,8673,17181,2022-05-12 15:50:41.76295
5763,75,581,58,124,893,1731,2022-05-12 15:50:43.92694
5772,654,30691,362,327,6332,38366,2022-05-12 15:50:50.22595
5774,1168,36959,318,396,6998,45839,2022-05-12 15:50:53.445212
5783,27,344,28,55,388,842,2022-05-12 15:50:55.586036
5784,1067,21219,591,726,7733,31336,2022-05-12 15:50:58.997775
5785,54,1718,28,52,720,2572,2022-05-12 15:51:00.620966
5802,94,1359,43,54,1858,3408,2022-05-12 15:51:05.172228
5810,37,110,12,54,316,529,2022-05-12 15:51:07.658504
5811,14,921,5,46,97,1083,2022-05-12 15:51:10.438287
5812,16,944,4,43,105,1112,2022-05-12 15:51:11.780338
5814,13,1064,6,53,125,1261,2022-05-12 15:51:13.977955
5819,117,1996,55,74,2397,4639,2022-05-12 15:51:16.239053
5821,33,223,21,115,158,550,2022-05-12 15:51:18.056555
5826,32,1435,12,68,214,1761,2022-05-12 15:51:20.006683
5828,74,903,48,59,747,1831,2022-05-12 15:51:21.743233
5829,53,313,32,114,380,892,2022-05-12 15:51:23.003583
5830,87,2001,76,219,328,2711,2022-05-12 15:51:25.377368
5832,177,3608,135,237,1456,5613,2022-05-12 15:51:28.25157
5833,43,316,42,113,321,835,2022-05-12 15:51:30.170722
5834,114,460,115,174,1417,2280,2022-05-12 15:51:32.065075
5838,17,782,5,40,130,974,2022-05-12 15:51:36.921882
5841,25,99,10,102,180,416,2022-05-12 15:51:38.74428
5842,19,864,7,39,205,1134,2022-05-12 15:51:40.283535
5844,88,4135,93,148,1877,6341,2022-05-12 15:51:42.896492
5845,92,4651,103,147,1879,6872,2022-05-12 15:51:45.66745
5848,49,955,31,63,861,1959,2022-05-12 15:51:47.944355
5854,142,1128,130,131,1117,2648,2022-05-12 15:51:52.461762
5859,112,2389,80,85,1974,4640,2022-05-12 15:51:54.570599
5862,28,521,22,47,400,1018,2022-05-12 15:51:55.811495
5865,49,1173,31,39,580,1872,2022-05-12 15:51:57.479472
5868,15,1206,6,37,138,1402,2022-05-12 15:51:59.691845
5869,17,924,4,48,138,1131,2022-05-12 15:52:01.453128
5870,28,897,10,58,140,1133,2022-05-12 15:52:02.968708
5872,14,770,3,41,114,942,2022-05-12 15:52:06.137157
5873,34,1240,12,68,259,1613,2022-05-12 15:52:08.100567
5877,236,3539,128,1024,1095,6022,2022-05-12 15:52:13.005832
5878,35,455,19,52,621,1182,2022-05-12 15:52:14.438039
5880,12,891,5,24,184,1116,2022-05-12 15:52:16.051514
5886,26,198,22,89,206,541,2022-05-12 15:52:19.453529
5889,42,460,10,62,242,816,2022-05-12 15:52:21.484582
5891,81,750,64,119,677,1691,2022-05-12 15:52:22.990799
5900,40,273,18,69,509,909,2022-05-12 15:52:25.876915
5902,737,25860,286,472,4606,31961,2022-05-12 15:52:28.395428
5904,65,1286,30,67,756,2204,2022-05-12 15:52:30.633437
5908,55,587,74,146,334,1196,2022-05-12 15:52:35.217336
5909,9105,100334,6190,7571,59936,183136,2022-05-12 15:52:35.712391
5914,1942,17487,1423,2157,13541,36550,2022-05-12 15:52:38.676888
5916,12,81,9,42,156,300,2022-05-12 15:52:40.209481
5917,36,364,13,30,321,764,2022-05-12 15:52:41.566963
5918,137,2493,73,80,2120,4903,2022-05-12 15:52:44.369071
5921,37,174,21,64,553,849,2022-05-12 15:52:46.868931
5923,51,219,40,66,569,945,2022-05-12 15:52:48.867137
5925,44,908,19,46,643,1660,2022-05-12 15:52:50.713996
5926,42,714,30,55,574,1415,2022-05-12 15:52:52.09808
5927,38,337,40,57,597,1069,2022-05-12 15:52:53.834964
5928,52,439,25,31,462,1009,2022-05-12 15:52:55.391875
5930,24,129,11,45,253,462,2022-05-12 15:52:57.216513
5933,37,403,25,59,441,965,2022-05-12 15:53:00.132433
5935,35,281,34,109,366,825,2022-05-12 15:53:01.955492
5938,89,624,65,127,1093,1998,2022-05-12 15:53:04.494335
5941,5929,53800,4522,3849,46123,114223,2022-05-12 15:53:08.548483
5945,887,3714,816,1909,5511,12837,2022-05-12 15:53:13.476516
5947,343,18871,322,227,8116,27879,2022-05-12 15:53:13.914701
5953,118,1124,99,155,1162,2658,2022-05-12 15:53:16.431658
5955,1000,37372,722,535,11259,50888,2022-05-12 15:53:19.513714
5957,750,21038,643,965,5388,28784,2022-05-12 15:53:22.183371
5962,1984,68671,1366,2666,4502,79189,2022-05-12 15:53:26.10306
5968,144,4429,85,153,1198,6009,2022-05-12 15:53:29.330938
5973,1640,17460,1125,2080,9592,31897,2022-05-12 15:53:32.518727
5978,473,24612,254,139,6311,31789,2022-05-12 15:53:35.309351
5983,568,2324,500,844,1479,5715,2022-05-12 15:53:37.700208
5986,16,112,8,54,181,371,2022-05-12 15:53:41.427569
5990,35,445,19,48,372,919,2022-05-12 15:53:44.993564
5992,134,893,124,187,854,2192,2022-05-12 15:53:47.590005
5996,83,4832,67,108,1468,6558,2022-05-12 15:53:52.827602
5997,189,239,150,163,1215,1956,2022-05-12 15:53:55.407407
5998,169,5323,101,124,3375,9092,2022-05-12 15:53:57.831231
6000,40,400,20,37,533,1030,2022-05-12 15:53:59.72295
6016,437,7017,248,273,4355,12330,2022-05-12 15:54:09.999644
6018,18,73,7,46,127,271,2022-05-12 15:54:11.338177
6023,2091,51862,1579,1861,10671,68064,2022-05-12 15:54:12.337762
6024,2186,13034,1975,1659,8816,27670,2022-05-12 15:54:15.398224
6028,45,755,31,64,560,1455,2022-05-12 15:54:17.551233
6031,109,656,42,83,941,1831,2022-05-12 15:54:20.473746
6032,159,3367,128,131,2412,6197,2022-05-12 15:54:22.837239
6033,16885,269259,9801,12251,28839,337035,2022-05-12 15:54:23.186485
6038,65,1100,33,60,537,1795,2022-05-12 15:54:25.620201
6045,45443,494965,29403,25308,207788,802907,2022-05-12 15:54:25.9494
6046,1174,28192,521,337,16693,46917,2022-05-12 15:54:30.773011
6050,1406,12271,662,433,8500,23272,2022-05-12 15:54:34.481271
6055,217,837,120,183,1652,3009,2022-05-12 15:54:36.692057
6056,62,373,59,113,681,1288,2022-05-12 15:54:36.904983
6060,39,667,19,63,472,1260,2022-05-12 15:54:38.897032
6061,153,982,74,100,1613,2922,2022-05-12 15:54:41.025092
6062,45,429,20,93,417,1004,2022-05-12 15:54:42.433113
6063,10,67,5,49,106,237,2022-05-12 15:54:44.031451
6064,919,28767,766,569,14872,45893,2022-05-12 15:54:44.898345
6067,90,272,49,99,706,1216,2022-05-12 15:54:47.586008
6069,149,1791,85,152,1535,3712,2022-05-12 15:54:53.144057
6072,15,186,14,77,202,494,2022-05-12 15:54:57.316524
6073,18,224,13,100,210,565,2022-05-12 15:54:58.636224
6074,21,241,13,93,251,619,2022-05-12 15:55:00.122274
6075,43,407,37,116,509,1112,2022-05-12 15:55:01.576239
6076,65,1324,39,65,941,2434,2022-05-12 15:55:01.98032
6078,43,465,29,53,569,1159,2022-05-12 15:55:03.92087
6090,69,923,32,47,685,1756,2022-05-12 15:55:06.190662
6093,50,269,52,112,564,1047,2022-05-12 15:55:08.197178
6095,34,501,15,67,300,917,2022-05-12 15:55:12.351144
6096,202,569,120,105,1429,2425,2022-05-12 15:55:14.49335
6098,2040,20221,1560,1631,15476,40928,2022-05-12 15:55:17.366622
6112,1446,15910,1053,1289,10385,30083,2022-05-12 15:55:22.048566
6114,24011,156195,18245,13965,142912,355328,2022-05-12 15:55:22.247593
6115,478,24163,259,255,6513,31668,2022-05-12 15:55:22.686854
6116,446,632,403,421,981,2883,2022-05-12 15:55:25.890204
6117,577,2367,498,1097,2992,7531,2022-05-12 15:55:28.942198
6119,134,355,107,180,1149,1925,2022-05-12 15:55:31.340313
6127,2445,74099,2234,2699,20020,101497,2022-05-12 15:55:35.486007
6129,1543,7714,1350,1996,13836,26439,2022-05-12 15:55:38.207611
6130,343,710,329,486,2127,3995,2022-05-12 15:55:41.010283
6131,226,389,311,770,723,2419,2022-05-12 15:55:44.106594
6148,357,3456,135,134,2177,6259,2022-05-12 15:55:46.685502
6149,1365,1,627,842,1268,4103,2022-05-12 15:55:46.868389
6151,334,17554,215,141,6717,24961,2022-05-12 15:55:50.558326
6152,223,7820,123,153,2933,11252,2022-05-12 15:55:53.027242
6156,15,268,6,76,120,485,2022-05-12 15:56:00.350976
6162,471,11516,161,131,6092,18371,2022-05-12 15:56:02.869514
6163,602,25922,379,438,9712,37053,2022-05-12 15:56:04.390779
6164,3914,40957,3060,3657,39180,90768,2022-05-12 15:56:04.567085
6165,1618,24764,1146,1363,17826,46717,2022-05-12 15:56:07.922545
6169,200,3770,138,119,3462,7689,2022-05-12 15:56:11.111892
6171,4731,67342,2685,2450,20560,97768,2022-05-12 15:56:13.892943
6181,39,656,30,49,430,1204,2022-05-12 15:56:20.334843
6183,27,438,9,48,346,868,2022-05-12 15:56:22.650685
6184,99,1219,43,50,1028,2439,2022-05-12 15:56:25.777006
6187,309,20120,238,146,5816,26629,2022-05-12 15:56:28.37661
6189,90,959,55,127,1204,2435,2022-05-12 15:56:29.949351
6195,29,117,17,82,260,505,2022-05-12 15:56:31.379147
6198,119,9657,118,124,2004,12022,2022-05-12 15:56:31.739576
6201,9938,142347,4750,6721,41536,205292,2022-05-12 15:56:35.217456
6202,34,433,13,70,335,885,2022-05-12 15:56:36.916208
6206,15,52,5,50,108,230,2022-05-12 15:56:44.939897
6209,130,3875,145,105,2080,6335,2022-05-12 15:56:47.738238
6211,10324,137504,8104,6428,111978,274338,2022-05-12 15:56:50.942495
6213,29428,325385,18984,14703,159580,548080,2022-05-12 15:56:51.10864
6215,39,1707,33,52,703,2534,2022-05-12 15:56:54.327591
6219,199,2311,106,119,3918,6653,2022-05-12 15:56:59.781264
6226,107,1923,83,152,1676,3941,2022-05-12 15:57:01.778852
6227,80,851,53,62,820,1866,2022-05-12 15:57:03.968128
6229,249,282,112,108,1744,2495,2022-05-12 15:57:05.919148
6230,91,198,37,63,916,1305,2022-05-12 15:57:07.501611
6231,179,8760,130,149,2299,11517,2022-05-12 15:57:07.677359
6234,185,6781,135,127,3102,10330,2022-05-12 15:57:10.098292
6245,79,1027,53,59,735,1953,2022-05-12 15:57:13.450998
6251,79,1188,54,59,928,2308,2022-05-12 15:57:15.986532
6261,23,204,16,81,144,468,2022-05-12 15:57:17.911246
6262,104,549,88,167,661,1569,2022-05-12 15:57:19.778531
6267,26,151,10,52,386,625,2022-05-12 15:57:21.792978
6268,28,266,19,45,691,1049,2022-05-12 15:57:23.470964
6270,40,277,24,50,922,1313,2022-05-12 15:57:25.538045
6271,49,168,27,51,887,1182,2022-05-12 15:57:27.156704
6272,27,212,20,61,633,953,2022-05-12 15:57:28.479354
6273,14,72,13,44,239,382,2022-05-12 15:57:30.291142
6275,98,7301,107,145,2079,9730,2022-05-12 15:57:32.66856
6276,138,3549,72,65,2549,6373,2022-05-12 15:57:35.367178
6277,59,535,75,184,476,1329,2022-05-12 15:57:37.086851
6287,376,19329,239,218,4297,24459,2022-05-12 15:57:42.622375
6288,662,46774,361,238,9004,57039,2022-05-12 15:57:43.074564
6291,552,26911,368,240,9119,37190,2022-05-12 15:57:46.030024
6293,174,2186,78,74,1612,4124,2022-05-12 15:57:48.494889
6297,33,503,10,53,265,864,2022-05-12 15:57:50.151855
6299,106,3448,92,93,1578,5317,2022-05-12 15:57:51.554398
6303,122,2323,111,256,441,3253,2022-05-12 15:57:53.586549
6312,95,1556,80,65,1208,3004,2022-05-12 15:58:01.907888
6324,9641,155323,4760,6197,48469,224390,2022-05-12 15:58:04.299222
6325,1504,163867,737,478,15388,181974,2022-05-12 15:58:04.572673
6330,218,7138,272,293,5060,12981,2022-05-12 15:58:10.428097
6331,51,831,41,53,633,1609,2022-05-12 15:58:13.772256
6344,308,8374,197,116,5508,14503,2022-05-12 15:58:20.84627
6346,43,1320,22,51,486,1922,2022-05-12 15:58:22.40897
6347,21596,416417,16300,23904,112694,590911,2022-05-12 15:58:22.82833
6351,2089,215801,1114,695,26671,246370,2022-05-12 15:58:22.990213
6355,28,865,15,43,326,1277,2022-05-12 15:58:29.128294
6361,456,18706,365,224,9798,29549,2022-05-12 15:58:32.491007
6368,344,4089,200,194,5080,9907,2022-05-12 15:58:36.314005
6372,2031,124003,1235,558,31981,159808,2022-05-12 15:58:36.747024
6374,112,837,66,145,958,2118,2022-05-12 15:58:38.965107
6375,80,859,78,138,914,2069,2022-05-12 15:58:40.497586
6377,4329,50007,3447,2087,39572,99442,2022-05-12 15:58:43.097306
6380,462,13173,243,155,6662,20695,2022-05-12 15:58:49.899845
6383,384,1036,240,484,1270,3414,2022-05-12 15:58:53.621964
6384,29,198,15,44,208,494,2022-05-12 15:58:55.216725
6390,41,872,13,45,379,1350,2022-05-12 15:58:57.501465
6397,37,311,32,109,235,724,2022-05-12 15:59:01.505629
6401,278,12073,238,193,5685,18467,2022-05-12 15:59:06.769136
6408,1653,33741,885,710,27277,64266,2022-05-12 15:59:07.21676
6412,19,210,12,57,316,614,2022-05-12 15:59:08.970785
6413,45,1353,19,50,544,2011,2022-05-12 15:59:11.095108
6418,123,4268,83,114,1717,6305,2022-05-12 15:59:14.467005
6421,4426,103026,2557,977,33997,144983,2022-05-12 15:59:16.958327
6428,83,279,58,109,546,1075,2022-05-12 15:59:19.660863
6437,117,1062,95,104,831,2209,2022-05-12 15:59:23.388525
6438,319,15990,143,211,2747,19410,2022-05-12 15:59:25.830713
6443,827,9115,437,485,6708,17572,2022-05-12 15:59:26.757347
6444,6658,51253,6754,6376,42419,113460,2022-05-12 15:59:29.796563
6448,47,251,46,158,266,768,2022-05-12 15:59:31.729719
6452,76,341,45,120,767,1349,2022-05-12 15:59:33.566433
6462,38,1044,17,75,456,1630,2022-05-12 15:59:38.081244
6463,242,909,160,129,5708,7148,2022-05-12 15:59:40.758797
6467,671,44065,263,314,4957,50270,2022-05-12 15:59:40.924387
6468,59,384,42,149,418,1052,2022-05-12 15:59:42.886472
6479,298,18201,164,148,3877,22688,2022-05-12 15:59:45.00037
6481,39,113,27,78,342,599,2022-05-12 15:59:46.533784
6482,27,125,21,80,318,571,2022-05-12 15:59:48.069911
6484,39,1042,19,44,445,1589,2022-05-12 15:59:49.902765
6489,1088,33618,584,745,10210,46245,2022-05-12 15:59:52.26959
6492,56,707,32,46,697,1538,2022-05-12 15:59:54.958514
6496,91,1550,77,73,1808,3599,2022-05-12 15:59:56.118105
6519,13,126,7,58,127,331,2022-05-12 16:00:19.86848
6500,20195,145758,13385,33543,87241,300122,2022-05-12 15:59:59.524519
6505,381,16383,252,262,6108,23386,2022-05-12 16:00:02.400548
6509,195,3110,279,710,604,4898,2022-05-12 16:00:07.199465
6511,91,1271,77,160,778,2377,2022-05-12 16:00:09.65271
6512,10017,171717,5754,6617,53196,247301,2022-05-12 16:00:12.889667
6513,42,654,24,61,464,1245,2022-05-12 16:00:14.830796
6517,12,156,13,60,195,436,2022-05-12 16:00:16.49377
6518,16,361,11,60,191,639,2022-05-12 16:00:18.303627
6520,19,199,23,105,252,598,2022-05-12 16:00:21.318854
6522,18,90,9,55,140,312,2022-05-12 16:00:23.240116
6523,36,391,34,128,144,733,2022-05-12 16:00:25.881863
6524,11,135,7,52,82,287,2022-05-12 16:00:27.42779
6527,97,2745,68,97,1302,4309,2022-05-12 16:00:30.238403
6528,15,82,8,67,196,368,2022-05-12 16:00:31.932561
6535,26,3089,20,87,606,3828,2022-05-12 16:00:36.00696
6546,352,8742,129,463,2597,12283,2022-05-12 16:00:36.444608
6547,66116,1444950,41173,47819,290652,1890710,2022-05-12 16:00:36.688926
6548,295,23842,193,191,4526,29047,2022-05-12 16:00:39.056931
6553,465,26482,215,284,6131,33577,2022-05-12 16:00:39.377797
6555,87,4089,95,147,1971,6389,2022-05-12 16:00:43.606652
6560,602,4218,403,592,2938,8753,2022-05-12 16:00:48.807879
6566,71,2903,38,37,809,3858,2022-05-12 16:00:50.810743
6567,141,2462,73,84,1789,4549,2022-05-12 16:00:52.595275
6568,22,159,10,47,181,419,2022-05-12 16:00:53.875889
6572,3270,55487,1778,1181,18660,80376,2022-05-12 16:00:58.02777
6573,9523,284649,6051,5718,79785,385726,2022-05-12 16:00:58.22563
6574,4637,43101,3051,3069,28138,81996,2022-05-12 16:01:05.65412
6577,44,225,19,60,395,743,2022-05-12 16:01:09.08055
6579,22,234,11,45,182,494,2022-05-12 16:01:11.550855
6581,176,8029,122,120,3822,12269,2022-05-12 16:01:12.483384
6582,480,4022,302,296,2326,7426,2022-05-12 16:01:15.783415
6583,29,166,17,64,209,485,2022-05-12 16:01:17.733528
6587,178,3441,106,126,2287,6138,2022-05-12 16:01:21.795538
6591,433,10879,246,199,5522,17279,2022-05-12 16:01:24.934328
6594,37673,228638,25664,15372,206213,513560,2022-05-12 16:01:26.292466
6604,344,1047,334,364,2386,4475,2022-05-12 16:01:30.132176
6607,49,2873,14,38,478,3452,2022-05-12 16:01:32.980758
6609,415,11924,320,717,1456,14832,2022-05-12 16:01:36.286196
6610,1695,42097,676,377,23723,68568,2022-05-12 16:01:39.417536
6625,37,260,49,135,505,986,2022-05-12 16:01:44.957265
6628,115,2948,75,109,1512,4759,2022-05-12 16:01:47.044309
6629,51,295,31,123,287,787,2022-05-12 16:01:48.532393
6630,18,164,6,74,176,438,2022-05-12 16:01:50.297941
6633,2271,28144,1383,1961,16348,50107,2022-05-12 16:01:53.586621
6634,2542,41576,1818,1486,18349,65771,2022-05-12 16:01:57.313634
6641,66,1917,18,43,921,2965,2022-05-12 16:02:02.53899
6645,2095,25739,1811,4697,11311,45653,2022-05-12 16:02:06.295187
6654,66,6919,35,77,617,7714,2022-05-12 16:02:13.441879
6657,109,2717,86,72,1475,4459,2022-05-12 16:02:14.067911
6667,15,1106,9,39,224,1393,2022-05-12 16:02:19.249285
6670,35,416,31,83,876,1441,2022-05-12 16:02:21.153451
6671,16,191,5,68,138,418,2022-05-12 16:02:22.971302
6674,44,290,32,108,470,944,2022-05-12 16:02:25.058169
6675,6340,217761,2087,966,96432,323586,2022-05-12 16:02:25.497989
6680,32,1013,11,54,582,1692,2022-05-12 16:02:31.022338
6682,7839,158278,5687,12073,39994,223871,2022-05-12 16:02:31.228711
6684,21,379,15,39,238,692,2022-05-12 16:02:33.484986
6687,19,78,18,56,227,398,2022-05-12 16:02:35.125464
6688,35,301,18,47,447,848,2022-05-12 16:02:38.11609
6695,31,635,19,55,338,1078,2022-05-12 16:02:44.135714
6701,15,143,11,87,165,421,2022-05-12 16:02:46.371398
6702,207220,889437,126558,181868,170740,1575823,2022-05-12 16:02:46.779407
6704,586,8727,382,346,4227,14268,2022-05-12 16:02:49.283691
38618,3,42,5,37,94,181,2022-05-12 20:44:57.979363
6705,346,4144,179,149,2890,7708,2022-05-12 16:02:52.00683
6707,14511,399464,8577,11548,82405,516505,2022-05-12 16:02:52.452709
6712,968,9620,640,528,7495,19251,2022-05-12 16:02:59.335487
6714,261,15545,200,277,3698,19981,2022-05-12 16:03:01.015261
6718,69,672,53,97,894,1785,2022-05-12 16:03:03.315112
6721,60,1375,46,133,769,2383,2022-05-12 16:03:05.150557
6728,26,345,12,52,333,768,2022-05-12 16:03:12.270033
6731,25,300,18,109,225,677,2022-05-12 16:03:16.192728
6733,54,756,45,64,793,1712,2022-05-12 16:03:17.945511
6734,49,807,45,64,817,1782,2022-05-12 16:03:19.160739
6735,55,704,40,68,804,1671,2022-05-12 16:03:20.675606
6736,92,4795,84,74,1637,6682,2022-05-12 16:03:22.63555
6741,105,2949,54,83,1489,4680,2022-05-12 16:03:24.57478
6743,196,2722,123,142,1854,5037,2022-05-12 16:03:26.296872
6746,88631,730431,71873,52768,337017,1280720,2022-05-12 16:03:26.465679
6747,9873,131146,7166,12256,50866,211307,2022-05-12 16:03:29.431816
6748,135,4420,78,77,1374,6084,2022-05-12 16:03:33.356623
6749,72,3589,57,107,1253,5078,2022-05-12 16:03:36.451018
6758,4464,17559,3211,3940,30711,59885,2022-05-12 16:03:39.259706
6759,9,137,5,50,108,309,2022-05-12 16:03:41.464987
6761,11,128,5,48,95,287,2022-05-12 16:03:44.001007
6762,10,132,5,52,111,310,2022-05-12 16:03:45.355813
6768,1017,29519,597,591,13313,45037,2022-05-12 16:03:48.401725
6771,18,199,14,83,137,451,2022-05-12 16:03:51.395313
6772,1565,58151,730,536,20283,81265,2022-05-12 16:03:55.830321
6773,8459,147302,7289,6848,53759,223657,2022-05-12 16:03:56.705397
6777,13,704,2,24,123,866,2022-05-12 16:04:00.519675
6783,261,6385,281,216,5779,12922,2022-05-12 16:04:04.547304
6787,499,4841,266,420,5016,11042,2022-05-12 16:04:05.0161
6791,1039,30255,571,436,9643,41944,2022-05-12 16:04:05.375468
6792,83,1199,76,140,949,2447,2022-05-12 16:04:07.568629
6793,1355,85571,638,473,18511,106548,2022-05-12 16:04:07.822122
6794,192,5236,141,96,3044,8709,2022-05-12 16:04:11.126662
6795,583,9887,407,197,7268,18342,2022-05-12 16:04:12.392322
6796,55,520,26,49,780,1430,2022-05-12 16:04:14.620974
6797,13,550,11,40,178,792,2022-05-12 16:04:16.646353
6800,53,1205,32,62,479,1831,2022-05-12 16:04:18.969061
6809,149,2176,73,98,2612,5108,2022-05-12 16:04:22.030446
6811,10106,177891,6488,4114,54182,252781,2022-05-12 16:04:22.557153
6822,44,149,26,122,193,534,2022-05-12 16:04:25.91653
6823,30,940,8,61,174,1213,2022-05-12 16:04:28.739672
6827,11,535,1,43,118,708,2022-05-12 16:04:31.317727
6828,10,648,3,42,82,785,2022-05-12 16:04:32.952303
6829,30,710,6,58,140,944,2022-05-12 16:04:34.709232
6830,14,737,3,44,103,901,2022-05-12 16:04:36.052411
6831,15,777,8,48,195,1043,2022-05-12 16:04:38.03949
6832,19,1007,8,47,212,1293,2022-05-12 16:04:39.611769
6834,19,915,3,67,111,1115,2022-05-12 16:04:42.600913
6836,25,775,11,60,160,1031,2022-05-12 16:04:45.243012
6838,13,1120,6,57,138,1334,2022-05-12 16:04:49.488923
6839,17,599,4,44,113,777,2022-05-12 16:04:50.648119
6840,13,806,6,47,123,995,2022-05-12 16:04:51.950054
6841,26,833,5,58,181,1103,2022-05-12 16:04:53.208108
6842,10,549,2,43,96,700,2022-05-12 16:04:55.039945
6844,12,862,5,44,116,1039,2022-05-12 16:04:58.2538
6846,13,501,5,39,104,662,2022-05-12 16:04:59.527601
6848,12,541,7,41,107,708,2022-05-12 16:05:02.856146
6849,10,790,3,46,103,952,2022-05-12 16:05:04.188548
6850,9,684,10,44,140,887,2022-05-12 16:05:05.673522
6851,10,766,2,43,94,915,2022-05-12 16:05:06.943159
6855,31,499,13,58,336,937,2022-05-12 16:05:10.884656
6861,33,728,11,43,473,1288,2022-05-12 16:05:16.377522
6864,2198,41450,1077,490,18608,63823,2022-05-12 16:05:19.724654
6867,998,27425,676,857,8369,38325,2022-05-12 16:05:20.162164
6872,74,1542,62,124,1246,3048,2022-05-12 16:05:25.10598
6877,107,10236,111,148,1922,12524,2022-05-12 16:05:32.791661
6880,41528,802000,27445,36600,212530,1120103,2022-05-12 16:05:34.859813
6882,500,11333,340,306,3981,16460,2022-05-12 16:05:40.18899
6883,131,1908,76,77,1946,4138,2022-05-12 16:05:43.474494
6884,942,40594,565,328,14232,56661,2022-05-12 16:05:48.033481
6885,164,3846,126,94,1359,5589,2022-05-12 16:05:50.38778
6890,100,1411,57,71,967,2606,2022-05-12 16:05:53.052035
6895,8028,85956,5227,6825,51818,157854,2022-05-12 16:05:56.124485
6896,1404,30214,975,685,10487,43765,2022-05-12 16:05:59.695194
6901,198,1477,96,198,1102,3071,2022-05-12 16:06:06.584957
6902,139,367,92,144,1578,2320,2022-05-12 16:06:08.69797
6907,21,240,16,58,225,560,2022-05-12 16:06:11.339049
6918,1210,14114,876,2467,6145,24812,2022-05-12 16:06:18.289184
6920,1206,13725,845,2095,7954,25825,2022-05-12 16:06:21.765042
6953,28,3363,23,61,401,3876,2022-05-12 16:06:57.402232
6922,3317,151879,1668,1657,44985,203506,2022-05-12 16:06:24.62548
6927,538,19420,430,370,11523,32281,2022-05-12 16:06:28.187338
6935,16,898,7,37,244,1202,2022-05-12 16:06:34.548778
6937,46,484,30,54,500,1114,2022-05-12 16:06:36.405529
6942,26,213,18,54,334,645,2022-05-12 16:06:41.451626
6946,448,7302,297,293,4203,12543,2022-05-12 16:06:44.182736
6947,74,617,45,188,299,1223,2022-05-12 16:06:46.588822
6951,396,37883,214,220,5029,43742,2022-05-12 16:06:55.094278
6956,16763,246158,11355,11954,117075,403305,2022-05-12 16:07:04.703483
6959,63,3108,56,62,1234,4523,2022-05-12 16:07:10.480099
6965,24,252,10,48,172,506,2022-05-12 16:07:14.983839
6970,51,246,43,106,419,865,2022-05-12 16:07:16.280706
6971,123,634,126,189,1103,2175,2022-05-12 16:07:19.676178
6973,3059,12845,2752,3651,20401,42708,2022-05-12 16:07:20.098062
6974,5516,49113,3948,5494,33105,97176,2022-05-12 16:07:22.835228
6975,104,503,80,95,1969,2751,2022-05-12 16:07:24.927864
6979,2270,13375,1454,2858,9973,29930,2022-05-12 16:07:29.855381
6980,1006,5245,907,1264,6728,15150,2022-05-12 16:07:32.242965
6981,47,157,25,71,322,622,2022-05-12 16:07:33.667782
6985,141,3682,84,161,2401,6469,2022-05-12 16:07:38.971061
6987,2996,85870,1138,1933,17564,109501,2022-05-12 16:07:42.434207
6989,38,164,41,146,250,639,2022-05-12 16:07:45.146211
6993,33,1268,13,58,351,1723,2022-05-12 16:07:48.594069
6999,85,4237,84,105,1487,5998,2022-05-12 16:07:51.86681
7004,48,1529,64,217,262,2120,2022-05-12 16:07:54.095132
7014,234,3730,139,91,4300,8494,2022-05-12 16:07:56.516968
7017,1292,44215,1023,1244,10649,58423,2022-05-12 16:08:00.506283
7022,15,979,10,51,180,1235,2022-05-12 16:08:04.628871
7024,16,1404,9,49,186,1664,2022-05-12 16:08:06.497439
7025,28,1775,15,52,473,2343,2022-05-12 16:08:08.271644
7027,20,884,8,40,190,1142,2022-05-12 16:08:10.21633
7028,13,1070,7,45,141,1276,2022-05-12 16:08:11.639396
7029,18,734,11,45,205,1013,2022-05-12 16:08:13.720647
7030,15,1136,7,50,179,1387,2022-05-12 16:08:14.900687
7032,12,716,6,41,123,898,2022-05-12 16:08:17.850701
7041,295,7584,217,174,3918,12188,2022-05-12 16:08:20.277634
7044,827,21978,525,290,14037,37657,2022-05-12 16:08:22.79648
7045,86,7765,80,120,571,8622,2022-05-12 16:08:25.620025
7048,73,837,50,154,427,1541,2022-05-12 16:08:27.99694
7052,36,130,11,67,443,687,2022-05-12 16:08:29.305359
7054,51020,830796,29558,31478,170349,1113201,2022-05-12 16:08:29.7116
7059,1763,142652,922,876,22984,169197,2022-05-12 16:08:35.423228
7060,84,2880,64,108,1416,4552,2022-05-12 16:08:38.324191
7062,830,15893,623,460,7616,25422,2022-05-12 16:08:41.510343
7071,13,750,4,44,98,909,2022-05-12 16:08:45.202835
7081,572,4996,415,505,2374,8862,2022-05-12 16:08:47.413923
7082,1923,48716,1747,4314,11744,68444,2022-05-12 16:08:47.882671
8331,144,8131,122,144,2207,10748,2022-05-12 16:20:47.825102
7088,16576,374454,7367,12628,61253,472278,2022-05-12 16:08:51.24719
7090,23,202,9,43,203,480,2022-05-12 16:08:52.452756
7103,1065,7966,1062,2626,5905,18624,2022-05-12 16:08:58.829211
7108,82,2542,71,89,1718,4502,2022-05-12 16:09:03.891538
7109,36,180,25,79,201,521,2022-05-12 16:09:05.966989
7117,17,577,5,38,271,908,2022-05-12 16:09:10.348936
7122,46,360,53,86,783,1328,2022-05-12 16:09:12.060147
7124,22,195,8,39,189,453,2022-05-12 16:09:13.173437
7139,40,633,19,43,422,1157,2022-05-12 16:09:18.255139
7144,114,1802,78,86,1823,3903,2022-05-12 16:09:20.327089
7156,54,792,24,57,578,1505,2022-05-12 16:09:25.77821
7157,34,668,25,58,529,1314,2022-05-12 16:09:27.873615
7160,135,488,79,135,1198,2035,2022-05-12 16:09:30.61841
7162,47,318,33,92,259,749,2022-05-12 16:09:31.951092
7164,11,432,16,31,204,694,2022-05-12 16:09:33.770942
7169,24,611,13,41,399,1088,2022-05-12 16:09:35.772915
7170,59,993,30,51,1085,2218,2022-05-12 16:09:38.05303
7171,26,1216,14,38,467,1761,2022-05-12 16:09:39.7229
7174,30,914,7,52,199,1202,2022-05-12 16:09:41.293237
7175,33,180,16,112,210,551,2022-05-12 16:09:42.580026
7176,194,1605,215,503,710,3227,2022-05-12 16:09:44.333492
7177,36,92,15,75,246,464,2022-05-12 16:09:45.749317
7189,39,101,31,97,228,496,2022-05-12 16:09:46.916779
7193,12571,65784,10369,8608,103567,200899,2022-05-12 16:09:47.80904
7211,24,64,7,87,155,337,2022-05-12 16:09:49.323108
7222,496,17376,270,230,7081,25453,2022-05-12 16:09:51.385993
7229,101,978,81,118,1321,2599,2022-05-12 16:09:53.491924
7244,16,582,7,34,186,825,2022-05-12 16:09:59.930608
7245,38,346,19,83,329,815,2022-05-12 16:10:01.729981
7248,125,3766,77,94,1976,6038,2022-05-12 16:10:06.276957
7252,26,250,8,51,168,503,2022-05-12 16:10:07.494745
7257,37,856,13,66,484,1456,2022-05-12 16:10:13.677714
7259,18,733,8,47,207,1013,2022-05-12 16:10:15.699784
7261,305,3356,248,185,963,5057,2022-05-12 16:10:18.031176
7279,172,2587,100,151,2336,5346,2022-05-12 16:10:22.67686
7296,8,536,3,28,119,694,2022-05-12 16:10:30.181834
7304,324,16562,136,215,2398,19635,2022-05-12 16:10:34.319905
7305,166,7149,100,202,1750,9367,2022-05-12 16:10:36.791025
7307,142,698,132,174,1011,2157,2022-05-12 16:10:38.944883
7311,13491,361453,5807,4516,172608,557875,2022-05-12 16:10:39.637028
7314,30,504,16,64,441,1055,2022-05-12 16:10:39.88963
7334,870,35626,533,1433,3548,42010,2022-05-12 16:10:47.167473
7337,530,46090,308,302,9624,56854,2022-05-12 16:10:53.374024
7338,5592,184608,2931,1605,46264,241000,2022-05-12 16:10:56.289075
7363,104,2144,51,84,1221,3604,2022-05-12 16:10:59.98766
7364,66,976,48,68,894,2052,2022-05-12 16:11:02.653994
7366,73,671,51,75,1228,2098,2022-05-12 16:11:03.000358
7367,631,37368,473,371,9214,48057,2022-05-12 16:11:03.419366
7374,33,283,35,107,384,842,2022-05-12 16:11:03.852874
7376,28,324,19,60,349,780,2022-05-12 16:11:07.34775
7377,66,2844,45,65,1210,4230,2022-05-12 16:11:09.445335
7395,80,838,71,129,510,1628,2022-05-12 16:11:12.369458
7396,360,11118,251,185,5180,17094,2022-05-12 16:11:14.871671
7405,28,382,16,102,161,689,2022-05-12 16:11:17.754973
7419,15,120,13,83,138,369,2022-05-12 16:11:24.355204
7423,13,341,4,28,136,522,2022-05-12 16:11:27.199582
7427,55,557,39,41,677,1369,2022-05-12 16:11:28.649925
7435,108,1083,53,93,1157,2494,2022-05-12 16:11:31.392376
7446,13,534,6,30,98,681,2022-05-12 16:11:37.31683
7449,7,263,5,30,85,390,2022-05-12 16:11:39.044679
7450,17,418,5,28,105,573,2022-05-12 16:11:40.164158
7451,18,594,6,32,133,783,2022-05-12 16:11:41.625323
7459,22,140,11,41,148,362,2022-05-12 16:11:46.216246
7461,18,228,9,49,155,459,2022-05-12 16:11:47.486181
7465,2615,68373,1289,600,44311,117188,2022-05-12 16:11:48.516006
7466,18,819,1,34,136,1008,2022-05-12 16:11:50.647923
7468,489,8138,273,324,4317,13541,2022-05-12 16:11:53.670017
7471,174,6856,93,193,1666,8982,2022-05-12 16:11:53.837409
7472,2334,110079,1022,770,30223,144428,2022-05-12 16:11:54.327633
7475,56,1552,27,61,604,2300,2022-05-12 16:11:59.391374
7477,20,555,7,44,287,913,2022-05-12 16:12:01.300594
7479,99,230,54,114,762,1259,2022-05-12 16:12:02.948305
7482,53,713,24,51,601,1442,2022-05-12 16:12:04.61549
7485,36,2068,14,63,228,2409,2022-05-12 16:12:06.514211
7491,53,737,38,56,722,1606,2022-05-12 16:12:09.753672
7494,13,994,6,48,131,1192,2022-05-12 16:12:11.301534
7495,6,58,14,73,90,241,2022-05-12 16:12:12.86563
7496,24,709,18,63,350,1164,2022-05-12 16:12:14.299233
7498,26,720,11,64,158,979,2022-05-12 16:12:17.274679
7505,236,0,61,182,330,809,2022-05-12 16:12:22.851036
7512,10,416,2,29,92,549,2022-05-12 16:12:26.669029
7518,10,1153,7,45,186,1401,2022-05-12 16:12:28.085457
7522,119,542,122,166,504,1453,2022-05-12 16:12:30.176804
7526,20,96,14,92,147,369,2022-05-12 16:12:34.867278
7528,25,787,12,64,280,1168,2022-05-12 16:12:38.070811
7529,15,107,13,92,160,387,2022-05-12 16:12:39.112012
7536,54,773,28,59,702,1616,2022-05-12 16:12:46.008228
7540,114,3311,87,82,1374,4968,2022-05-12 16:12:48.682971
7547,21,232,8,55,171,487,2022-05-12 16:12:49.934113
7549,141,3167,68,62,1649,5087,2022-05-12 16:12:52.608369
7550,89,4221,98,145,1864,6417,2022-05-12 16:12:55.448518
7559,933,23765,658,695,13813,39864,2022-05-12 16:12:58.139137
7568,660,6473,839,828,6727,15527,2022-05-12 16:13:03.883397
7569,26,666,11,27,252,982,2022-05-12 16:13:05.350267
7575,82,220,71,108,645,1126,2022-05-12 16:13:07.481942
7578,72,1159,73,72,1644,3020,2022-05-12 16:13:10.452457
7579,94,2289,60,71,1010,3524,2022-05-12 16:13:12.502853
7580,1921,26732,1150,1326,15038,46167,2022-05-12 16:13:15.447435
7588,4334,28982,3060,2131,44998,83505,2022-05-12 16:13:18.577715
7590,7224,74774,4358,6171,38192,130719,2022-05-12 16:13:21.454726
7591,86,2409,48,113,1129,3785,2022-05-12 16:13:23.350488
7592,14379,143468,9449,9554,72811,249661,2022-05-12 16:13:27.41479
7598,370,9481,209,268,6629,16957,2022-05-12 16:13:39.640454
7601,38,233,27,46,390,734,2022-05-12 16:13:41.283768
7605,25,270,18,106,127,546,2022-05-12 16:13:42.766084
7610,49,885,28,88,803,1853,2022-05-12 16:13:45.466
7617,10,498,3,39,83,633,2022-05-12 16:13:47.442289
7619,184,1232,219,307,1355,3297,2022-05-12 16:13:49.887209
7621,25,500,20,77,410,1032,2022-05-12 16:13:51.644033
7625,25,173,11,80,244,533,2022-05-12 16:13:52.929333
7627,5181,50434,3146,4910,35762,99433,2022-05-12 16:13:55.95653
7629,18,60,6,65,96,245,2022-05-12 16:13:57.310874
7643,305,727,174,293,898,2397,2022-05-12 16:14:01.289843
7645,2272,12270,2079,1602,9637,27860,2022-05-12 16:14:03.899693
7646,23,115,11,99,280,528,2022-05-12 16:14:06.040048
7651,326,2743,213,164,6463,9909,2022-05-12 16:14:10.660931
7654,175,4245,148,185,3479,8232,2022-05-12 16:14:13.769418
7655,1908,44866,852,660,9229,57515,2022-05-12 16:14:14.19415
7661,3771,38148,3094,3384,16227,64624,2022-05-12 16:14:18.399653
7666,49,1205,34,69,636,1993,2022-05-12 16:14:23.875335
7667,36,681,29,63,528,1337,2022-05-12 16:14:25.275785
7668,164,3436,87,115,1309,5111,2022-05-12 16:14:28.373297
7669,300,13342,202,130,4554,18528,2022-05-12 16:14:28.803921
7674,29547,328478,22955,19043,168089,568112,2022-05-12 16:14:29.303922
7681,24,135,11,63,262,495,2022-05-12 16:14:31.282864
7683,15,185,7,40,150,397,2022-05-12 16:14:32.500832
7691,77,972,55,69,867,2040,2022-05-12 16:14:34.648303
7695,335,59643,237,234,4517,64966,2022-05-12 16:14:38.003209
7696,32,234,12,45,297,620,2022-05-12 16:14:39.665505
7697,33,239,13,38,286,609,2022-05-12 16:14:41.336761
7705,4272,17890,3881,8111,16275,50429,2022-05-12 16:14:45.483691
7709,10,189,4,33,126,362,2022-05-12 16:14:46.677358
7711,3089,247144,1258,432,43158,295081,2022-05-12 16:14:47.114869
7718,57,1200,43,64,1439,2803,2022-05-12 16:14:53.403775
7720,1611,28337,1154,684,9508,41294,2022-05-12 16:14:56.949025
7723,126,1703,66,156,1030,3081,2022-05-12 16:15:01.126882
7724,26659,287106,17974,18293,188181,538213,2022-05-12 16:15:01.314379
7728,646,17056,358,282,11402,29744,2022-05-12 16:15:06.280617
7729,23,267,5,56,167,518,2022-05-12 16:15:08.804513
7739,466,32758,314,371,5241,39150,2022-05-12 16:15:09.242037
7744,227,4719,156,119,1583,6804,2022-05-12 16:15:15.270061
7750,29,103,16,65,245,458,2022-05-12 16:15:18.37781
7751,38,125,36,80,472,751,2022-05-12 16:15:20.178766
38828,6,32,6,39,74,157,2022-05-12 20:48:53.536131
7752,28,258,13,48,201,548,2022-05-12 16:15:21.928741
7759,135,2135,114,126,1751,4261,2022-05-12 16:15:24.087324
7768,1929,19869,1608,2678,16206,42290,2022-05-12 16:15:33.309709
7769,12624,159929,7376,8559,71129,259617,2022-05-12 16:15:33.528372
7770,326,2007,294,357,2534,5518,2022-05-12 16:15:36.618633
7774,199,4447,122,104,2611,7483,2022-05-12 16:15:39.288238
7779,34,313,34,130,384,895,2022-05-12 16:15:43.903737
7781,76,121,53,90,2910,3250,2022-05-12 16:15:46.585188
7782,285,10377,230,283,2938,14113,2022-05-12 16:15:49.062121
7785,23894,140468,14272,8788,201251,388673,2022-05-12 16:15:49.484077
7786,47,785,33,94,550,1509,2022-05-12 16:15:51.92108
7791,35952,416372,25854,18133,121677,617988,2022-05-12 16:15:52.222996
7803,15,90,11,51,169,336,2022-05-12 16:15:54.454656
7808,28,234,23,111,269,665,2022-05-12 16:16:03.434778
7809,30,1129,21,94,504,1778,2022-05-12 16:16:06.76113
7810,32,797,13,40,399,1281,2022-05-12 16:16:08.538082
7811,26,1221,12,43,358,1660,2022-05-12 16:16:10.209959
7817,12362,262600,7910,14371,62909,360152,2022-05-12 16:16:11.665667
7818,63,524,27,67,802,1483,2022-05-12 16:16:16.74884
7843,33,639,13,36,383,1104,2022-05-12 16:16:20.130943
7845,45,227,26,85,236,619,2022-05-12 16:16:24.901869
7857,145,3021,137,153,1676,5132,2022-05-12 16:16:27.705237
7858,1638,83661,694,492,16137,102622,2022-05-12 16:16:31.334154
7862,40,632,20,65,325,1082,2022-05-12 16:16:36.050781
7867,132,676,123,357,618,1906,2022-05-12 16:16:38.193734
7870,857,34272,801,491,10487,46908,2022-05-12 16:16:40.149787
7875,489,11386,283,201,5665,18024,2022-05-12 16:16:42.849743
7876,28,440,14,57,321,860,2022-05-12 16:16:44.45011
7877,139,1567,61,73,2354,4194,2022-05-12 16:16:46.640083
7882,108,2207,83,127,1798,4323,2022-05-12 16:16:49.576055
7897,478,13032,234,375,4595,18714,2022-05-12 16:16:49.826043
7900,48,640,16,66,417,1187,2022-05-12 16:16:51.654181
7902,1315,37901,1071,762,15280,56329,2022-05-12 16:16:51.904158
7904,90,795,66,170,1297,2418,2022-05-12 16:16:54.363268
7914,66,278,38,76,321,779,2022-05-12 16:16:55.954426
7939,27,243,44,67,325,706,2022-05-12 16:17:00.049297
7953,27,1509,26,62,464,2088,2022-05-12 16:17:02.030479
7955,35,283,28,98,348,792,2022-05-12 16:17:03.625283
7960,69,119,32,70,541,831,2022-05-12 16:17:05.415406
7967,23,178,14,46,437,698,2022-05-12 16:17:07.602942
7972,111,4260,85,88,2284,6828,2022-05-12 16:17:10.265963
7980,17,155,14,103,142,431,2022-05-12 16:17:11.418979
7981,20,257,21,101,140,539,2022-05-12 16:17:12.809619
7982,22,106,6,53,420,607,2022-05-12 16:17:14.217272
8017,92,1498,65,88,910,2653,2022-05-12 16:17:18.099879
8023,1055,31245,706,444,10896,44346,2022-05-12 16:17:23.971472
8025,25,117,19,90,239,490,2022-05-12 16:17:25.469444
8038,661,30777,366,215,9068,41087,2022-05-12 16:17:29.014363
8041,45,215,48,159,390,857,2022-05-12 16:17:31.317191
8042,49,579,29,54,755,1466,2022-05-12 16:17:32.7831
8057,808,11090,528,478,6590,19494,2022-05-12 16:17:33.994588
8063,1846,54581,700,596,8726,66449,2022-05-12 16:17:37.15938
8065,42,175,28,76,287,608,2022-05-12 16:17:40.51847
8074,40887,1086231,19780,42300,156829,1346027,2022-05-12 16:17:43.508018
8079,58,616,33,64,633,1404,2022-05-12 16:17:45.728497
38868,2,24,5,31,33,95,2022-05-12 20:49:32.910396
8086,16311,165086,9483,9226,75175,275281,2022-05-12 16:17:47.793095
8092,37,527,32,59,773,1428,2022-05-12 16:17:50.607451
8098,406,7017,217,191,5619,13450,2022-05-12 16:17:55.381365
8100,1943,34918,837,500,29972,68170,2022-05-12 16:17:58.283402
8109,37,993,26,71,615,1742,2022-05-12 16:18:03.536243
8120,61,1124,43,59,1227,2514,2022-05-12 16:18:09.924802
8129,7531,128124,5042,3478,67974,212149,2022-05-12 16:18:13.730431
8130,33,254,34,91,306,718,2022-05-12 16:18:16.113867
8132,54,996,45,155,855,2105,2022-05-12 16:18:18.199504
8133,122,3932,64,120,1644,5882,2022-05-12 16:18:19.946793
8134,77,2048,52,79,1013,3269,2022-05-12 16:18:22.34021
8140,42,835,44,124,226,1271,2022-05-12 16:18:24.678788
8142,3526,97518,1638,932,72405,176019,2022-05-12 16:18:27.327228
8143,13,53,10,76,136,288,2022-05-12 16:18:28.597729
8145,47,461,36,64,461,1069,2022-05-12 16:18:30.137569
8150,33,416,28,64,334,875,2022-05-12 16:18:32.40972
8152,38,367,33,68,448,954,2022-05-12 16:18:33.690921
8153,27,290,24,65,378,784,2022-05-12 16:18:35.347216
8154,31,264,22,66,368,751,2022-05-12 16:18:37.050292
8155,29,242,21,66,357,715,2022-05-12 16:18:39.360883
8156,40,327,28,62,391,848,2022-05-12 16:18:41.829707
8157,38,361,29,56,369,853,2022-05-12 16:18:43.607576
8158,48,316,31,77,458,930,2022-05-12 16:18:45.00108
8162,54,551,28,44,582,1259,2022-05-12 16:18:46.666157
8171,383,13698,245,337,4717,19380,2022-05-12 16:18:46.916158
8176,22,325,13,69,194,623,2022-05-12 16:18:48.401274
8179,20,119,18,107,159,423,2022-05-12 16:18:51.759072
8180,23,290,21,56,346,736,2022-05-12 16:18:53.188065
8181,41,772,22,65,568,1468,2022-05-12 16:18:54.696028
8182,29,198,34,114,216,591,2022-05-12 16:18:55.852191
8183,18,214,14,94,141,481,2022-05-12 16:18:56.961558
8184,23,146,18,90,194,471,2022-05-12 16:18:58.726858
8187,315,21475,115,62,4053,26020,2022-05-12 16:19:01.944785
8189,98,174,59,134,408,873,2022-05-12 16:19:03.893479
8190,333,20894,245,137,6169,27778,2022-05-12 16:19:06.236291
8191,21,69,18,52,200,360,2022-05-12 16:19:07.356084
8194,52,302,41,133,506,1034,2022-05-12 16:19:11.227073
8208,92,1296,47,43,1024,2502,2022-05-12 16:19:21.561608
8213,31,406,17,103,172,729,2022-05-12 16:19:25.353188
8215,81,269,43,89,829,1311,2022-05-12 16:19:27.728195
8217,572,5972,468,566,2868,10446,2022-05-12 16:19:34.477508
8220,31,246,21,104,199,601,2022-05-12 16:19:37.408136
8226,29,338,13,75,289,744,2022-05-12 16:19:38.609964
8227,18,282,13,77,225,615,2022-05-12 16:19:39.825827
8228,74,1043,39,43,810,2009,2022-05-12 16:19:41.154
8229,15,74,10,41,119,259,2022-05-12 16:19:42.188701
8230,192,9138,104,115,3000,12549,2022-05-12 16:19:45.352123
8231,234,5924,188,190,3086,9622,2022-05-12 16:19:47.861194
8235,109,1098,86,195,817,2305,2022-05-12 16:19:52.131158
8241,2332,16164,1702,5368,12128,37694,2022-05-12 16:19:57.755634
8244,35,28,11,77,125,276,2022-05-12 16:20:01.922935
8245,103,4058,78,132,1457,5828,2022-05-12 16:20:04.418256
8246,2012,199161,807,578,18601,221159,2022-05-12 16:20:04.855718
8247,2032,160970,901,513,21163,185579,2022-05-12 16:20:05.027609
8248,66,1664,38,68,963,2799,2022-05-12 16:20:07.652632
8249,96,1698,39,65,1090,2988,2022-05-12 16:20:10.235398
8250,85,1655,49,59,997,2845,2022-05-12 16:20:12.141725
8258,13,73,9,68,141,304,2022-05-12 16:20:14.276819
8277,9473,98060,5549,8127,46380,167589,2022-05-12 16:20:17.33944
8278,187,4504,104,135,2582,7512,2022-05-12 16:20:20.940276
8285,52,347,37,134,452,1022,2022-05-12 16:20:23.562475
8287,281,1890,225,499,1442,4337,2022-05-12 16:20:25.911637
8297,92,2561,47,107,1020,3827,2022-05-12 16:20:28.177343
8302,945,23880,524,523,5910,31782,2022-05-12 16:20:30.596058
8304,33,369,17,34,469,922,2022-05-12 16:20:32.236686
8310,5526,36496,3089,2106,17871,65088,2022-05-12 16:20:32.589474
8311,2872,33600,2368,1765,18903,59508,2022-05-12 16:20:35.309164
8312,41,1543,25,37,789,2435,2022-05-12 16:20:37.885184
8314,28,418,21,66,323,856,2022-05-12 16:20:39.62782
8316,19,251,14,71,265,620,2022-05-12 16:20:41.025554
8317,233,4936,213,164,4522,10068,2022-05-12 16:20:43.1246
8324,26,233,8,48,276,591,2022-05-12 16:20:44.568604
8332,9,199,4,29,87,328,2022-05-12 16:20:49.277472
8333,18,779,9,44,209,1059,2022-05-12 16:20:50.755039
8336,155,0,89,186,232,662,2022-05-12 16:20:52.739376
8337,127,2834,57,67,1963,5048,2022-05-12 16:20:55.102215
8339,268,8738,118,243,3438,12805,2022-05-12 16:20:57.836617
8348,357,14824,307,276,5919,21683,2022-05-12 16:21:03.01837
8356,17,143,12,84,165,421,2022-05-12 16:21:07.358901
8357,23,140,14,93,184,454,2022-05-12 16:21:08.697896
8358,65,6120,43,104,748,7080,2022-05-12 16:21:11.498726
8359,78,5746,39,112,659,6634,2022-05-12 16:21:14.549529
8362,78,5644,39,111,646,6518,2022-05-12 16:21:18.962438
8363,65,3235,34,90,627,4051,2022-05-12 16:21:21.031588
8364,59,2584,41,96,629,3409,2022-05-12 16:21:23.96652
8366,81,2631,44,99,707,3562,2022-05-12 16:21:26.849443
8367,63,3168,39,105,604,3979,2022-05-12 16:21:29.295375
8368,73,2404,41,100,634,3252,2022-05-12 16:21:32.142247
8372,28,259,12,59,350,708,2022-05-12 16:21:35.806867
8373,47,2436,55,179,318,3035,2022-05-12 16:21:38.57426
8394,215,2467,386,431,2298,5797,2022-05-12 16:21:40.422719
8403,14,152,9,76,160,411,2022-05-12 16:21:41.672712
8408,3123,129123,1895,850,25391,160382,2022-05-12 16:21:48.241767
8409,68,294,53,82,490,987,2022-05-12 16:21:50.138218
8410,701,39227,471,799,3007,44205,2022-05-12 16:21:54.393211
8415,30,136,14,66,282,528,2022-05-12 16:21:55.609231
8416,23,210,12,68,191,504,2022-05-12 16:21:57.463277
8417,15,130,11,78,136,370,2022-05-12 16:21:59.337715
8423,84,1694,76,136,1735,3725,2022-05-12 16:22:01.081077
8424,8616,156174,4736,7951,45685,223162,2022-05-12 16:22:04.684623
8425,28895,248539,23456,21930,168758,491578,2022-05-12 16:22:04.934639
8426,6502,44700,5250,5052,57276,118780,2022-05-12 16:22:05.122147
8431,44,377,23,40,410,894,2022-05-12 16:22:09.593543
8436,65,239,47,112,746,1209,2022-05-12 16:22:12.609751
8438,118,6268,124,152,2323,8985,2022-05-12 16:22:14.98668
8440,995,42476,641,700,13601,58413,2022-05-12 16:22:15.30221
8446,15,322,5,26,146,514,2022-05-12 16:22:18.845189
8450,44,267,33,54,934,1332,2022-05-12 16:22:21.495028
8456,984,10516,513,395,7621,20029,2022-05-12 16:22:27.455411
8460,4006,176809,1586,1968,30965,215334,2022-05-12 16:22:28.174237
8464,55,637,21,62,526,1301,2022-05-12 16:22:31.008786
8465,1228,37538,633,589,7669,47657,2022-05-12 16:22:33.627557
8475,612,17634,337,381,11648,30612,2022-05-12 16:22:36.138494
8478,21,96,17,73,170,377,2022-05-12 16:22:41.395942
8481,974,16642,625,424,8985,27650,2022-05-12 16:22:45.191075
8486,21,459,9,42,501,1032,2022-05-12 16:22:47.07536
8487,328,6942,165,172,5463,13070,2022-05-12 16:22:49.876763
8490,99,5534,93,215,1937,7878,2022-05-12 16:22:52.261237
8491,109,3694,116,161,2015,6095,2022-05-12 16:22:54.310367
8492,15,76,8,54,84,237,2022-05-12 16:22:55.325967
8493,32,268,20,68,357,745,2022-05-12 16:22:56.56355
8494,16,127,6,63,118,330,2022-05-12 16:22:58.182659
8495,19,117,16,47,337,536,2022-05-12 16:22:59.98551
8496,32,543,12,35,343,965,2022-05-12 16:23:01.403326
8500,70,718,29,56,989,1862,2022-05-12 16:23:03.013395
8501,15,112,10,93,152,382,2022-05-12 16:23:04.857447
8503,215,585,164,145,1597,2706,2022-05-12 16:23:05.923558
8514,598,51107,341,229,7645,59920,2022-05-12 16:23:06.750076
8516,8596,283789,5558,5813,45230,348986,2022-05-12 16:23:10.396174
8518,81,1762,54,67,1016,2980,2022-05-12 16:23:12.236707
8520,15,105,10,79,89,298,2022-05-12 16:23:15.095887
8521,9,102,5,73,89,278,2022-05-12 16:23:17.286219
8522,18,89,4,53,119,283,2022-05-12 16:23:18.934881
8524,28,175,21,61,312,597,2022-05-12 16:23:20.804755
8525,22111,398554,14474,17143,125297,577579,2022-05-12 16:23:24.216839
8536,4408,78667,2615,4001,21130,110821,2022-05-12 16:23:35.373566
8539,61,274,24,76,713,1148,2022-05-12 16:23:39.004459
8546,44,810,28,64,563,1509,2022-05-12 16:23:43.415419
8547,38,640,27,62,510,1277,2022-05-12 16:23:45.431095
8548,33,582,26,54,478,1173,2022-05-12 16:23:46.912522
8550,36,563,29,62,508,1198,2022-05-12 16:23:48.169705
8551,42,671,25,63,496,1297,2022-05-12 16:23:49.359548
8553,47,424,32,130,358,991,2022-05-12 16:23:51.313909
8554,40,490,31,80,526,1167,2022-05-12 16:23:54.049701
8557,8636,103239,7611,8086,54302,181874,2022-05-12 16:23:56.733466
8561,22,121,6,44,225,418,2022-05-12 16:24:01.89748
8563,32,151,19,62,503,767,2022-05-12 16:24:03.396444
8567,10,50,5,59,80,204,2022-05-12 16:24:04.610783
8577,1608,60473,777,1002,8545,72405,2022-05-12 16:24:07.65697
8584,76,764,37,67,1101,2045,2022-05-12 16:24:09.934714
8598,48,368,29,65,841,1351,2022-05-12 16:24:13.571247
8599,473,12019,282,179,5136,18089,2022-05-12 16:24:17.059951
8603,18,597,11,32,319,977,2022-05-12 16:24:19.357978
8609,296,13511,144,192,2783,16926,2022-05-12 16:24:24.003481
8624,1989,29594,1970,3857,7161,44571,2022-05-12 16:24:24.798148
8626,59,4673,19,45,494,5290,2022-05-12 16:24:32.675625
8628,18,925,4,35,160,1142,2022-05-12 16:24:34.614595
8630,13737,245562,7694,12504,68228,347725,2022-05-12 16:24:34.786557
8631,116,132,63,129,182,622,2022-05-12 16:24:38.959462
8635,136,2867,98,98,1903,5102,2022-05-12 16:24:44.651921
8643,112,347,53,103,934,1549,2022-05-12 16:24:47.70162
8644,15,125,7,55,124,326,2022-05-12 16:24:49.012655
8646,19,1430,10,75,165,1699,2022-05-12 16:24:54.848173
8648,276,3039,294,254,2327,6190,2022-05-12 16:24:57.471666
8659,12,400,5,31,120,568,2022-05-12 16:24:59.637208
8660,8,170,5,39,68,290,2022-05-12 16:25:00.90274
8661,8,533,6,46,105,698,2022-05-12 16:25:02.451203
8663,18,632,12,49,244,955,2022-05-12 16:25:04.81107
8666,352,6708,206,233,3460,10959,2022-05-12 16:25:09.879923
8667,10,338,5,30,119,502,2022-05-12 16:25:11.676175
8668,618,8522,475,512,5790,15917,2022-05-12 16:25:14.662688
8671,8,260,5,31,67,371,2022-05-12 16:25:19.997479
8675,23758,260475,14530,15811,134305,448879,2022-05-12 16:25:20.20068
8676,19649,175404,13271,18926,114647,341897,2022-05-12 16:25:20.372479
39145,2,9,2,29,34,76,2022-05-12 20:54:31.75821
8677,39,376,18,47,409,889,2022-05-12 16:25:26.229274
8678,32,284,11,42,275,644,2022-05-12 16:25:29.658506
8679,9,201,5,38,59,312,2022-05-12 16:25:30.72411
8682,15,456,5,23,134,633,2022-05-12 16:25:38.27539
8687,6721,4,2723,3414,3530,16392,2022-05-12 16:25:40.138512
8689,40,1713,13,56,646,2468,2022-05-12 16:25:42.574008
8697,8,363,5,27,71,474,2022-05-12 16:25:44.824428
8701,25,919,9,56,315,1324,2022-05-12 16:25:46.2779
8704,13,422,3,39,87,564,2022-05-12 16:25:48.048784
8705,241,2839,183,228,3816,7307,2022-05-12 16:25:50.218115
8706,59,349,40,78,494,1020,2022-05-12 16:25:51.715897
8707,32,295,19,64,253,663,2022-05-12 16:25:52.896979
8709,84,4018,96,133,1799,6130,2022-05-12 16:25:55.235401
8710,31,638,14,34,213,930,2022-05-12 16:25:56.675489
8713,39,1672,12,57,597,2377,2022-05-12 16:25:56.925428
8716,11,310,7,67,109,504,2022-05-12 16:25:58.238191
8717,8,373,3,30,125,539,2022-05-12 16:25:59.700622
8718,11,306,5,29,96,447,2022-05-12 16:26:00.981787
8719,9,267,4,41,92,413,2022-05-12 16:26:02.247399
8722,18,584,0,31,147,780,2022-05-12 16:26:03.575881
8724,9,194,4,32,78,317,2022-05-12 16:26:06.264973
8726,2965,24201,2060,2594,24925,56745,2022-05-12 16:26:09.673438
8728,448,19616,469,424,8992,29949,2022-05-12 16:26:12.727286
8729,10,255,6,37,66,374,2022-05-12 16:26:13.986906
8730,9,385,5,33,81,513,2022-05-12 16:26:15.106916
8731,9,473,9,64,147,702,2022-05-12 16:26:16.509682
8732,11,291,2,32,72,408,2022-05-12 16:26:18.025263
8733,10,266,2,29,78,385,2022-05-12 16:26:19.746488
8743,49,1751,17,42,640,2499,2022-05-12 16:26:25.451304
8751,9,372,3,25,81,490,2022-05-12 16:26:28.731369
8753,37,229,20,109,222,617,2022-05-12 16:26:31.528968
8754,113,1992,93,86,2050,4334,2022-05-12 16:26:34.122719
8756,362,10277,276,230,5319,16464,2022-05-12 16:26:34.570964
8767,116,2068,85,81,1460,3810,2022-05-12 16:26:41.417817
8768,1871,67918,645,454,19423,90311,2022-05-12 16:26:44.395156
8769,21205,456523,11978,22908,123064,635678,2022-05-12 16:26:44.566931
8772,7,214,8,31,54,314,2022-05-12 16:26:48.971034
8773,7,256,4,30,58,355,2022-05-12 16:26:51.427799
8774,20,408,8,101,248,785,2022-05-12 16:26:53.157714
8777,33,187,29,83,336,668,2022-05-12 16:26:54.550888
8783,28,448,17,65,321,879,2022-05-12 16:26:59.481451
8792,85,8198,42,43,860,9228,2022-05-12 16:27:04.305248
8795,19549,207655,16255,16005,82344,341808,2022-05-12 16:27:05.318649
8799,30,147,21,72,296,566,2022-05-12 16:27:07.586731
8800,221,3061,210,146,1567,5205,2022-05-12 16:27:10.652913
8812,77,354,51,120,1126,1728,2022-05-12 16:27:12.795937
8815,43,877,37,117,348,1422,2022-05-12 16:27:14.799309
8832,18,129,16,88,144,395,2022-05-12 16:27:18.514723
8840,83,2593,57,64,1030,3827,2022-05-12 16:27:23.649735
8841,22194,426156,13990,19021,102828,584189,2022-05-12 16:27:26.604044
8848,26,264,10,41,293,634,2022-05-12 16:27:29.79677
8853,50,148,47,92,352,689,2022-05-12 16:27:31.255569
8857,1113,58463,602,318,17037,77533,2022-05-12 16:27:35.121134
8861,17842,296293,9056,22529,98420,444140,2022-05-12 16:27:38.517037
8876,4740,52397,2368,1737,24593,85835,2022-05-12 16:27:43.136843
8879,12,107,13,92,183,407,2022-05-12 16:27:44.796238
8883,27,123,16,40,284,490,2022-05-12 16:27:47.333496
8889,57,816,26,56,637,1592,2022-05-12 16:27:50.789696
8890,72,234,41,76,827,1250,2022-05-12 16:27:52.574349
8891,44,163,28,66,360,661,2022-05-12 16:27:53.791579
8894,112,7986,72,90,2109,10369,2022-05-12 16:27:54.767543
8896,36,390,14,45,490,975,2022-05-12 16:27:56.951528
8898,50,603,18,52,503,1226,2022-05-12 16:28:00.470707
8899,29,228,30,104,301,692,2022-05-12 16:28:02.166985
8908,116,3306,94,78,2002,5596,2022-05-12 16:28:06.987589
8917,5215,28109,4882,7895,24215,70316,2022-05-12 16:28:14.080229
8920,67,729,24,40,811,1671,2022-05-12 16:28:16.669829
8921,20,667,21,63,301,1072,2022-05-12 16:28:18.529176
8928,35,365,14,61,334,809,2022-05-12 16:28:21.56497
8936,21,952,15,39,486,1513,2022-05-12 16:28:27.075318
8939,44,4368,22,49,807,5290,2022-05-12 16:28:30.999156
8949,40,821,26,63,501,1451,2022-05-12 16:28:34.072824
8950,83,1129,56,104,1438,2810,2022-05-12 16:28:37.583781
8953,28,250,17,66,380,741,2022-05-12 16:28:39.932259
8955,21,91,20,54,296,482,2022-05-12 16:28:41.158281
8956,34,289,22,87,208,640,2022-05-12 16:28:43.451744
8957,12,177,8,42,92,331,2022-05-12 16:28:44.951735
8959,16,95,7,44,118,280,2022-05-12 16:28:46.412109
8960,56,363,66,114,635,1234,2022-05-12 16:28:48.810485
8963,33,609,19,66,386,1113,2022-05-12 16:28:55.574472
8964,77,976,54,154,750,2011,2022-05-12 16:28:56.011923
8966,33,795,20,61,479,1388,2022-05-12 16:28:58.136839
8967,21,127,13,47,254,462,2022-05-12 16:28:59.269419
8972,33,879,30,52,506,1500,2022-05-12 16:29:01.634878
8986,2033,10147,1812,2789,13133,29914,2022-05-12 16:29:06.065276
8993,56,590,33,76,433,1188,2022-05-12 16:29:08.27741
9001,105,4551,49,54,2364,7123,2022-05-12 16:29:18.234815
9005,210,2239,138,108,1853,4548,2022-05-12 16:29:22.998883
9014,1598,26068,775,759,10069,39269,2022-05-12 16:29:26.684293
9023,317,11410,203,204,4384,16518,2022-05-12 16:29:30.029103
9028,35,166,17,83,218,519,2022-05-12 16:29:31.388408
9032,372,23312,123,170,2425,26402,2022-05-12 16:29:31.747746
9035,82,1802,52,80,1214,3230,2022-05-12 16:29:34.160188
9041,19085,448807,8756,17622,90495,584765,2022-05-12 16:29:35.297359
39406,5,12,2,31,30,80,2022-05-12 20:58:17.86706
9043,78,312,52,73,793,1308,2022-05-12 16:29:38.540896
9053,43,608,35,67,627,1380,2022-05-12 16:29:46.303213
9055,1601,17583,1030,860,19482,40556,2022-05-12 16:29:47.838072
9061,38,163,30,80,315,626,2022-05-12 16:29:52.546692
9062,39455,168841,10269,4222,32654,255441,2022-05-12 16:29:52.765442
9063,642,28323,399,220,9166,38750,2022-05-12 16:30:00.253237
9065,3222,53467,2023,1883,20868,81463,2022-05-12 16:30:03.720736
9077,93,651,42,65,1118,1969,2022-05-12 16:30:11.562787
9078,56,289,26,66,631,1068,2022-05-12 16:30:14.076112
9087,53,715,42,111,818,1739,2022-05-12 16:30:16.483182
9088,625,5944,326,269,5466,12630,2022-05-12 16:30:19.545245
9098,53,732,47,106,912,1850,2022-05-12 16:30:22.098984
9100,136,831,96,98,1658,2819,2022-05-12 16:30:24.988162
9106,32,369,26,76,323,826,2022-05-12 16:30:26.605997
9107,3279,67637,3385,6497,8749,89547,2022-05-12 16:30:26.856029
9119,28,455,17,114,174,788,2022-05-12 16:30:28.987269
9120,745,26236,413,354,8213,35961,2022-05-12 16:30:31.667766
9121,104,1609,72,88,981,2854,2022-05-12 16:30:34.803212
9127,98,1224,70,94,1314,2800,2022-05-12 16:30:40.558849
9130,2441,52398,1174,934,11309,68256,2022-05-12 16:30:40.777527
9135,2174,129052,1550,885,37384,171045,2022-05-12 16:30:46.472967
9136,3589,87814,2585,1643,20216,115847,2022-05-12 16:30:49.602423
9154,66,848,59,54,846,1873,2022-05-12 16:30:52.718952
9159,724,7035,400,278,3925,12362,2022-05-12 16:30:55.596721
9164,34,319,19,87,304,763,2022-05-12 16:30:58.005127
9165,30,331,22,89,313,785,2022-05-12 16:30:59.346671
9166,33,324,19,90,303,769,2022-05-12 16:31:01.89647
9167,139,2253,107,140,1315,3954,2022-05-12 16:31:04.115127
9172,25,361,14,63,268,731,2022-05-12 16:31:08.117842
9181,8030,241045,3865,4199,46053,303192,2022-05-12 16:31:14.599979
9200,66,1020,49,87,534,1756,2022-05-12 16:31:16.162005
9201,2337,45449,1241,904,12513,62444,2022-05-12 16:31:18.916669
9204,443,9064,168,211,7135,17021,2022-05-12 16:31:28.300326
9205,1199,4606,631,672,2186,9294,2022-05-12 16:31:31.279323
9212,19,105,18,48,300,490,2022-05-12 16:31:32.568843
9221,30,421,12,38,204,705,2022-05-12 16:31:39.28746
9232,364,6396,153,232,1768,8913,2022-05-12 16:31:43.093465
9241,697,3863,485,754,3021,8820,2022-05-12 16:31:46.371087
9242,29,405,18,65,312,829,2022-05-12 16:31:47.865272
9243,27,363,19,58,268,735,2022-05-12 16:31:49.084025
9244,21,333,16,61,226,657,2022-05-12 16:31:50.017232
9252,537,48463,306,223,7436,56965,2022-05-12 16:31:50.439074
9253,143547,1397706,78183,46350,558239,2224025,2022-05-12 16:31:50.751606
9254,71,422,44,59,1165,1761,2022-05-12 16:31:52.833325
9260,9809,313085,2882,1414,139266,466456,2022-05-12 16:31:53.239574
9264,40,547,23,52,377,1039,2022-05-12 16:31:56.248719
9282,40,330,18,94,373,855,2022-05-12 16:32:01.939349
9284,33,162,28,121,315,659,2022-05-12 16:32:03.364432
9288,111,4685,72,138,1573,6579,2022-05-12 16:32:06.258301
9289,18533,140342,12908,10709,124942,307434,2022-05-12 16:32:10.715927
9291,38,804,7,54,268,1171,2022-05-12 16:32:16.55008
9292,11,160,9,46,171,397,2022-05-12 16:32:17.750328
9314,3365,40475,2912,4157,27878,78787,2022-05-12 16:32:21.286613
9324,76,1126,42,43,724,2011,2022-05-12 16:32:26.325848
9330,6778,112632,4103,7450,31960,162923,2022-05-12 16:32:27.450849
39436,2,21,5,33,58,119,2022-05-12 20:58:45.811302
9332,986,26853,585,591,9871,38886,2022-05-12 16:32:28.878108
9333,168,5081,80,83,2298,7710,2022-05-12 16:32:31.206153
9334,15,66,6,50,218,355,2022-05-12 16:32:32.88691
9337,68,387,27,51,943,1476,2022-05-12 16:32:37.864339
9338,42,118,14,45,323,542,2022-05-12 16:32:39.801176
9339,12,73,8,64,152,309,2022-05-12 16:32:42.342667
9340,32,764,20,68,461,1345,2022-05-12 16:32:44.465121
9342,97,2389,39,98,1188,3811,2022-05-12 16:32:48.276089
9345,58,150,26,88,554,876,2022-05-12 16:32:52.321461
9346,216,1766,108,250,1329,3669,2022-05-12 16:32:54.587885
9347,454,20035,272,240,5318,26319,2022-05-12 16:32:57.007425
9348,38,797,32,79,596,1542,2022-05-12 16:32:59.199295
9349,34,102,7,49,293,485,2022-05-12 16:33:00.793122
9351,15,64,8,54,173,314,2022-05-12 16:33:01.972956
9353,172,3241,136,126,2442,6117,2022-05-12 16:33:04.280127
9355,905,38076,500,275,9058,48814,2022-05-12 16:33:07.174652
9356,45,782,14,53,367,1261,2022-05-12 16:33:08.6366
9361,24,1338,11,36,233,1642,2022-05-12 16:33:10.339874
9362,707,16005,440,318,5372,22842,2022-05-12 16:33:12.783317
9367,10759,217898,5700,12840,52664,299861,2022-05-12 16:33:18.679726
9371,29,70,19,79,234,431,2022-05-12 16:33:20.711021
9376,33,255,17,59,321,685,2022-05-12 16:33:22.086019
9379,14430,149828,9737,10810,98512,283317,2022-05-12 16:33:22.974324
39501,2,14,3,28,30,77,2022-05-12 20:59:25.841701
9385,42,338,14,56,328,778,2022-05-12 16:33:28.044213
9389,26,282,15,53,223,599,2022-05-12 16:33:30.506872
9390,20,301,13,50,237,621,2022-05-12 16:33:33.062643
9392,25,317,10,71,241,664,2022-05-12 16:33:35.055598
9393,189,2103,168,158,1647,4265,2022-05-12 16:33:39.187159
9396,245,13569,159,124,3399,17496,2022-05-12 16:33:43.810118
9403,28,223,18,65,307,641,2022-05-12 16:33:45.82657
9404,17,75,3,55,130,280,2022-05-12 16:33:46.962282
9416,13,164,5,58,131,371,2022-05-12 16:33:49.872966
9417,10,133,4,51,112,310,2022-05-12 16:33:51.997966
9421,22,272,3,24,208,529,2022-05-12 16:33:53.668478
9423,14,489,4,22,230,759,2022-05-12 16:33:55.845048
9426,20,98,17,68,172,375,2022-05-12 16:33:57.760748
9433,35,252,21,126,224,658,2022-05-12 16:33:59.324848
9445,45,279,28,45,420,817,2022-05-12 16:34:06.311733
9446,16,163,8,73,115,375,2022-05-12 16:34:07.561733
9447,11,97,5,57,110,280,2022-05-12 16:34:08.862036
9455,28,114,14,80,166,402,2022-05-12 16:34:11.064967
9464,15,110,8,41,147,321,2022-05-12 16:34:12.290425
9465,573,47176,338,228,7530,55845,2022-05-12 16:34:12.712231
9471,1689,99399,853,617,16391,118949,2022-05-12 16:34:15.372481
9479,6675,56493,6258,15627,29195,114248,2022-05-12 16:34:18.739749
9491,71,1079,27,42,815,2034,2022-05-12 16:34:24.000396
9493,1075,6194,965,2089,6465,16788,2022-05-12 16:34:25.113439
9495,41,348,21,50,628,1088,2022-05-12 16:34:28.691752
9496,26,147,8,47,268,496,2022-05-12 16:34:30.916214
9498,22,87,8,44,151,312,2022-05-12 16:34:32.353654
9501,22,165,10,46,208,451,2022-05-12 16:34:36.618315
9502,10,803,4,31,110,958,2022-05-12 16:34:38.029911
9509,65,980,21,57,702,1825,2022-05-12 16:34:42.089047
9510,1185,32662,699,704,7634,42884,2022-05-12 16:34:45.177138
9513,47050,293404,37768,39082,124864,542168,2022-05-12 16:34:46.101375
9518,26,118,20,65,308,537,2022-05-12 16:34:49.204263
9519,47,215,19,57,525,863,2022-05-12 16:34:50.764926
9520,43,191,40,108,357,739,2022-05-12 16:34:52.668975
9522,37,172,15,97,189,510,2022-05-12 16:34:56.247149
9525,34,244,20,48,404,750,2022-05-12 16:35:02.925048
9528,24,485,21,63,265,858,2022-05-12 16:35:08.262992
9531,40,383,9,47,308,787,2022-05-12 16:35:09.740321
9533,17,78,8,64,119,286,2022-05-12 16:35:10.817436
9535,28,328,20,60,558,994,2022-05-12 16:35:13.459775
9539,3352,28871,2617,5035,9515,49390,2022-05-12 16:35:16.778428
9540,18,106,10,74,151,359,2022-05-12 16:35:18.150485
9544,255,19849,96,110,3318,23628,2022-05-12 16:35:20.998692
9546,18,71,4,58,188,339,2022-05-12 16:35:22.283453
9561,55,1018,30,87,439,1629,2022-05-12 16:35:32.327693
9562,21,60,8,91,131,311,2022-05-12 16:35:33.99392
9575,22,279,6,50,154,511,2022-05-12 16:35:40.098121
9587,4232,49229,2391,6125,22329,84306,2022-05-12 16:35:47.576017
9591,346,8626,326,455,5931,15684,2022-05-12 16:35:50.093834
9595,70,705,55,47,1465,2342,2022-05-12 16:35:52.625129
9598,830,16024,590,1009,8833,27286,2022-05-12 16:35:55.858941
9600,227,2127,115,154,1257,3880,2022-05-12 16:35:56.093398
9606,10,61,3,52,63,189,2022-05-12 16:35:58.14015
9608,311,10516,124,102,4583,15636,2022-05-12 16:36:00.483282
9611,2025,12057,695,394,5530,20701,2022-05-12 16:36:03.209354
9617,4274,222942,1994,1025,62053,292288,2022-05-12 16:36:06.768484
9618,922,33331,446,351,8623,43673,2022-05-12 16:36:09.73861
9624,2779,31370,1624,3151,19941,58865,2022-05-12 16:36:13.410898
9627,52,479,50,111,662,1354,2022-05-12 16:36:15.44433
9630,120,2278,104,115,1594,4211,2022-05-12 16:36:19.254653
9645,469,1789,274,183,3736,6451,2022-05-12 16:36:19.717446
9646,156,1234,43,82,1456,2971,2022-05-12 16:36:22.750015
9650,28,346,15,38,263,690,2022-05-12 16:36:24.101834
9656,10861,314704,6783,4821,66442,403611,2022-05-12 16:36:24.441019
9665,34,119,17,66,409,645,2022-05-12 16:36:28.700604
9667,24,825,9,24,225,1107,2022-05-12 16:36:30.184941
9689,116,349,101,234,743,1543,2022-05-12 16:36:38.917538
9690,376,13987,201,213,3962,18739,2022-05-12 16:36:42.162653
9691,59,337,31,59,549,1035,2022-05-12 16:36:43.560184
9693,919,10277,874,1539,7264,20873,2022-05-12 16:36:46.311184
9712,3407,35479,3091,3369,16308,61654,2022-05-12 16:36:53.913773
9716,133,2990,136,167,2320,5746,2022-05-12 16:36:56.343717
9723,328,8210,186,183,4366,13273,2022-05-12 16:36:57.390503
9724,544,45267,325,217,7289,53642,2022-05-12 16:36:57.812467
9732,21,1345,4,32,191,1593,2022-05-12 16:37:03.662263
9734,1420,92265,767,374,18729,113555,2022-05-12 16:37:05.940777
9735,881,26341,432,392,10529,38575,2022-05-12 16:37:07.409527
9736,5928,85400,3664,6761,32799,134552,2022-05-12 16:37:07.581402
9737,866,4603,780,1320,5889,13458,2022-05-12 16:37:13.215766
9741,1254,14747,518,660,5981,23160,2022-05-12 16:37:16.559301
9748,28,211,16,54,314,623,2022-05-12 16:37:24.426263
9749,20,64,3,44,113,244,2022-05-12 16:37:25.668648
9750,7173,73054,5142,8628,31078,125075,2022-05-12 16:37:28.030098
9756,46395,815225,28621,24789,230078,1145108,2022-05-12 16:37:31.817143
9759,22,230,14,47,270,583,2022-05-12 16:37:34.359849
9761,668,13696,191,327,4316,19198,2022-05-12 16:37:36.417377
9770,43,441,14,84,239,821,2022-05-12 16:37:40.997966
9774,474,5656,182,207,2517,9036,2022-05-12 16:37:45.035258
9776,4397,52115,3619,5762,28652,94545,2022-05-12 16:37:47.369737
9777,52,1378,22,60,640,2152,2022-05-12 16:37:51.06272
9782,211,6410,84,92,3306,10103,2022-05-12 16:37:52.078346
9785,215,4388,141,237,2571,7552,2022-05-12 16:37:52.265845
9786,136,2352,120,220,1918,4746,2022-05-12 16:37:52.703269
9796,17,324,11,83,172,607,2022-05-12 16:37:55.239075
9797,14,123,7,54,206,404,2022-05-12 16:37:57.205048
9798,106,2458,70,82,2184,4900,2022-05-12 16:37:59.98226
9799,72,574,34,140,707,1527,2022-05-12 16:38:02.560452
9801,17,498,6,26,167,714,2022-05-12 16:38:04.092732
9806,302,686,101,206,1913,3208,2022-05-12 16:38:05.024338
9807,11,102,10,71,78,272,2022-05-12 16:38:06.60335
9811,22,111,10,66,142,351,2022-05-12 16:38:09.973732
9812,17,96,8,70,140,331,2022-05-12 16:38:11.092819
9817,17,185,7,52,122,383,2022-05-12 16:38:12.305717
9818,11,141,5,49,81,287,2022-05-12 16:38:13.628201
9819,11,111,4,49,91,266,2022-05-12 16:38:14.749408
9822,42,162,24,71,255,554,2022-05-12 16:38:17.548341
9824,37,500,15,44,406,1002,2022-05-12 16:38:19.754801
9826,30,384,7,49,348,818,2022-05-12 16:38:21.78605
9829,40,251,30,64,882,1267,2022-05-12 16:38:24.505574
9834,4427,44327,3684,5161,30907,88506,2022-05-12 16:38:26.012625
9837,78,635,30,50,761,1554,2022-05-12 16:38:27.872077
9846,52,1235,35,60,709,2091,2022-05-12 16:38:30.351903
9857,30,558,15,88,265,956,2022-05-12 16:38:34.260012
9858,35,517,16,79,317,964,2022-05-12 16:38:35.567104
9861,67,1136,62,80,1127,2472,2022-05-12 16:38:37.377166
9862,34,241,19,50,242,586,2022-05-12 16:38:38.820603
9863,18438,79435,17085,15774,77548,208280,2022-05-12 16:38:38.992479
9866,29,179,16,59,498,781,2022-05-12 16:38:41.205891
9868,16,138,9,65,101,329,2022-05-12 16:38:43.338552
9869,8,99,3,45,91,246,2022-05-12 16:38:44.421889
9874,10155,1328,5073,1578,17432,35566,2022-05-12 16:38:44.593765
9875,773,2874,340,278,10246,14511,2022-05-12 16:38:47.969512
9879,11,156,3,42,100,312,2022-05-12 16:38:51.19052
9883,554,1302,562,530,2608,5556,2022-05-12 16:38:58.801386
9884,254,726,306,377,1613,3276,2022-05-12 16:39:01.022547
9885,25,138,9,78,159,409,2022-05-12 16:39:02.694456
9890,464,22385,193,261,4821,28124,2022-05-12 16:39:10.067634
9893,1024,6645,844,886,4559,13958,2022-05-12 16:39:12.49957
9895,22,1156,12,52,270,1512,2022-05-12 16:39:14.444528
9902,16,60,3,39,67,185,2022-05-12 16:39:16.726702
9905,27,245,19,99,316,706,2022-05-12 16:39:18.640318
9906,28,154,16,82,216,496,2022-05-12 16:39:21.217837
9911,381,11714,219,399,4465,17178,2022-05-12 16:39:27.583455
9917,295,45226,255,270,4701,50747,2022-05-12 16:39:32.042043
9919,72479,1337486,44182,49415,224285,1727847,2022-05-12 16:39:32.385794
9922,4817,39253,3303,6041,29267,82681,2022-05-12 16:39:32.80767
9924,176,3811,116,107,1584,5794,2022-05-12 16:39:34.837467
9926,7025,157021,3358,5137,29517,202058,2022-05-12 16:39:35.884344
9930,262,18014,95,156,2155,20682,2022-05-12 16:39:38.73293
9931,99,1503,55,68,1752,3477,2022-05-12 16:39:39.635398
9935,663,1945,562,493,3977,7640,2022-05-12 16:39:43.482261
9936,13248,166728,5878,11356,62933,260143,2022-05-12 16:39:43.91976
9938,2905,27144,2728,3055,19618,55450,2022-05-12 16:39:46.789984
9941,12480,99881,9987,10462,76721,209531,2022-05-12 16:39:53.156779
9943,333,728,315,232,1636,3244,2022-05-12 16:39:55.825559
9944,103,226,101,103,685,1218,2022-05-12 16:39:58.161525
9948,19,83,12,54,184,352,2022-05-12 16:40:00.34919
9950,17,255,7,64,140,483,2022-05-12 16:40:02.662688
9952,31,155,18,67,277,548,2022-05-12 16:40:07.522338
9957,17,212,17,43,541,830,2022-05-12 16:40:13.694161
9963,547,37282,242,278,4286,42635,2022-05-12 16:40:16.668492
9965,18,127,4,45,127,321,2022-05-12 16:40:18.043492
9967,65,755,44,52,586,1502,2022-05-12 16:40:20.099305
9969,33479,238359,13462,8842,173041,467183,2022-05-12 16:40:20.521181
9972,36,332,22,66,366,822,2022-05-12 16:40:23.696445
9973,10,244,7,79,119,459,2022-05-12 16:40:25.947631
9976,20,660,9,35,175,899,2022-05-12 16:40:28.369505
9978,51,256,31,105,419,862,2022-05-12 16:40:29.798015
9981,7192,51252,6456,10071,27956,102927,2022-05-12 16:40:33.259112
9988,728,8591,342,329,6344,16334,2022-05-12 16:40:36.615438
9989,43388,1091952,23576,17509,274860,1451285,2022-05-12 16:40:36.896688
9991,21,347,15,62,296,741,2022-05-12 16:40:45.253923
9993,26,160,10,50,341,587,2022-05-12 16:40:48.941284
9996,1861,3656,1770,1311,16651,25249,2022-05-12 16:40:52.623724
9999,691,42065,439,433,8159,51787,2022-05-12 16:40:54.501929
10000,18,135,8,56,185,402,2022-05-12 16:40:55.93582
10005,35,400,17,61,424,937,2022-05-12 16:41:00.561593
10012,8381,106614,5669,4027,54937,179628,2022-05-12 16:41:04.458055
10013,53,620,32,60,762,1527,2022-05-12 16:41:06.517074
10014,333,1403,384,467,2797,5384,2022-05-12 16:41:08.7202
10015,4041,43891,3243,7586,9142,67903,2022-05-12 16:41:10.536651
10017,401,32595,280,244,4279,37799,2022-05-12 16:41:15.591705
10020,2760,154302,1286,1064,19434,178846,2022-05-12 16:41:18.434441
10029,2214,125361,1034,416,38224,167249,2022-05-12 16:41:18.684481
39502,2,15,3,27,31,78,2022-05-12 20:59:26.812814
10030,10714,248015,7091,4245,56585,326650,2022-05-12 16:41:19.121981
10033,14547,42955,10306,12991,35155,115954,2022-05-12 16:41:19.278231
10040,14,159,7,52,116,348,2022-05-12 16:41:21.565313
10048,133,2851,71,140,1605,4800,2022-05-12 16:41:27.779583
10049,6861,107412,3814,2743,30474,151304,2022-05-12 16:41:30.79232
10050,81,2749,66,93,1447,4436,2022-05-12 16:41:32.597692
10055,58,1176,46,70,935,2285,2022-05-12 16:41:34.957105
10057,10,153,5,68,102,338,2022-05-12 16:41:37.354508
10060,14,158,6,70,99,347,2022-05-12 16:41:43.636862
10067,1696,200293,1114,542,26593,230238,2022-05-12 16:41:47.416939
10073,4908,81565,3299,5723,31101,126596,2022-05-12 16:41:49.913953
10075,801,37625,407,387,8897,48117,2022-05-12 16:41:52.754539
10076,1195,46483,580,535,8475,57268,2022-05-12 16:41:55.421237
10077,24,228,14,49,212,527,2022-05-12 16:41:56.575289
10080,8701,298752,5402,4078,45476,362409,2022-05-12 16:41:58.06715
10087,59399,955643,30153,20851,280329,1346375,2022-05-12 16:42:03.432894
10090,398,6681,235,236,7168,14718,2022-05-12 16:42:03.88602
10098,311,4980,249,178,3666,9384,2022-05-12 16:42:08.168809
10104,66,909,39,65,665,1744,2022-05-12 16:42:10.78202
10105,50,437,27,76,505,1095,2022-05-12 16:42:14.232543
10108,788,11708,771,863,7645,21775,2022-05-12 16:42:16.901407
10110,16528,327713,7414,9140,90048,450843,2022-05-12 16:42:18.099428
10113,27,143,19,56,235,480,2022-05-12 16:42:23.503779
10115,36,603,13,74,430,1156,2022-05-12 16:42:26.552561
10116,57,3142,42,87,605,3933,2022-05-12 16:42:29.586349
10118,24,221,38,76,403,762,2022-05-12 16:42:30.87129
10122,131,7693,89,59,1854,9826,2022-05-12 16:42:34.193109
10132,14,523,6,30,134,707,2022-05-12 16:42:36.385853
10135,30,226,22,99,171,548,2022-05-12 16:42:37.635929
10136,18,153,11,74,110,366,2022-05-12 16:42:38.758447
10138,15,172,15,81,122,405,2022-05-12 16:42:42.097659
10139,27,211,9,100,187,534,2022-05-12 16:42:43.925865
10149,17,143,3,39,97,299,2022-05-12 16:42:45.469214
10152,930,50974,638,327,13719,66588,2022-05-12 16:42:48.859139
10153,565,13862,299,262,7187,22175,2022-05-12 16:42:49.343438
10155,7953,107916,5493,11557,44896,177815,2022-05-12 16:42:52.604205
10161,14703,245210,9323,11905,115424,396565,2022-05-12 16:42:57.051366
10162,16519,273443,9953,6444,144381,450740,2022-05-12 16:42:57.330141
39504,1,10,3,29,24,67,2022-05-12 20:59:30.068249
10163,11688,176297,7981,10472,76619,283057,2022-05-12 16:42:58.257996
10165,78715,343916,58825,29878,270750,782084,2022-05-12 16:42:58.679871
10172,973,34689,547,552,6251,43012,2022-05-12 16:43:03.738587
10177,192,2219,162,281,1787,4641,2022-05-12 16:43:06.224636
10178,1499,7189,863,481,10103,20135,2022-05-12 16:43:09.796125
10187,2270,20509,1655,3176,15071,42681,2022-05-12 16:43:15.232233
10189,410,17097,306,269,7257,25339,2022-05-12 16:43:15.597528
10201,73,1307,56,61,954,2451,2022-05-12 16:43:31.46796
10202,30,417,10,50,239,746,2022-05-12 16:43:34.428679
10203,11,102,4,63,95,275,2022-05-12 16:43:35.405687
10207,34,643,24,37,516,1254,2022-05-12 16:43:37.441837
10209,3661,101665,1954,911,17565,125756,2022-05-12 16:43:40.077469
10210,18,144,25,86,222,495,2022-05-12 16:43:42.192497
10213,15680,159011,7694,11579,80492,274456,2022-05-12 16:43:42.607195
10216,3100,39954,1775,2469,24058,71356,2022-05-12 16:43:46.798918
10217,505,2643,345,907,3595,7995,2022-05-12 16:43:49.707403
10218,2656,169080,904,846,25247,198733,2022-05-12 16:43:49.957404
10219,256,10756,141,142,3179,14474,2022-05-12 16:43:53.040288
10232,2441,14491,2091,2242,22031,43296,2022-05-12 16:43:57.880787
10236,13,96,8,70,143,330,2022-05-12 16:43:59.816442
10238,17,105,13,65,137,337,2022-05-12 16:44:01.704103
10239,10,75,6,51,83,225,2022-05-12 16:44:03.273812
10242,13,62,4,65,65,209,2022-05-12 16:44:04.711354
10244,21,212,7,65,87,392,2022-05-12 16:44:06.062668
10245,18,78,5,65,206,372,2022-05-12 16:44:07.352124
10247,12,84,7,54,79,236,2022-05-12 16:44:11.093129
10249,846,24055,544,349,10683,36477,2022-05-12 16:44:14.046254
10257,1320,9860,1022,1388,6209,19799,2022-05-12 16:44:19.083019
10259,957,18530,411,306,17757,37961,2022-05-12 16:44:22.298953
10260,815,6483,386,320,7477,15481,2022-05-12 16:44:25.058202
10261,21,155,14,63,285,538,2022-05-12 16:44:26.23091
10263,62,2961,38,58,775,3894,2022-05-12 16:44:30.277786
10270,22,158,7,48,273,508,2022-05-12 16:44:32.56619
10271,6718,112396,4015,2399,45534,171062,2022-05-12 16:44:32.8161
10278,9702,58608,8002,8727,58350,143389,2022-05-12 16:44:35.205465
10282,34,226,18,94,262,634,2022-05-12 16:44:37.800878
10285,18,166,5,69,137,395,2022-05-12 16:44:39.676978
10294,2498,33927,955,524,34094,71998,2022-05-12 16:44:42.440439
10301,156,2899,95,97,1795,5042,2022-05-12 16:44:47.531989
10302,133,8440,129,158,2127,10987,2022-05-12 16:44:50.909188
10304,29,136,10,54,272,501,2022-05-12 16:44:52.458987
10306,83,591,55,60,1071,1860,2022-05-12 16:44:54.396453
10308,2771,21390,1650,2749,14955,43515,2022-05-12 16:44:57.634331
10313,26,435,22,56,349,888,2022-05-12 16:44:59.259332
10319,50,306,35,92,501,984,2022-05-12 16:45:02.237694
10324,136,1293,98,171,1244,2942,2022-05-12 16:45:09.271097
10336,2447,19163,2211,2493,16284,42598,2022-05-12 16:45:20.587748
10342,53,730,32,115,619,1549,2022-05-12 16:45:22.986764
10347,95,336,49,255,470,1205,2022-05-12 16:45:26.922985
10348,339,5553,204,406,1330,7832,2022-05-12 16:45:29.094803
10349,53,254,32,121,167,627,2022-05-12 16:45:30.512996
10350,1080,16558,686,485,7344,26153,2022-05-12 16:45:33.10678
10351,97,4040,73,74,1283,5567,2022-05-12 16:45:35.149392
10353,37,128,23,52,435,675,2022-05-12 16:45:36.78988
10354,54,801,39,62,827,1783,2022-05-12 16:45:39.555272
10355,40,586,17,55,630,1328,2022-05-12 16:45:42.304872
10357,10413,66351,8282,7688,83191,175925,2022-05-12 16:45:44.798554
10359,294,1384,256,352,2308,4594,2022-05-12 16:45:45.713181
10360,40,229,13,66,250,598,2022-05-12 16:45:47.760852
10361,81,1422,62,92,1505,3162,2022-05-12 16:45:49.836764
10369,11,82,3,50,91,237,2022-05-12 16:45:51.056804
10370,671,34732,411,747,2988,39549,2022-05-12 16:45:51.339095
10372,3154,37012,2442,4100,22262,68970,2022-05-12 16:45:54.199023
10375,9,285,4,31,133,462,2022-05-12 16:45:57.577025
10378,3559,59116,2874,2126,22018,89693,2022-05-12 16:45:59.983242
10379,8532,141339,4306,2264,72543,228984,2022-05-12 16:46:00.40761
10384,712,3642,331,323,6269,11277,2022-05-12 16:46:00.565167
10389,1547,41059,742,353,30048,73749,2022-05-12 16:46:03.79954
10390,181,3882,154,247,3267,7731,2022-05-12 16:46:07.004273
10391,137,5547,107,123,3221,9135,2022-05-12 16:46:09.285521
10397,6371,93164,3262,4487,37674,144958,2022-05-12 16:46:14.625058
10405,36,2469,25,54,566,3150,2022-05-12 16:46:16.629713
10406,46,2047,21,70,556,2740,2022-05-12 16:46:20.344582
10407,16,240,13,45,248,562,2022-05-12 16:46:20.765529
10408,14391,519931,3920,1015,184025,723282,2022-05-12 16:46:20.921818
10417,1025,36867,421,584,16364,55261,2022-05-12 16:46:21.327986
10444,653,18645,523,649,4805,25275,2022-05-12 16:46:25.144407
10445,145,9148,55,65,1690,11103,2022-05-12 16:46:28.28383
10447,5752,54889,4106,5691,30197,100635,2022-05-12 16:46:29.346328
10448,303,17074,100,75,5976,23528,2022-05-12 16:46:30.346331
10456,10298,78833,6556,11199,61779,168665,2022-05-12 16:46:33.431451
10459,51,165,41,87,636,980,2022-05-12 16:46:37.521619
10460,8679,72459,6253,7809,75916,171116,2022-05-12 16:46:37.834121
10463,47,772,34,46,678,1577,2022-05-12 16:46:40.786473
10464,2678,44734,1756,1445,17069,67682,2022-05-12 16:46:43.878733
10465,5309,27947,2699,4416,29070,69441,2022-05-12 16:46:44.784982
10469,314,10938,224,131,5662,17269,2022-05-12 16:46:51.581093
10471,71,1508,36,67,553,2235,2022-05-12 16:46:56.5798
10477,232,8540,187,158,3810,12927,2022-05-12 16:46:59.644907
10479,773,11609,510,387,8469,21748,2022-05-12 16:47:02.187166
10481,35,267,22,55,454,833,2022-05-12 16:47:04.768869
10483,140,4275,96,95,2494,7100,2022-05-12 16:47:07.071824
10490,15551,175880,9231,16977,103138,320777,2022-05-12 16:47:07.243699
10495,15822,174062,11001,12166,101493,314544,2022-05-12 16:47:10.865933
10497,564,16674,406,280,5267,23191,2022-05-12 16:47:15.514833
10501,77,3948,42,84,955,5106,2022-05-12 16:47:18.114829
10502,76,4283,47,59,1016,5481,2022-05-12 16:47:21.735504
10507,2522,57509,1439,2525,6441,70436,2022-05-12 16:47:27.221506
10509,12,125,7,52,123,319,2022-05-12 16:47:30.546772
10513,50,2165,26,102,377,2720,2022-05-12 16:47:33.013523
10516,87,2749,41,58,1281,4216,2022-05-12 16:47:35.200619
10521,6900,188742,4081,2843,43555,246121,2022-05-12 16:47:38.502605
10524,64,512,33,131,534,1274,2022-05-12 16:47:41.030706
10526,68,906,41,130,586,1731,2022-05-12 16:47:43.858872
10528,79,1011,37,157,638,1922,2022-05-12 16:47:49.062464
10531,147,6774,116,136,2026,9199,2022-05-12 16:47:51.878638
10532,303,8812,193,171,4349,13828,2022-05-12 16:47:54.827825
10534,180,9263,64,183,927,10617,2022-05-12 16:47:56.582649
10536,1141,28760,847,381,13004,44133,2022-05-12 16:47:59.351369
10539,18,111,13,61,166,369,2022-05-12 16:48:01.134603
10540,52,184,43,94,577,950,2022-05-12 16:48:02.775227
10541,36,102,19,68,363,588,2022-05-12 16:48:04.415852
10545,94,2608,55,87,1075,3919,2022-05-12 16:48:06.556943
10549,86,2230,45,93,1157,3611,2022-05-12 16:48:11.646488
10562,59,317,34,114,333,857,2022-05-12 16:48:15.099531
10563,18,144,12,85,170,429,2022-05-12 16:48:16.983272
10564,26,126,12,49,157,370,2022-05-12 16:48:18.200099
10568,11446,111352,8596,9727,84233,225354,2022-05-12 16:48:21.973141
10573,230,7050,152,141,2405,9978,2022-05-12 16:48:27.906027
10578,8317,101311,6612,11455,39943,167638,2022-05-12 16:48:28.843543
10582,812,26909,360,298,6665,35044,2022-05-12 16:48:32.577688
10584,21,832,12,42,218,1125,2022-05-12 16:48:35.171472
10586,7,594,7,32,74,714,2022-05-12 16:48:37.029452
10588,14358,143480,11532,12600,63366,245336,2022-05-12 16:48:38.295077
10589,1844,188044,820,531,17880,209119,2022-05-12 16:48:38.466952
10594,26,261,12,69,243,611,2022-05-12 16:48:41.36694
10595,77,242,60,90,1630,2099,2022-05-12 16:48:44.335598
10603,14,82,3,38,174,311,2022-05-12 16:48:46.551691
10604,850,42890,424,304,9618,54086,2022-05-12 16:48:47.000866
10611,4543,48936,2852,5452,24295,86078,2022-05-12 16:48:54.765742
10620,78631,1353279,46181,67787,277681,1823559,2022-05-12 16:48:55.109492
10622,535,22932,377,220,8826,32890,2022-05-12 16:48:56.713031
10623,39,206,36,83,494,858,2022-05-12 16:48:59.182899
10627,14,285,9,50,122,480,2022-05-12 16:49:04.206762
10628,292,5250,191,142,3367,9242,2022-05-12 16:49:09.439231
10629,141,2625,77,85,2879,5807,2022-05-12 16:49:11.621811
10633,18,93,12,72,104,299,2022-05-12 16:49:12.68677
10647,2193,55644,1596,985,22411,82829,2022-05-12 16:49:18.055535
10648,22,159,12,47,297,537,2022-05-12 16:49:19.344238
10659,534,39730,391,284,7383,48322,2022-05-12 16:49:21.095576
10666,36,1930,17,46,376,2405,2022-05-12 16:49:23.605631
10671,956,13107,622,1077,7049,22811,2022-05-12 16:49:26.051208
10679,70,2585,58,97,1217,4027,2022-05-12 16:49:28.459552
10684,13,127,7,70,102,319,2022-05-12 16:49:32.87616
10685,11,106,8,72,107,304,2022-05-12 16:49:34.037221
10686,673,60422,384,277,8141,69897,2022-05-12 16:49:34.276241
10687,319,20459,142,216,4505,25641,2022-05-12 16:49:36.900335
10688,50,925,14,40,562,1591,2022-05-12 16:49:40.138405
10689,119,1655,90,126,2080,4070,2022-05-12 16:49:42.424266
10691,82,4565,24,38,789,5498,2022-05-12 16:49:44.861099
10701,31,321,13,55,190,610,2022-05-12 16:49:47.043123
10702,297,16819,125,142,3078,20461,2022-05-12 16:49:50.001915
10703,161,9447,121,134,2137,12000,2022-05-12 16:49:52.499023
10705,17,116,9,67,198,407,2022-05-12 16:49:54.003741
10706,15,106,7,62,106,296,2022-05-12 16:49:55.219119
10711,5010,121830,1787,1362,54370,184359,2022-05-12 16:50:01.364995
10714,552,25766,289,167,7802,34576,2022-05-12 16:50:05.106695
10715,584,24820,300,177,7932,33813,2022-05-12 16:50:05.543067
10716,527,24059,291,160,7912,32949,2022-05-12 16:50:05.96492
10718,35,383,24,31,443,916,2022-05-12 16:50:08.74634
10719,25144,546962,12833,18461,137440,740840,2022-05-12 16:50:09.02759
10720,23,2043,9,28,364,2467,2022-05-12 16:50:12.715983
10721,17384,114800,14112,11960,119227,277483,2022-05-12 16:50:13.141599
10731,181,7438,104,137,2415,10275,2022-05-12 16:50:16.902289
10732,67,1776,60,63,1107,3073,2022-05-12 16:50:19.046401
10737,638,13206,582,410,3848,18684,2022-05-12 16:50:28.309432
10740,239,37506,234,237,4195,42411,2022-05-12 16:50:29.278183
10741,17,103,11,47,213,391,2022-05-12 16:50:31.994046
10742,26,500,24,110,202,862,2022-05-12 16:50:34.181815
10751,43,422,14,52,388,919,2022-05-12 16:50:38.641876
10756,18,127,28,122,130,425,2022-05-12 16:50:40.458048
10757,32,291,30,130,179,662,2022-05-12 16:50:42.506583
10759,18,135,22,115,113,403,2022-05-12 16:50:45.663866
10760,19,214,21,114,135,503,2022-05-12 16:50:46.918463
10763,23,295,11,63,185,577,2022-05-12 16:50:48.254788
10766,116,3445,86,133,1469,5249,2022-05-12 16:50:50.942687
10775,152,2297,123,127,2515,5214,2022-05-12 16:50:55.905536
10780,41,706,22,60,399,1228,2022-05-12 16:50:57.699156
10790,10437,284026,6240,6086,49650,356439,2022-05-12 16:51:00.297282
10793,53436,719108,37065,58411,247029,1115049,2022-05-12 16:51:00.543403
39541,4,59,0,20,42,125,2022-05-12 21:00:06.853257
10794,1830,95550,704,620,14842,113546,2022-05-12 16:51:00.895373
10796,172,2725,133,118,1078,4226,2022-05-12 16:51:03.773428
10798,6344,69464,5024,6182,54396,141410,2022-05-12 16:51:09.451595
10799,42,3952,25,36,532,4587,2022-05-12 16:51:12.230899
10800,25003,196908,19234,15345,156888,413378,2022-05-12 16:51:12.639383
10801,456,4315,316,671,2248,8006,2022-05-12 16:51:16.021811
10802,32,239,19,80,248,618,2022-05-12 16:51:18.624211
39626,1,5,2,37,26,71,2022-05-12 21:01:49.700232
10805,1147,82962,621,393,14907,100030,2022-05-12 16:51:24.005836
10807,754,6957,1051,620,9273,18655,2022-05-12 16:51:27.429621
10808,2227,15612,1737,3039,6800,29415,2022-05-12 16:51:32.590872
10810,162,6111,77,173,737,7260,2022-05-12 16:51:35.599577
10812,12,203,9,48,142,414,2022-05-12 16:51:38.238853
10813,17,664,20,76,282,1059,2022-05-12 16:51:40.155185
10815,26,145,10,93,196,470,2022-05-12 16:51:41.24908
10819,93,2316,83,84,1546,4122,2022-05-12 16:51:43.72498
10821,97,2989,87,132,1884,5189,2022-05-12 16:51:46.922154
10822,88,2191,96,111,1580,4066,2022-05-12 16:51:49.064045
10823,77,1752,75,95,1281,3280,2022-05-12 16:51:50.762742
10824,78,1940,75,99,1349,3541,2022-05-12 16:51:51.96086
10825,102,2467,91,107,1628,4395,2022-05-12 16:51:54.243788
10834,752,22853,550,424,9936,34515,2022-05-12 16:51:59.503201
10838,512,5987,396,1186,3382,11463,2022-05-12 16:52:01.653001
10842,473,11032,543,415,9549,22012,2022-05-12 16:52:02.51943
10845,677,8185,329,275,4459,13925,2022-05-12 16:52:06.510265
10847,34,217,21,66,375,713,2022-05-12 16:52:08.121832
10849,116,4205,77,96,1836,6330,2022-05-12 16:52:10.594782
10850,16,83,10,63,88,260,2022-05-12 16:52:12.345551
10852,20,164,9,41,189,423,2022-05-12 16:52:13.837741
10856,16,79,8,62,99,264,2022-05-12 16:52:16.620414
10859,60,1266,16,41,488,1871,2022-05-12 16:52:18.136334
10862,132,3174,113,137,1732,5288,2022-05-12 16:52:18.323799
10863,4634,337817,1697,833,52740,397721,2022-05-12 16:52:20.827697
10869,118,1737,108,234,628,2825,2022-05-12 16:52:23.996038
10882,116,180,57,74,1560,1987,2022-05-12 16:52:26.927454
10884,1895,19202,1174,1288,10628,34187,2022-05-12 16:52:30.25311
10889,27,121,20,90,187,445,2022-05-12 16:52:34.477315
10893,1100,25795,508,373,15917,43693,2022-05-12 16:52:36.941907
10897,1486,97393,744,480,16466,116569,2022-05-12 16:52:37.270031
10901,20,282,22,64,349,737,2022-05-12 16:52:38.807742
10904,37,422,25,101,468,1053,2022-05-12 16:52:41.850497
10908,26,310,25,74,339,774,2022-05-12 16:52:43.812156
10916,105,6896,100,137,1725,8963,2022-05-12 16:52:48.903439
10917,126,6774,123,156,1789,8968,2022-05-12 16:52:51.306038
10918,362,8190,190,119,6027,14888,2022-05-12 16:52:54.279888
10920,417,7174,293,281,5023,13188,2022-05-12 16:52:56.478638
10923,138,4711,87,92,1792,6820,2022-05-12 16:52:58.881778
10928,894,26159,584,375,7037,35049,2022-05-12 16:53:02.266811
10935,179,5631,139,109,3187,9245,2022-05-12 16:53:11.503073
10936,118,2052,74,64,1384,3692,2022-05-12 16:53:13.59092
10937,9052,25889,3021,965,23675,62602,2022-05-12 16:53:16.157128
10943,23,114,6,55,169,367,2022-05-12 16:53:17.931459
10950,136,2077,146,163,2673,5195,2022-05-12 16:53:26.23499
10953,12,67,8,57,74,218,2022-05-12 16:53:27.412615
10954,58,1344,30,45,669,2146,2022-05-12 16:53:29.223664
10958,278,4732,150,407,2301,7868,2022-05-12 16:53:31.366822
10964,40,263,18,52,351,724,2022-05-12 16:53:32.846466
10965,25,133,18,81,147,404,2022-05-12 16:53:33.942608
10979,25,1396,13,71,403,1908,2022-05-12 16:53:35.422079
10989,15,112,8,56,155,346,2022-05-12 16:53:38.06792
10995,21,52,12,83,132,300,2022-05-12 16:53:39.288315
10997,28,110,12,63,151,364,2022-05-12 16:53:40.41213
10999,237,12130,118,164,2021,14670,2022-05-12 16:53:43.039267
11001,735,10470,328,267,10510,22310,2022-05-12 16:53:43.473249
11013,21965,289177,15353,18562,118603,463660,2022-05-12 16:53:49.328048
11017,113,781,64,168,796,1922,2022-05-12 16:53:51.262967
11019,108,7267,148,216,2339,10078,2022-05-12 16:53:54.088004
11021,5711,47159,3441,5468,27085,88864,2022-05-12 16:53:55.126313
11033,143,10981,74,123,1660,12981,2022-05-12 16:53:57.586627
11043,27,305,13,39,338,722,2022-05-12 16:53:59.916972
11053,50,4134,35,102,595,4916,2022-05-12 16:54:03.790392
11099,155,5838,85,100,2960,9138,2022-05-12 16:54:26.140512
11061,305670,1558855,116697,47803,320470,2349495,2022-05-12 16:54:04.149851
11069,82,3813,97,135,1702,5829,2022-05-12 16:54:07.22353
11077,2963,53357,1419,583,28282,86604,2022-05-12 16:54:10.777859
11079,6783,53403,5575,9616,35241,110618,2022-05-12 16:54:14.016637
11087,34,479,23,72,267,875,2022-05-12 16:54:17.704602
11093,31,344,16,52,311,754,2022-05-12 16:54:19.023873
11095,14,108,3,58,102,285,2022-05-12 16:54:21.696617
11097,13,130,6,69,116,334,2022-05-12 16:54:23.308294
11101,37,300,17,62,321,737,2022-05-12 16:54:27.58799
11103,649,7065,498,641,3686,12539,2022-05-12 16:54:29.606049
11111,48995,1119593,28264,36099,256020,1488971,2022-05-12 16:54:29.856019
11123,3973,123625,1661,1897,14074,145230,2022-05-12 16:54:30.66129
11161,499,22307,270,176,5092,28344,2022-05-12 16:54:33.721791
11189,18,827,10,33,214,1102,2022-05-12 16:54:44.976342
11197,14,76,8,60,100,258,2022-05-12 16:54:47.896594
39627,2,7,3,30,23,65,2022-05-12 21:01:52.162586
11203,20,107,15,67,117,326,2022-05-12 16:54:49.385971
11209,2759,38812,1012,699,11671,54953,2022-05-12 16:54:51.715096
11221,57,496,31,51,1012,1647,2022-05-12 16:54:54.641432
11227,3658,28332,2527,3793,28285,66595,2022-05-12 16:54:57.849262
11241,6983,88428,4671,7584,32649,140315,2022-05-12 16:55:10.371058
11245,35,129,24,72,216,476,2022-05-12 16:55:12.001566
11255,580,8994,326,234,6887,17021,2022-05-12 16:55:15.384745
11266,1877,99061,918,494,22844,125194,2022-05-12 16:55:15.805019
11268,57,337,84,136,351,965,2022-05-12 16:55:17.861458
11269,28,360,13,54,274,729,2022-05-12 16:55:19.70846
11275,32,221,24,122,310,709,2022-05-12 16:55:21.772321
11285,11265,214175,9233,14709,81091,330473,2022-05-12 16:55:23.800069
11299,65,966,32,65,598,1726,2022-05-12 16:55:26.92334
11313,1572,24602,781,614,12975,40544,2022-05-12 16:55:29.13948
11319,9768,311436,5461,6011,49959,382635,2022-05-12 16:55:29.547524
39628,8,38,11,52,93,202,2022-05-12 21:01:53.419333
11339,457,15775,284,188,4628,21332,2022-05-12 16:55:30.662952
11341,809,9883,708,658,5368,17426,2022-05-12 16:55:34.188729
11357,33,516,11,60,297,917,2022-05-12 16:55:37.701804
11359,501,36769,271,297,5157,42995,2022-05-12 16:55:37.983054
11371,2139,40237,1383,1425,11405,56589,2022-05-12 16:55:38.411871
11375,316,10222,244,281,6168,17231,2022-05-12 16:55:38.585111
11447,39,1209,12,61,495,1816,2022-05-12 16:55:42.913667
11471,99,2384,71,151,1448,4153,2022-05-12 16:55:49.084888
11483,194,6216,71,105,2561,9147,2022-05-12 16:55:51.569749
11487,68,5562,31,39,748,6448,2022-05-12 16:55:55.70205
11491,2198,31798,1175,2457,13448,51076,2022-05-12 16:55:59.165674
11499,24268,371138,13877,15338,128317,552938,2022-05-12 16:56:04.469842
11511,23,1094,11,40,203,1371,2022-05-12 16:56:11.540135
11525,25,91,12,68,162,358,2022-05-12 16:56:13.606961
11531,614,25432,334,227,9221,35828,2022-05-12 16:56:17.881429
11533,30,160,19,77,248,534,2022-05-12 16:56:20.9359
11537,29,607,8,53,246,943,2022-05-12 16:56:22.734289
11541,87,173,130,200,422,1012,2022-05-12 16:56:24.47166
11547,494,949,435,574,2754,5206,2022-05-12 16:56:30.910886
11553,2038,137202,992,675,23566,164473,2022-05-12 16:56:31.364001
11561,26,613,9,41,340,1029,2022-05-12 16:56:34.25666
11577,8253,404192,3021,1209,113182,529857,2022-05-12 16:56:37.018609
11579,21,712,7,33,150,923,2022-05-12 16:56:39.450762
11583,159,7113,112,152,1961,9497,2022-05-12 16:56:42.688404
11589,24,109,13,52,217,415,2022-05-12 16:56:45.822072
11593,14,83,6,78,131,312,2022-05-12 16:56:47.759182
11595,141,2066,187,422,327,3143,2022-05-12 16:56:50.840341
11597,24755,499246,11993,6820,130795,673609,2022-05-12 16:56:51.277842
11609,31,99,13,58,199,400,2022-05-12 16:56:52.495052
11611,17,106,7,40,110,280,2022-05-12 16:56:54.673233
11617,44331,1019832,19347,44930,127987,1256427,2022-05-12 16:56:55.466573
11625,9,99,6,57,112,283,2022-05-12 16:56:59.063279
11633,26685,437237,17020,21914,124391,627247,2022-05-12 16:56:59.235176
11659,41,751,37,75,604,1508,2022-05-12 16:57:06.492718
11661,78,1068,19,76,689,1930,2022-05-12 16:57:08.360287
11665,8242,129727,3945,2132,77837,221883,2022-05-12 16:57:09.401113
11679,44,5626,13,77,677,6437,2022-05-12 16:57:15.065704
11681,13,43,5,54,86,201,2022-05-12 16:57:16.216921
11689,15,2135,5,62,168,2385,2022-05-12 16:57:20.76173
11693,22,397,6,56,219,700,2022-05-12 16:57:25.773402
11695,25,183,16,90,218,532,2022-05-12 16:57:27.123447
11699,73,1737,38,56,708,2612,2022-05-12 16:57:30.074287
11701,1534,150760,897,501,22740,176432,2022-05-12 16:57:30.277413
11703,14920,193228,9450,17271,67990,302859,2022-05-12 16:57:33.021556
11705,173,5637,107,176,3185,9278,2022-05-12 16:57:33.271649
11711,9,42,4,50,57,162,2022-05-12 16:57:34.385398
11713,9,43,4,52,81,189,2022-05-12 16:57:35.32551
11715,263,3899,254,187,1950,6553,2022-05-12 16:57:37.420911
11717,29,1497,18,39,425,2008,2022-05-12 16:57:39.991407
11729,26,724,4,35,153,942,2022-05-12 16:57:41.315092
11733,20,79,11,80,129,319,2022-05-12 16:57:42.870667
11735,51,1299,31,42,609,2032,2022-05-12 16:57:44.612722
11737,3318,193423,1679,803,49493,248716,2022-05-12 16:57:47.43765
11739,2872,52208,1926,1292,23891,82189,2022-05-12 16:57:47.79585
11741,26643,803154,10215,5832,151645,997489,2022-05-12 16:57:48.202102
11743,2261,86318,1136,556,30316,120587,2022-05-12 16:57:49.736399
11755,541,8553,251,332,8012,17689,2022-05-12 16:57:50.607238
11763,3439,18678,1960,5851,21041,50969,2022-05-12 16:57:54.97066
11767,36,152,20,42,642,892,2022-05-12 16:57:58.652793
11769,1457,14979,793,1588,10725,29542,2022-05-12 16:58:02.431372
11771,58696,786408,31259,28482,146106,1050951,2022-05-12 16:58:02.776873
11773,215,1896,149,122,1853,4235,2022-05-12 16:58:06.706644
11783,3660,71525,2745,3326,16404,97660,2022-05-12 16:58:10.564557
11785,18283,180100,11614,16092,101809,327898,2022-05-12 16:58:10.906343
11787,95,1311,82,113,1451,3052,2022-05-12 16:58:13.535471
11789,11,270,6,48,135,470,2022-05-12 16:58:14.784606
11793,143,5327,156,95,2766,8487,2022-05-12 16:58:19.053426
11795,21,971,6,33,175,1206,2022-05-12 16:58:20.725804
11799,31,863,10,52,399,1355,2022-05-12 16:58:22.262267
11809,284,2212,264,500,1697,4957,2022-05-12 16:58:25.867376
11813,5631,33059,2110,980,11022,52802,2022-05-12 16:58:28.291443
11829,48,364,21,79,249,761,2022-05-12 16:58:30.612404
11835,75,421,42,100,600,1238,2022-05-12 16:58:32.441302
11837,6484,73148,3616,7019,34900,125167,2022-05-12 16:58:32.842019
11841,65,469,31,98,490,1153,2022-05-12 16:58:34.310692
11843,45267,438557,31336,20241,190867,726268,2022-05-12 16:58:34.48508
11853,78,3088,92,129,1719,5106,2022-05-12 16:58:37.3399
11859,2192,17444,1199,1842,16132,38809,2022-05-12 16:58:40.442654
11869,30,2399,12,62,371,2874,2022-05-12 16:58:43.790429
11883,11,2061,5,51,137,2265,2022-05-12 16:58:46.671397
11887,32875,472262,20518,19977,215574,761206,2022-05-12 16:58:46.942446
11889,339,15206,216,159,5688,21608,2022-05-12 16:58:50.977882
11915,25,2095,12,68,248,2448,2022-05-12 16:58:59.876978
11917,642,26429,261,355,5938,33625,2022-05-12 16:59:02.565041
11919,36,563,19,111,335,1064,2022-05-12 16:59:05.648087
11977,2618,131865,1459,1014,44847,181803,2022-05-12 16:59:11.442036
11979,2656,131948,1360,995,47441,184400,2022-05-12 16:59:11.901394
11981,5231,255931,2338,1246,71287,336033,2022-05-12 16:59:12.29202
11995,51,264,16,59,558,948,2022-05-12 16:59:14.056721
12001,386,13253,358,380,6706,21083,2022-05-12 16:59:14.494714
12015,361,14495,187,156,8198,23397,2022-05-12 16:59:18.84656
12017,538,16005,237,189,11204,28173,2022-05-12 16:59:19.28406
12027,28,278,24,96,482,908,2022-05-12 16:59:23.589105
12029,6643,40333,3825,2103,51668,104572,2022-05-12 16:59:24.026683
12031,11208,68756,5374,8017,79822,173177,2022-05-12 16:59:24.182924
12035,184,2676,82,94,3195,6231,2022-05-12 16:59:27.174819
12039,37,164,24,96,447,768,2022-05-12 16:59:29.463026
12049,2535,165469,1048,721,25876,195649,2022-05-12 16:59:32.156375
12053,577,21890,338,181,10338,33324,2022-05-12 16:59:35.203683
12065,432,5228,217,188,3512,9577,2022-05-12 16:59:37.629161
12069,732,38548,246,271,5971,45768,2022-05-12 16:59:41.511988
12079,1269,49884,694,899,12144,64890,2022-05-12 16:59:44.617756
12101,78,1794,34,89,1045,3040,2022-05-12 16:59:47.290091
12113,2452,157718,800,620,22115,183705,2022-05-12 16:59:47.697774
12115,3152,160714,921,748,27294,192829,2022-05-12 16:59:48.119721
12117,428,33821,203,249,3821,38522,2022-05-12 16:59:51.511779
12119,2177,17031,1601,2758,17390,40957,2022-05-12 16:59:54.423788
12121,85,3244,43,111,787,4270,2022-05-12 16:59:56.512623
12131,240,2966,168,192,2499,6065,2022-05-12 16:59:59.170626
12135,22,604,13,37,286,962,2022-05-12 17:00:03.514689
12137,238,9385,99,150,4124,13996,2022-05-12 17:00:06.37673
12141,29,583,19,48,476,1155,2022-05-12 17:00:11.275809
12163,25,247,41,62,523,898,2022-05-12 17:00:19.361648
12175,12169,121711,6165,7672,76919,224636,2022-05-12 17:00:22.736429
12185,12,62,8,55,84,221,2022-05-12 17:00:25.853317
12187,638,35982,383,199,7535,44737,2022-05-12 17:00:28.54099
12189,90289,652157,64971,49817,348485,1205719,2022-05-12 17:00:28.853488
12191,2929,21022,2172,3006,7763,36892,2022-05-12 17:00:32.30839
12221,108,3395,67,110,1423,5103,2022-05-12 17:00:34.928194
12223,108,1460,88,81,2128,3865,2022-05-12 17:00:37.59332
12243,28,143,19,71,336,597,2022-05-12 17:00:46.113775
12255,350,27969,237,193,4512,33261,2022-05-12 17:00:48.881376
12267,66,380,53,102,1080,1681,2022-05-12 17:00:51.853731
12281,1098,15985,1021,988,8026,27118,2022-05-12 17:00:55.033202
12291,14152,173607,10175,12136,82563,292633,2022-05-12 17:00:58.766237
12293,15040,259071,8020,13638,59661,355430,2022-05-12 17:00:59.172486
12295,20,770,11,63,245,1109,2022-05-12 17:01:02.448129
12337,38,332,15,83,403,871,2022-05-12 17:01:09.952594
12341,13,170,8,50,114,355,2022-05-12 17:01:11.329969
12343,106,2006,86,69,1322,3589,2022-05-12 17:01:15.136685
12351,31,553,24,38,391,1037,2022-05-12 17:01:19.032862
12355,13387,527208,4095,1536,182398,728624,2022-05-12 17:01:19.235987
12359,16,190,21,82,126,435,2022-05-12 17:01:21.857158
12361,48,597,26,136,344,1151,2022-05-12 17:01:24.169869
12365,9552,225670,5300,3145,61289,304956,2022-05-12 17:01:24.600923
12367,2624,19599,1748,3545,13551,41067,2022-05-12 17:01:27.140825
12371,7,137,4,46,95,289,2022-05-12 17:01:29.396092
12391,18,97,15,72,159,361,2022-05-12 17:01:31.244955
12393,46,577,19,139,183,964,2022-05-12 17:01:33.168798
12399,23,221,9,40,276,569,2022-05-12 17:01:35.387081
12401,39,309,11,42,409,810,2022-05-12 17:01:36.79764
12403,5925,122733,3532,2753,34627,169570,2022-05-12 17:01:37.112682
12419,741,24836,484,461,10125,36647,2022-05-12 17:01:41.591236
12429,151,3962,109,147,1884,6253,2022-05-12 17:01:45.462138
12431,18117,42390,14251,7692,92074,174524,2022-05-12 17:01:45.902367
12433,101,3099,61,54,1445,4760,2022-05-12 17:01:48.450894
12437,289,8026,126,102,3967,12510,2022-05-12 17:01:52.895505
12439,35,318,7,68,397,825,2022-05-12 17:01:54.962195
12445,17955,208173,10557,9701,118152,364538,2022-05-12 17:01:57.108182
39938,0,2,0,0,8502,8504,2022-05-12 21:06:04.128386
12449,918,20385,511,539,7360,29713,2022-05-12 17:02:04.61368
12455,174,5203,158,130,3115,8780,2022-05-12 17:02:09.679522
12461,5623,57346,3779,7341,30896,104985,2022-05-12 17:02:09.882647
12467,13600,153346,8152,14841,74958,264897,2022-05-12 17:02:12.723568
12471,5145,49094,4276,5487,26746,90748,2022-05-12 17:02:15.890551
12477,6491,154999,2328,808,95047,259673,2022-05-12 17:02:16.374959
12481,63,1049,38,69,435,1654,2022-05-12 17:02:19.748829
40054,1,0,0,0,17322,17323,2022-05-12 21:07:58.476016
40055,0,0,0,0,3828,3828,2022-05-12 21:08:02.450595
12485,30,668,15,53,310,1076,2022-05-12 17:02:21.900187
12487,3560,47952,2416,2008,21882,77818,2022-05-12 17:02:24.364221
12499,61,3481,34,92,572,4240,2022-05-12 17:02:29.863062
12501,168,4773,74,112,1826,6953,2022-05-12 17:02:32.109691
12521,17,443,2,23,109,594,2022-05-12 17:02:38.1559
12531,14327,183681,9005,6195,127880,341088,2022-05-12 17:02:38.783
12549,18464,259482,10484,20532,71895,380857,2022-05-12 17:02:42.828599
40814,801,7550,386,107,16475,25319,2022-05-12 21:18:48.608912
12565,1945,73131,854,473,27282,103685,2022-05-12 17:02:49.93507
12569,31,302,6,41,293,673,2022-05-12 17:02:52.829313
12579,302,3127,187,174,2820,6610,2022-05-12 17:02:55.662536
12581,1527,36439,550,535,10262,49313,2022-05-12 17:02:55.995066
12585,150,4159,79,136,1338,5862,2022-05-12 17:02:56.405885
12589,32,310,14,101,250,707,2022-05-12 17:02:57.804843
12591,44,906,41,75,812,1878,2022-05-12 17:03:00.853086
12599,40,1250,19,47,304,1660,2022-05-12 17:03:02.797525
12603,38,791,6,63,217,1115,2022-05-12 17:03:04.461357
12611,1989,6446,1768,3655,9409,23267,2022-05-12 17:03:07.057758
12623,28,2188,14,29,306,2565,2022-05-12 17:03:10.743053
12637,151,10725,73,124,1865,12938,2022-05-12 17:03:13.431067
12651,315,3390,247,298,1378,5628,2022-05-12 17:03:18.95142
12657,26,230,9,58,248,571,2022-05-12 17:03:20.436824
12665,384,16274,252,185,6829,23924,2022-05-12 17:03:28.129993
12673,510,31192,275,140,5938,38055,2022-05-12 17:03:34.513953
12677,721,7754,648,1349,4111,14583,2022-05-12 17:03:37.294198
12685,863,50250,627,773,14589,67102,2022-05-12 17:03:45.238502
12689,52,524,27,41,535,1179,2022-05-12 17:03:47.643372
12695,859,35624,280,325,8760,45848,2022-05-12 17:03:47.893373
12709,209,3256,168,102,2282,6017,2022-05-12 17:03:53.223292
12711,4873,75982,3186,4270,17739,106050,2022-05-12 17:03:56.46776
12725,244,5886,116,166,3264,9676,2022-05-12 17:03:57.095576
12727,88,2288,74,76,1025,3551,2022-05-12 17:04:00.153584
12729,15006,211388,3346,1954,25260,256954,2022-05-12 17:04:03.340474
12745,81,889,35,73,1014,2092,2022-05-12 17:04:06.169166
12753,2402,28360,2213,2042,11034,46051,2022-05-12 17:04:08.935357
12755,40,1192,14,37,381,1664,2022-05-12 17:04:10.979193
12759,15,87,2,57,91,252,2022-05-12 17:04:12.298622
12763,32,208,49,163,340,792,2022-05-12 17:04:15.332525
12767,30,159,30,117,172,508,2022-05-12 17:04:17.825175
12771,18,126,9,73,144,370,2022-05-12 17:04:19.927832
12783,1643,55664,876,647,29068,87898,2022-05-12 17:04:25.08364
12793,13,105,7,65,97,287,2022-05-12 17:04:29.520325
12795,56,358,23,70,651,1158,2022-05-12 17:04:31.355971
12799,25,94,13,65,330,527,2022-05-12 17:04:32.969849
12809,19,72,11,71,138,311,2022-05-12 17:04:38.067284
12815,10475,16433,10108,8270,40570,85856,2022-05-12 17:04:39.179099
12823,358,11515,317,270,6422,18882,2022-05-12 17:04:41.696346
12835,26,120,9,100,152,407,2022-05-12 17:04:44.138498
12859,3553,203057,826,567,20437,228440,2022-05-12 17:04:46.838997
12861,15,98,6,55,109,283,2022-05-12 17:04:48.24216
12863,480,4360,415,576,2352,8183,2022-05-12 17:04:50.850534
12867,174,2357,82,54,2404,5071,2022-05-12 17:04:53.839306
12875,1820,12570,1250,1502,7180,24322,2022-05-12 17:04:58.190359
12879,298,15030,202,116,5008,20654,2022-05-12 17:05:06.338525
12883,8509,68171,7205,7255,67656,158796,2022-05-12 17:05:11.278394
12885,40,689,26,60,373,1188,2022-05-12 17:05:13.177475
12887,28,144,33,122,194,521,2022-05-12 17:05:14.531754
12893,2975,96408,1676,864,22273,124196,2022-05-12 17:05:15.536049
12903,23,107,4,58,208,400,2022-05-12 17:05:21.139277
12905,38,456,28,40,509,1071,2022-05-12 17:05:23.1508
12907,132,2395,52,105,857,3541,2022-05-12 17:05:25.859019
12917,103,1935,29,111,1509,3687,2022-05-12 17:05:28.274996
12929,4674,20194,3105,7811,9530,45314,2022-05-12 17:05:32.793255
12935,26,1922,24,32,291,2295,2022-05-12 17:05:35.315806
12951,70,288,37,105,686,1186,2022-05-12 17:05:37.371743
12965,54,451,32,82,735,1354,2022-05-12 17:05:41.255391
12967,9308,119373,7240,16832,39762,192515,2022-05-12 17:05:44.63726
12971,22,227,9,42,243,543,2022-05-12 17:05:46.606973
12979,6829,48041,6631,9116,14670,85287,2022-05-12 17:05:46.946999
12981,34,96,23,41,544,738,2022-05-12 17:05:48.752098
12991,83,1158,67,82,1463,2853,2022-05-12 17:05:50.984591
13029,168,822,135,347,982,2454,2022-05-12 17:05:55.312228
13053,20,2638,22,45,266,2991,2022-05-12 17:06:00.523483
13055,2702,81432,1832,789,15428,102183,2022-05-12 17:06:00.992233
13083,11,375,5,40,115,546,2022-05-12 17:06:04.49062
13085,11,311,6,37,101,466,2022-05-12 17:06:05.590965
13087,10,294,8,40,102,454,2022-05-12 17:06:06.890019
13089,11,329,7,35,113,495,2022-05-12 17:06:08.291524
13091,8,206,10,40,69,333,2022-05-12 17:06:09.342374
13093,634,30009,345,216,7070,38274,2022-05-12 17:06:09.859886
13115,2560,30003,1759,1616,18235,54173,2022-05-12 17:06:14.676755
13117,773,13198,389,282,12054,26696,2022-05-12 17:06:17.77801
13119,560,10138,314,234,9087,20333,2022-05-12 17:06:18.180904
13125,48850,282814,33752,30794,313870,710080,2022-05-12 17:06:18.35278
13137,179,3340,142,125,2085,5871,2022-05-12 17:06:21.253288
13139,533,2639,506,1010,2311,6999,2022-05-12 17:06:24.044815
13141,447,3929,320,897,3599,9192,2022-05-12 17:06:27.346863
13145,998,17470,615,737,3159,22979,2022-05-12 17:06:30.818038
13159,1003,1737,891,1373,3676,8680,2022-05-12 17:06:34.600754
13161,15579,270896,6750,14014,68812,376051,2022-05-12 17:06:34.788252
13165,20,54,9,81,106,270,2022-05-12 17:06:38.435486
13167,17,86,8,78,129,318,2022-05-12 17:06:39.510553
13169,171,6030,86,75,2026,8388,2022-05-12 17:06:41.909286
13171,877,21064,331,113,11947,34332,2022-05-12 17:06:45.51202
13173,104,3501,59,60,1461,5185,2022-05-12 17:06:47.463002
13177,40,149,23,82,214,508,2022-05-12 17:06:49.387722
13179,26,110,15,73,152,376,2022-05-12 17:06:51.320687
13183,672,11797,467,451,10000,23387,2022-05-12 17:06:54.167263
13185,557,3559,409,703,2051,7279,2022-05-12 17:06:57.448992
13201,428,11692,390,535,2482,15527,2022-05-12 17:07:02.473319
13203,3709,25015,2547,1840,23179,56290,2022-05-12 17:07:05.868958
13207,26,178,13,102,149,468,2022-05-12 17:07:07.301649
13215,168,2476,102,104,2818,5668,2022-05-12 17:07:10.548206
13231,385,9291,311,869,2213,13069,2022-05-12 17:07:13.067152
13233,27,438,22,49,385,921,2022-05-12 17:07:15.964086
13239,133,5612,69,119,2450,8383,2022-05-12 17:07:18.70492
13247,85,1968,78,79,1370,3580,2022-05-12 17:07:23.961385
13249,89,1527,75,80,1556,3327,2022-05-12 17:07:26.249029
13251,99,2544,93,79,1195,4010,2022-05-12 17:07:26.663834
13253,53,3913,28,48,731,4773,2022-05-12 17:07:29.325426
13255,17,598,8,36,189,848,2022-05-12 17:07:30.923378
13259,68,4004,37,65,707,4881,2022-05-12 17:07:32.987262
13261,1847,40529,1024,1633,5251,50284,2022-05-12 17:07:36.509256
13267,1859,15125,1242,327,6598,25151,2022-05-12 17:07:40.23395
13271,2220,136319,1049,663,30191,170442,2022-05-12 17:07:40.502481
13281,31,2009,16,29,334,2419,2022-05-12 17:07:42.26784
13287,43,1438,36,47,582,2146,2022-05-12 17:07:47.658106
13303,77,298,45,99,1311,1830,2022-05-12 17:07:50.508089
13309,51,3613,28,58,517,4267,2022-05-12 17:07:54.572973
13311,10,537,4,38,94,683,2022-05-12 17:07:56.012017
13333,7946,66430,5195,6015,64860,150446,2022-05-12 17:07:57.485188
13335,892,15176,365,227,14738,31398,2022-05-12 17:08:00.546161
13357,3511,167912,1259,1046,16488,190216,2022-05-12 17:08:03.783149
13365,12,149,3,69,112,345,2022-05-12 17:08:06.21967
13367,9476,124778,4439,7256,49022,194971,2022-05-12 17:08:06.495417
13369,6,286,3,29,110,434,2022-05-12 17:08:07.892414
13373,53,3867,24,63,492,4499,2022-05-12 17:08:09.75857
13375,46,3598,25,57,432,4158,2022-05-12 17:08:11.469851
13391,2688,54006,956,903,33288,91841,2022-05-12 17:08:17.068895
13405,149,16894,39,208,1437,18727,2022-05-12 17:08:23.741527
13407,13,352,5,30,111,511,2022-05-12 17:08:25.228098
13409,1065,15438,885,899,5547,23834,2022-05-12 17:08:28.453271
13411,1257,73956,724,429,16327,92693,2022-05-12 17:08:31.508849
13421,12,488,4,28,114,646,2022-05-12 17:08:33.340568
13423,8,206,4,32,73,323,2022-05-12 17:08:35.314033
13427,132,2176,84,168,914,3474,2022-05-12 17:08:37.036261
13435,12,185,14,68,120,399,2022-05-12 17:08:43.620801
13439,66,687,39,83,958,1833,2022-05-12 17:08:46.362938
13441,24,862,15,43,319,1263,2022-05-12 17:08:48.174506
13449,22,154,14,59,169,418,2022-05-12 17:08:49.605988
13455,20,102,8,89,134,353,2022-05-12 17:08:51.030847
13457,43,42,11,114,103,313,2022-05-12 17:08:52.284009
13463,44,52,15,89,135,335,2022-05-12 17:08:54.313238
13465,12,73,8,69,130,292,2022-05-12 17:08:55.456985
13469,1659,144569,852,366,22199,169645,2022-05-12 17:08:55.880859
13479,94,1884,56,127,1627,3788,2022-05-12 17:08:58.231893
13495,24,1171,10,34,241,1480,2022-05-12 17:08:59.892441
13499,16,101,8,85,124,334,2022-05-12 17:09:03.775766
13501,9,80,11,53,81,234,2022-05-12 17:09:05.165465
13507,11,80,10,56,82,239,2022-05-12 17:09:09.790294
13509,11,71,11,72,82,247,2022-05-12 17:09:11.985377
13511,11,74,11,76,88,260,2022-05-12 17:09:13.506276
13515,23,296,10,40,200,569,2022-05-12 17:09:16.606278
13517,631,5890,280,225,6332,13358,2022-05-12 17:09:19.306669
13519,10,226,4,30,98,368,2022-05-12 17:09:20.609657
13535,9465,130315,6159,6737,62865,215541,2022-05-12 17:09:21.031532
13541,23,281,6,38,137,485,2022-05-12 17:09:22.656024
13561,675,12703,606,509,10410,24903,2022-05-12 17:09:28.508646
13563,118,1061,46,66,838,2129,2022-05-12 17:09:31.243419
13585,3975,37250,2910,3194,29281,76610,2022-05-12 17:09:32.704808
13599,8993,86374,7026,7268,59497,169158,2022-05-12 17:09:36.022829
13601,95760,840762,64567,45224,403258,1449571,2022-05-12 17:09:36.382184
13619,136,3514,112,99,2421,6282,2022-05-12 17:09:39.228961
13629,151,15625,62,93,2778,18709,2022-05-12 17:09:42.026098
13639,147,4700,65,53,2487,7452,2022-05-12 17:09:44.963816
13655,16713,117572,13435,15797,106850,270367,2022-05-12 17:09:45.135693
13667,3499,270529,1007,719,22373,298127,2022-05-12 17:09:52.128765
40838,0,0,0,0,0,0,2022-05-12 21:19:04.325036
13669,138,1633,66,103,1376,3316,2022-05-12 17:09:55.736514
13673,117,3418,46,59,1290,4930,2022-05-12 17:09:57.840561
13675,72,4312,31,41,843,5299,2022-05-12 17:10:00.33753
13677,578,21866,546,578,12276,35844,2022-05-12 17:10:02.755794
13681,71,680,54,58,752,1615,2022-05-12 17:10:10.389445
13709,1045,45232,451,485,12484,59697,2022-05-12 17:10:16.841419
13715,102,1587,38,85,636,2448,2022-05-12 17:10:19.014063
13731,208,5152,129,151,3523,9163,2022-05-12 17:10:24.326399
13755,39,955,20,33,690,1737,2022-05-12 17:10:26.152396
13757,332,5671,180,149,3190,9522,2022-05-12 17:10:28.68844
13759,56113,786368,32605,30747,221394,1127227,2022-05-12 17:10:30.747614
13781,19,123,6,50,149,347,2022-05-12 17:10:38.376056
13789,28,703,6,31,236,1004,2022-05-12 17:10:40.175977
13793,14,689,6,41,97,847,2022-05-12 17:10:41.947073
13795,21,534,3,31,122,711,2022-05-12 17:10:44.934462
13807,1969,101234,811,747,26093,130854,2022-05-12 17:10:47.870726
13817,24,122,15,70,230,461,2022-05-12 17:10:49.313554
13821,16,104,14,74,153,361,2022-05-12 17:10:51.905488
13825,40,98,14,62,119,333,2022-05-12 17:10:55.050634
13827,15,132,15,64,125,351,2022-05-12 17:10:56.103197
13833,507,17004,161,156,5303,23131,2022-05-12 17:11:00.096387
13835,65,3563,35,61,534,4258,2022-05-12 17:11:02.384647
13837,138,6227,110,154,2043,8672,2022-05-12 17:11:02.558579
13839,121,7951,95,129,1981,10277,2022-05-12 17:11:02.824205
13843,597,2544,446,355,3733,7675,2022-05-12 17:11:05.390141
13851,10510,87055,3781,1673,18879,121898,2022-05-12 17:11:08.213883
13855,382,4650,191,185,3449,8857,2022-05-12 17:11:11.082861
13857,14,289,8,20,115,446,2022-05-12 17:11:12.523161
13863,467,14937,275,279,9380,25338,2022-05-12 17:11:18.670764
13927,93,1202,52,65,1202,2614,2022-05-12 17:11:20.949414
13931,199,5066,166,164,3599,9194,2022-05-12 17:11:21.371272
13935,44,650,27,72,518,1311,2022-05-12 17:11:23.347886
13947,12,179,8,80,175,454,2022-05-12 17:11:26.784178
13965,23,315,20,69,346,773,2022-05-12 17:11:29.576096
13967,22,334,16,67,360,799,2022-05-12 17:11:30.957475
13971,32,2807,22,83,718,3662,2022-05-12 17:11:33.907003
13983,33,834,16,53,484,1420,2022-05-12 17:11:35.839296
14007,54,649,47,119,953,1822,2022-05-12 17:11:40.03723
14023,15,306,3,24,96,444,2022-05-12 17:11:41.266484
14039,32,96,23,45,641,837,2022-05-12 17:11:43.054842
14045,1336,16622,883,2043,9937,30821,2022-05-12 17:11:43.511953
14049,298,6983,158,173,3062,10674,2022-05-12 17:11:46.231684
14059,51,771,48,68,753,1691,2022-05-12 17:11:48.766437
14067,17,198,8,46,146,415,2022-05-12 17:11:50.042177
14069,11,135,4,43,81,274,2022-05-12 17:11:51.775004
14073,1492,10105,1167,2297,9099,24160,2022-05-12 17:11:54.949649
14075,31904,299695,22586,21583,176127,551895,2022-05-12 17:11:55.302387
14077,281,4251,259,275,5188,10254,2022-05-12 17:11:56.329931
14095,36,741,15,70,340,1202,2022-05-12 17:12:00.732592
14125,11,219,4,36,54,324,2022-05-12 17:12:07.535547
14145,600,8388,251,299,5028,14566,2022-05-12 17:12:11.569711
14175,2774,42703,1109,500,34771,81857,2022-05-12 17:12:14.837185
14189,1115,57472,521,242,13780,73130,2022-05-12 17:12:17.844192
14199,15364,164803,7862,13443,74117,275589,2022-05-12 17:12:18.172317
14213,27,191,24,127,229,598,2022-05-12 17:12:20.095402
14227,41203,706871,22973,21749,160887,953683,2022-05-12 17:12:20.550702
14235,15,196,7,37,97,352,2022-05-12 17:12:24.474
14237,2338,15958,1646,4199,11547,35688,2022-05-12 17:12:24.959086
14247,33,753,13,50,353,1202,2022-05-12 17:12:27.159149
14249,17,223,12,51,249,552,2022-05-12 17:12:28.757857
14267,411,7083,255,232,9784,17765,2022-05-12 17:12:33.651058
14277,1117,10976,820,1960,4686,19559,2022-05-12 17:12:36.653573
14283,3338,31439,2310,5795,20572,63454,2022-05-12 17:12:41.956782
14289,22010,424370,11059,16332,115496,589267,2022-05-12 17:12:42.380057
14293,2694,47441,1191,882,35513,87721,2022-05-12 17:12:45.927832
14317,120,5235,51,47,1292,6745,2022-05-12 17:12:49.430641
14333,655,1060,680,1225,2355,5975,2022-05-12 17:12:49.838837
14345,23855,581181,13066,21489,142887,782478,2022-05-12 17:12:49.998599
14349,5520,222583,2116,1765,60570,292554,2022-05-12 17:12:51.313876
14373,553,11579,224,187,7079,19622,2022-05-12 17:12:55.694932
14381,11,136,10,73,113,343,2022-05-12 17:12:58.898233
41750,0,0,0,0,5196,5196,2022-05-12 21:29:39.747399
41751,0,0,0,0,1,1,2022-05-12 21:29:41.201597
14397,8212,147884,5130,3146,48757,213129,2022-05-12 17:12:59.320201
14407,1975,72656,771,547,30153,106102,2022-05-12 17:13:02.797769
14467,32723,461914,20306,26359,157619,698921,2022-05-12 17:13:03.047768
14513,52597,635789,33658,27711,182787,932542,2022-05-12 17:13:07.34449
14515,5028,29923,4201,7856,31317,78325,2022-05-12 17:13:09.944855
14527,4294,92855,2529,2367,28683,130728,2022-05-12 17:13:13.378043
14529,21,199,5,64,155,444,2022-05-12 17:13:18.151784
41980,0,0,0,0,0,0,2022-05-12 21:31:36.931528
41991,0,0,0,0,0,0,2022-05-12 21:31:42.131302
41994,0,0,0,0,0,0,2022-05-12 21:31:44.286533
41997,0,0,0,0,0,0,2022-05-12 21:31:45.367689
14537,19,268,9,46,193,535,2022-05-12 17:13:19.998829
14563,387,1755,335,584,2219,5280,2022-05-12 17:13:23.361219
14575,1053,15811,385,186,6309,23744,2022-05-12 17:13:25.948817
14583,206,2673,163,106,2124,5272,2022-05-12 17:13:28.881472
14617,306,6256,165,136,4230,11093,2022-05-12 17:13:31.486197
14623,13,87,13,64,106,283,2022-05-12 17:13:32.851536
14627,204,10016,125,114,2268,12727,2022-05-12 17:13:35.339306
14631,11,102,6,66,135,320,2022-05-12 17:13:39.69812
14645,1982,34066,1385,1774,10576,49783,2022-05-12 17:13:42.342698
14653,1931,33491,1506,2184,12809,51921,2022-05-12 17:13:48.243238
14669,3201,41023,1162,613,39414,85413,2022-05-12 17:13:51.023881
14675,103,1311,74,89,1377,2954,2022-05-12 17:13:53.191139
14685,140,2781,113,100,1529,4663,2022-05-12 17:13:55.870582
14713,23329,391119,11438,10882,127156,563924,2022-05-12 17:14:00.842055
14719,106093,1048276,51687,38837,148359,1393252,2022-05-12 17:14:01.10768
14735,395,29332,193,235,4136,34291,2022-05-12 17:14:01.35768
14751,19042,60747,12490,15823,24924,133026,2022-05-12 17:14:02.22228
14827,1465,14723,838,1229,10241,28496,2022-05-12 17:14:07.691603
14829,11745,141042,7188,9851,80339,250165,2022-05-12 17:14:11.55726
14833,27798,253414,16669,19150,114345,431376,2022-05-12 17:14:12.61929
14837,1453,179657,394,346,7866,189716,2022-05-12 17:14:13.411874
14853,119,4815,57,56,1986,7033,2022-05-12 17:14:16.995096
14889,210,3067,96,94,1926,5393,2022-05-12 17:14:23.078993
14893,938,49307,446,337,9602,60630,2022-05-12 17:14:26.870829
14921,5845,56193,4507,8974,29319,104838,2022-05-12 17:14:32.326623
14935,71,3038,76,118,1251,4554,2022-05-12 17:14:34.941858
14941,1088,25401,784,897,6474,34644,2022-05-12 17:14:37.787488
14947,39,323,23,68,607,1060,2022-05-12 17:14:38.037563
14957,158,3889,171,199,3052,7469,2022-05-12 17:14:43.272216
15043,511,4240,328,493,4562,10134,2022-05-12 17:14:56.369546
14967,13258,398284,6686,6474,65062,489764,2022-05-12 17:14:43.726721
14989,562,1217,481,913,1925,5098,2022-05-12 17:14:46.641123
15005,2816,19460,1406,1377,16782,41841,2022-05-12 17:14:47.575156
15015,57,740,48,58,853,1756,2022-05-12 17:14:49.780291
15021,47,2076,18,52,628,2821,2022-05-12 17:14:51.814586
15037,8497,262266,4311,6343,61275,342692,2022-05-12 17:14:52.252514
15039,4835,175002,2818,1475,84398,268528,2022-05-12 17:14:53.819118
15051,19236,262280,10612,14414,107078,413620,2022-05-12 17:14:59.116323
15059,5321,86167,2227,1134,25264,120113,2022-05-12 17:14:59.573288
15061,5437,10374,3430,4185,15121,38547,2022-05-12 17:14:59.995133
15067,18,175,10,56,208,467,2022-05-12 17:15:03.526295
15077,68,3259,34,68,1085,4514,2022-05-12 17:15:06.520482
15085,10556,178172,7016,22985,56498,275227,2022-05-12 17:15:06.957906
15109,5791,43198,3916,7034,35379,95318,2022-05-12 17:15:13.293716
15111,21,54,8,54,104,241,2022-05-12 17:15:14.444258
15119,9081,47338,5101,9124,53886,124530,2022-05-12 17:15:19.322109
15125,2477,33296,1193,2059,22137,61162,2022-05-12 17:15:22.804778
15129,21,64,8,48,95,236,2022-05-12 17:15:25.122465
15133,2790,28031,1199,2784,12790,47594,2022-05-12 17:15:27.900604
15137,14,272,11,58,129,484,2022-05-12 17:15:31.193827
15141,17,156,4,48,201,426,2022-05-12 17:15:34.298094
15159,41,1005,25,48,722,1841,2022-05-12 17:15:36.566658
15195,2810,45629,1979,1734,15337,67489,2022-05-12 17:15:42.568224
15197,1864,92483,1060,615,29726,125748,2022-05-12 17:15:45.729073
15199,1471,70329,889,542,30761,103992,2022-05-12 17:15:46.149706
15211,52,93,22,70,312,549,2022-05-12 17:15:51.896179
15219,140,3879,126,168,2621,6934,2022-05-12 17:15:52.099303
15225,18746,285643,10643,13787,89967,418786,2022-05-12 17:15:52.414566
15227,4379,82392,1728,710,73166,162375,2022-05-12 17:15:52.808849
15313,475,6677,376,788,3019,11335,2022-05-12 17:15:56.878125
15315,20067,380973,10219,12508,109385,533152,2022-05-12 17:15:57.326851
15323,1127,52023,380,415,7126,61071,2022-05-12 17:15:57.572367
15325,570,18680,275,366,5222,25113,2022-05-12 17:15:58.722352
15335,4559,149179,1542,1456,52061,208797,2022-05-12 17:15:59.128601
15377,4668,55884,2826,3657,24916,91951,2022-05-12 17:15:59.849345
15407,463,1,232,178,8198,9072,2022-05-12 17:16:01.702895
16480,14,90,11,78,126,319,2022-05-12 17:21:54.245765
15411,380,14692,245,219,5752,21288,2022-05-12 17:16:06.389844
15417,9362,178697,3328,2389,83925,277701,2022-05-12 17:16:06.553384
15423,18,1123,7,35,132,1315,2022-05-12 17:16:12.199355
15431,102,5473,71,65,1428,7139,2022-05-12 17:16:14.303573
15437,1532,82768,725,410,14703,100138,2022-05-12 17:16:16.683866
15439,594,26770,206,316,7927,35813,2022-05-12 17:16:17.585199
15451,22808,720788,8881,11441,54711,818629,2022-05-12 17:16:17.741534
15453,82,2800,53,73,1265,4273,2022-05-12 17:16:20.575786
15479,30,109,18,63,171,391,2022-05-12 17:16:26.067751
15487,1408,50154,781,496,9201,62040,2022-05-12 17:16:26.458375
15505,125,1091,116,106,856,2294,2022-05-12 17:16:34.181732
15525,11,323,6,43,114,497,2022-05-12 17:16:36.109686
15533,46,501,18,51,301,917,2022-05-12 17:16:41.298177
15535,218,4750,84,80,1918,7050,2022-05-12 17:16:43.707822
15547,117,2015,89,175,619,3015,2022-05-12 17:16:48.407527
15577,20,462,11,53,210,756,2022-05-12 17:16:51.206349
15579,49,125,34,74,541,823,2022-05-12 17:16:53.1755
15583,34377,670056,16206,27487,159667,907793,2022-05-12 17:16:53.597129
15591,310,13998,213,130,5519,20170,2022-05-12 17:16:53.769004
15607,16,285,11,73,248,633,2022-05-12 17:17:05.283902
15609,849,33116,406,242,8455,43068,2022-05-12 17:17:08.997436
15613,5424,54993,3882,5385,37291,106975,2022-05-12 17:17:12.823149
15633,1264,19296,1337,672,8443,31012,2022-05-12 17:17:16.463251
15649,799,7174,592,671,3783,13019,2022-05-12 17:17:17.766702
15651,1669,17989,1409,1366,11715,34148,2022-05-12 17:17:21.170079
15657,10,96,7,50,86,249,2022-05-12 17:17:22.724002
15663,21,203,7,47,124,402,2022-05-12 17:17:24.012358
15687,2501,105126,1457,1133,21421,131638,2022-05-12 17:17:24.955382
15689,10430,398255,4145,2216,87704,502750,2022-05-12 17:17:27.912739
15699,6563,117326,3903,3967,36357,168116,2022-05-12 17:17:28.272076
15731,920,8522,693,604,8176,18915,2022-05-12 17:17:43.532613
15735,344,7123,178,248,4055,11948,2022-05-12 17:17:46.830684
15743,29,367,21,42,323,782,2022-05-12 17:17:48.4978
15751,4367,64956,2302,3241,35245,110111,2022-05-12 17:17:52.769595
15769,102,897,67,74,976,2116,2022-05-12 17:17:54.672552
15771,1732,51446,748,502,30849,85277,2022-05-12 17:17:55.07883
15775,3269,49787,1709,862,30827,86454,2022-05-12 17:17:56.050759
15781,108,2565,67,98,1391,4229,2022-05-12 17:17:58.199289
15785,204,9268,127,160,1980,11739,2022-05-12 17:17:58.839638
15787,37,138,22,95,405,697,2022-05-12 17:18:03.290487
15793,2669,34478,1502,1373,14565,54587,2022-05-12 17:18:04.271317
15795,146,432,93,285,530,1486,2022-05-12 17:18:06.221947
15809,51492,1060072,26083,20834,194380,1352861,2022-05-12 17:18:09.789824
15813,453,7487,221,143,8060,16364,2022-05-12 17:18:15.455573
15819,78,782,59,67,863,1849,2022-05-12 17:18:19.41568
15847,162,4998,86,122,2140,7508,2022-05-12 17:18:24.452501
15863,4033,26777,2525,4343,14756,52434,2022-05-12 17:18:25.385586
15865,26,158,20,94,267,565,2022-05-12 17:18:27.470013
15875,28,185,17,107,282,619,2022-05-12 17:18:30.695612
15879,1789,59039,1375,1130,15387,78720,2022-05-12 17:18:33.560613
15883,1595,11441,1358,3424,7995,25813,2022-05-12 17:18:38.77436
15891,115,3001,56,77,1200,4449,2022-05-12 17:18:39.211861
15893,77,882,67,71,642,1739,2022-05-12 17:18:42.271723
15895,714,18399,295,205,7710,27323,2022-05-12 17:18:44.896731
15897,22,70,10,65,129,296,2022-05-12 17:18:46.023552
15905,94,371,31,112,589,1197,2022-05-12 17:18:46.972796
15911,5593,45696,3485,3842,39941,98557,2022-05-12 17:18:49.494824
15913,17,175,22,75,159,448,2022-05-12 17:18:51.122329
15915,29,126,11,71,236,473,2022-05-12 17:18:51.434829
15925,64,4985,36,115,555,5755,2022-05-12 17:18:54.270592
15927,472,24734,282,163,5642,31293,2022-05-12 17:18:56.686292
15933,578,22974,195,271,7920,31938,2022-05-12 17:18:56.967541
15951,389,12391,280,212,4845,18117,2022-05-12 17:19:02.504322
15957,10,80,13,83,115,301,2022-05-12 17:19:03.648567
15959,693,15840,330,166,6273,23302,2022-05-12 17:19:06.241073
15961,108,453,45,93,848,1547,2022-05-12 17:19:09.459022
15963,480,14816,247,143,5785,21471,2022-05-12 17:19:12.388032
15971,10,60,7,36,139,252,2022-05-12 17:19:13.675739
15977,7,164,8,48,62,289,2022-05-12 17:19:14.718618
15979,127,2311,101,172,2436,5147,2022-05-12 17:19:17.191789
15989,437,9945,225,136,2742,13485,2022-05-12 17:19:19.64171
15993,32,807,19,71,432,1361,2022-05-12 17:19:21.618395
16001,4058,203345,2065,1376,32150,242994,2022-05-12 17:19:24.326426
16007,17,208,10,66,203,504,2022-05-12 17:19:29.192423
16009,11823,109108,9338,12660,64289,207218,2022-05-12 17:19:32.552882
16011,26624,264360,15487,19001,118793,444265,2022-05-12 17:19:32.974757
16023,392,5298,149,252,3784,9875,2022-05-12 17:19:37.801993
16027,78,231,47,71,651,1078,2022-05-12 17:19:41.21364
16035,11853,109701,9156,13082,58553,202345,2022-05-12 17:19:44.802742
16041,14,115,8,51,126,314,2022-05-12 17:19:46.239024
16049,16052,239567,8739,5533,81129,351020,2022-05-12 17:19:46.665756
16051,1690,23307,1116,1232,8439,35784,2022-05-12 17:19:50.61378
16067,33269,273685,24219,28284,191002,550459,2022-05-12 17:19:50.785656
16099,4240,56020,3692,5818,16228,85998,2022-05-12 17:19:51.583461
16101,161,3073,118,133,2371,5856,2022-05-12 17:19:54.792536
16123,1535,19230,798,759,10410,32732,2022-05-12 17:19:59.268513
16143,359,10454,233,261,4253,15560,2022-05-12 17:20:01.243324
16157,8333,70689,6086,8817,49933,143858,2022-05-12 17:20:06.516584
16159,23,142,17,94,205,481,2022-05-12 17:20:07.882091
16183,52,561,51,79,976,1719,2022-05-12 17:20:14.936311
16199,387,13949,253,250,3729,18568,2022-05-12 17:20:18.062258
16201,9922,77949,7365,16695,81461,193392,2022-05-12 17:20:18.234132
16233,15,1849,10,45,281,2200,2022-05-12 17:20:23.68708
16239,721,36827,379,272,6899,45098,2022-05-12 17:20:24.16808
16241,1264,25624,653,632,6767,34940,2022-05-12 17:20:27.10385
16247,34,463,15,51,368,931,2022-05-12 17:20:29.877699
16251,49,328,18,43,352,790,2022-05-12 17:20:31.785839
16253,17,71,3,61,99,251,2022-05-12 17:20:32.935555
16255,30,334,15,42,325,746,2022-05-12 17:20:34.42903
16257,24,105,13,55,255,452,2022-05-12 17:20:36.136468
16261,28,231,11,47,291,608,2022-05-12 17:20:38.221212
16263,14,86,9,54,226,389,2022-05-12 17:20:39.545777
16303,29,139,26,91,242,527,2022-05-12 17:20:43.682393
16331,149,6069,48,63,1679,8008,2022-05-12 17:20:46.995306
16335,208,5483,88,134,2041,7954,2022-05-12 17:20:50.351692
16345,38,354,15,45,300,752,2022-05-12 17:20:51.815688
16353,11420,87415,6942,7874,71323,184974,2022-05-12 17:20:55.134294
16355,5703,55639,4208,9056,29923,104529,2022-05-12 17:20:58.563503
16363,898,5011,424,368,5746,12447,2022-05-12 17:21:01.579005
16373,30,307,12,78,231,658,2022-05-12 17:21:06.499294
16377,23,200,18,77,230,548,2022-05-12 17:21:08.210319
16381,105,2662,63,77,1726,4633,2022-05-12 17:21:10.174257
16385,2686,44884,1754,2131,17426,68881,2022-05-12 17:21:13.021583
16389,32,303,21,65,236,657,2022-05-12 17:21:14.506368
16393,31,118,27,82,269,527,2022-05-12 17:21:16.521118
16395,367,15153,226,187,4443,20376,2022-05-12 17:21:19.756698
16397,7425,51081,3957,9459,40169,112091,2022-05-12 17:21:22.183222
16399,17,94,5,67,110,293,2022-05-12 17:21:23.93926
16405,787,10808,512,1718,4758,18583,2022-05-12 17:21:26.417853
16417,19436,191524,12860,12340,139444,375604,2022-05-12 17:21:31.271446
16434,145,1480,42,73,2035,3775,2022-05-12 17:21:35.989885
16436,216,12141,76,189,2454,15076,2022-05-12 17:21:39.865697
16442,96,2721,66,105,1253,4241,2022-05-12 17:21:42.511704
16444,1005,66828,508,241,11923,80505,2022-05-12 17:21:45.699743
16454,44,116,24,78,302,564,2022-05-12 17:21:47.562212
16458,23,143,6,63,210,445,2022-05-12 17:21:49.01795
16468,422,19754,299,203,4992,25670,2022-05-12 17:21:50.629465
16486,18,165,13,93,227,516,2022-05-12 17:21:56.70759
16490,17,100,7,63,119,306,2022-05-12 17:21:57.98275
16498,177910,2969225,45513,52661,154058,3399367,2022-05-12 17:21:58.295267
16508,163,2677,97,132,1393,4462,2022-05-12 17:22:02.294965
16518,3804,39743,2412,5094,15767,66820,2022-05-12 17:22:08.98549
16524,14100,211991,7836,8936,68249,311112,2022-05-12 17:22:09.314826
16526,20,91,14,78,161,364,2022-05-12 17:22:14.503775
42632,304,7199,143,86,3266,10998,2022-05-12 21:37:49.936136
16528,2702,85449,1171,659,42210,132191,2022-05-12 17:22:18.393962
16552,14,70,6,54,117,261,2022-05-12 17:22:21.075241
16554,9,86,8,49,94,246,2022-05-12 17:22:22.511756
16558,10,106,5,45,88,254,2022-05-12 17:22:24.113577
16562,16,118,8,60,126,328,2022-05-12 17:22:28.010722
16564,20,244,9,84,152,509,2022-05-12 17:22:29.163751
16566,14,106,7,63,122,312,2022-05-12 17:22:30.137465
16568,17,126,2,66,108,319,2022-05-12 17:22:31.774203
16570,9,174,12,82,104,381,2022-05-12 17:22:33.266427
16572,5,69,3,55,67,199,2022-05-12 17:22:34.444713
16586,22,99,9,46,236,412,2022-05-12 17:22:39.697198
16590,17,116,5,58,169,365,2022-05-12 17:22:40.888182
16592,30496,625837,14411,22764,145475,838983,2022-05-12 17:22:41.075607
16604,22,2770,5,44,222,3063,2022-05-12 17:22:45.497155
16606,27,2599,7,48,191,2872,2022-05-12 17:22:48.748767
16608,116,18196,39,156,1083,19590,2022-05-12 17:22:49.858643
16610,20,3990,7,51,283,4351,2022-05-12 17:22:52.422191
16620,12,116,5,44,101,278,2022-05-12 17:22:54.34549
16636,611,14024,341,354,7639,22969,2022-05-12 17:22:54.69136
16648,58,1445,51,93,823,2470,2022-05-12 17:22:59.134367
16656,769,9960,229,231,4332,15521,2022-05-12 17:23:03.552537
16662,4326,200995,1888,852,66310,274371,2022-05-12 17:23:04.31822
16664,3172,126490,1553,777,60278,192270,2022-05-12 17:23:04.744409
16680,269,36253,215,243,4109,41089,2022-05-12 17:23:15.45911
16694,1110,64968,564,296,12350,79288,2022-05-12 17:23:23.708121
16696,16,164,17,90,157,444,2022-05-12 17:23:25.208269
16700,1118,44191,670,353,18312,64644,2022-05-12 17:23:28.287637
16702,21,621,21,82,263,1008,2022-05-12 17:23:30.530362
16706,10054,239223,5429,4905,54749,314360,2022-05-12 17:23:30.952252
16718,102,1488,80,113,1677,3460,2022-05-12 17:23:32.515343
16728,23,227,15,55,250,570,2022-05-12 17:23:34.836721
16730,20,165,5,67,164,421,2022-05-12 17:23:36.810477
16740,76,1458,52,62,758,2406,2022-05-12 17:23:45.689652
16742,32713,363749,24172,43470,124145,588249,2022-05-12 17:23:45.917825
16748,12,91,5,60,112,280,2022-05-12 17:23:48.907923
16752,7,62,1,41,61,172,2022-05-12 17:23:50.000246
16754,10,58,2,55,66,191,2022-05-12 17:23:51.174506
16762,3263,290049,1247,799,33390,328748,2022-05-12 17:23:54.639896
16774,2875,64628,1787,2845,23345,95480,2022-05-12 17:23:58.944364
16776,18,74,11,50,197,350,2022-05-12 17:24:02.028838
16778,13,114,5,50,105,287,2022-05-12 17:24:03.365318
16780,13,69,3,42,83,210,2022-05-12 17:24:05.061037
16782,13109,569002,3819,1278,164154,751362,2022-05-12 17:24:05.297901
16790,8,60,3,49,70,190,2022-05-12 17:24:11.658374
16796,10,68,2,45,84,209,2022-05-12 17:24:15.505044
16798,20,210,10,58,277,575,2022-05-12 17:24:17.309832
16800,8,67,6,44,84,209,2022-05-12 17:24:18.410505
16804,23,112,2,68,135,340,2022-05-12 17:24:20.291046
16810,18,87,6,63,121,295,2022-05-12 17:24:23.725304
16812,17,214,9,82,149,471,2022-05-12 17:24:25.343198
16816,9,78,3,51,87,228,2022-05-12 17:24:26.893913
16822,30,495,14,66,305,910,2022-05-12 17:24:30.649133
16824,7,58,3,50,67,185,2022-05-12 17:24:31.904201
16828,19,114,3,55,101,292,2022-05-12 17:24:34.583317
16830,10,68,3,60,63,204,2022-05-12 17:24:35.7308
16834,14,75,4,44,79,216,2022-05-12 17:24:38.094487
16838,6,68,3,51,82,210,2022-05-12 17:24:39.136749
16868,926,44136,449,223,12916,58650,2022-05-12 17:24:43.046363
16870,6362,469824,1122,878,33148,511334,2022-05-12 17:24:43.327612
16894,29084,635004,10573,6945,66766,748372,2022-05-12 17:24:48.613581
16906,214,577,181,317,599,1888,2022-05-12 17:24:56.476483
16908,20,76,9,85,114,304,2022-05-12 17:24:57.587324
43196,2,6,4,18,21,51,2022-05-12 21:41:08.207991
16910,2085,21827,1161,1957,12153,39183,2022-05-12 17:25:01.76186
16912,20,350,16,69,269,724,2022-05-12 17:25:03.216987
16916,1248,80176,413,348,11907,94092,2022-05-12 17:25:03.401472
16918,12160,146756,8546,7769,90426,265657,2022-05-12 17:25:08.505893
16934,2727,169769,1152,828,30629,205105,2022-05-12 17:25:13.956433
16936,69,3041,43,50,805,4008,2022-05-12 17:25:16.549656
16964,77,1929,44,84,843,2977,2022-05-12 17:25:20.428865
16982,1571,26144,1109,1255,11739,41818,2022-05-12 17:25:24.520156
16988,13,139,4,68,83,307,2022-05-12 17:25:26.71793
16994,20,107,4,50,122,303,2022-05-12 17:25:28.705648
17002,16,149,8,41,217,431,2022-05-12 17:25:30.192526
17006,11,112,5,73,87,288,2022-05-12 17:25:32.245326
17020,154,2636,111,102,1990,4993,2022-05-12 17:25:36.36122
17048,8,283,12,37,140,480,2022-05-12 17:25:37.71425
17068,28,1488,12,24,261,1813,2022-05-12 17:25:39.676425
17074,38749,398298,18775,6679,144683,607184,2022-05-12 17:25:40.120651
17076,27,800,6,65,144,1042,2022-05-12 17:25:41.783045
17086,10,170,9,95,103,387,2022-05-12 17:25:49.741331
17090,11,151,10,105,104,381,2022-05-12 17:25:51.775894
17092,35,293,21,88,318,755,2022-05-12 17:25:53.494757
17100,13,82,1,68,89,253,2022-05-12 17:25:55.095764
17102,10,68,5,60,122,265,2022-05-12 17:25:56.238214
17106,17,107,12,71,111,318,2022-05-12 17:25:58.812621
17115,602,32503,587,651,5970,40313,2022-05-12 17:26:03.686781
17127,147,787,104,426,894,2358,2022-05-12 17:26:08.276393
17131,34,157,11,49,312,563,2022-05-12 17:26:09.6929
17141,54,223,38,102,681,1098,2022-05-12 17:26:12.090868
17151,11,358,3,20,51,443,2022-05-12 17:26:15.325126
17157,1493,35821,606,610,10252,48782,2022-05-12 17:26:18.66691
17159,16,296,14,57,150,533,2022-05-12 17:26:21.067481
17161,20,262,10,65,168,525,2022-05-12 17:26:22.917563
17165,30,287,16,53,234,620,2022-05-12 17:26:24.884704
17167,32,245,23,66,317,683,2022-05-12 17:26:26.415755
17187,1112,38342,530,320,18222,58526,2022-05-12 17:26:26.670452
17201,22,109,5,47,190,373,2022-05-12 17:26:28.123278
17211,77,211,48,104,545,985,2022-05-12 17:26:33.486006
17213,14,128,7,70,93,312,2022-05-12 17:26:34.787603
17217,19,63,10,52,222,366,2022-05-12 17:26:38.354896
17221,46,322,12,62,523,965,2022-05-12 17:26:41.277992
17223,34,339,8,55,320,756,2022-05-12 17:26:42.725281
17233,20,207,10,47,300,584,2022-05-12 17:26:44.196386
17245,17,688,7,24,134,870,2022-05-12 17:26:47.68218
17247,15386,196013,8214,10954,69612,300179,2022-05-12 17:26:48.025927
17249,733,5901,456,659,4043,11792,2022-05-12 17:26:51.150989
17265,60555,659126,37870,42737,215037,1015325,2022-05-12 17:26:56.460158
17269,783,39370,317,294,9146,49910,2022-05-12 17:27:04.796622
17273,441,11645,264,263,4780,17393,2022-05-12 17:27:07.752077
43218,2,26,2,8,20,58,2022-05-12 21:41:22.413313
17291,50,258,27,91,283,709,2022-05-12 17:27:10.505582
17295,32,254,17,50,302,655,2022-05-12 17:27:14.903227
17313,10,87,2,56,92,247,2022-05-12 17:27:17.392186
17315,12,88,4,68,89,261,2022-05-12 17:27:18.417036
17321,8,69,2,60,87,226,2022-05-12 17:27:20.513098
17325,73,369,40,115,1054,1651,2022-05-12 17:27:22.640298
17339,28,217,12,43,281,581,2022-05-12 17:27:24.046664
17345,660,9753,310,228,5931,16882,2022-05-12 17:27:29.710104
17351,103,5078,68,53,1430,6732,2022-05-12 17:27:31.985272
17357,87,2465,57,100,1276,3985,2022-05-12 17:27:35.75332
17359,20,188,17,79,216,520,2022-05-12 17:27:37.21861
17387,35,470,28,113,215,861,2022-05-12 17:27:40.652757
17389,5191,60610,1746,1577,31661,100785,2022-05-12 17:27:41.090194
17395,219,5030,91,117,2746,8203,2022-05-12 17:27:43.81846
17409,1539,34744,814,854,14069,52020,2022-05-12 17:27:52.98492
17419,251,5032,198,202,3241,8924,2022-05-12 17:27:55.839692
17427,19,110,5,44,104,282,2022-05-12 17:27:58.799358
17437,485,13986,270,185,7517,22443,2022-05-12 17:28:01.657682
17439,12,129,12,73,168,394,2022-05-12 17:28:02.874678
17441,13,123,12,82,167,397,2022-05-12 17:28:04.374436
17445,16,124,12,81,173,406,2022-05-12 17:28:06.7437
17467,64,160,63,124,480,891,2022-05-12 17:28:11.00903
17469,30,118,10,49,157,364,2022-05-12 17:28:12.363628
17471,11,77,5,58,74,225,2022-05-12 17:28:13.487229
17483,11,99,8,43,107,268,2022-05-12 17:28:17.76964
17485,13,185,8,44,142,392,2022-05-12 17:28:19.144662
17487,24,56,11,61,128,280,2022-05-12 17:28:20.788956
17493,33,235,14,58,479,819,2022-05-12 17:28:22.873525
17501,34,175,28,90,329,656,2022-05-12 17:28:24.821826
17505,6063,40978,3245,4611,28710,83607,2022-05-12 17:28:27.541519
17513,12176,223767,5430,28756,42402,312531,2022-05-12 17:28:27.957577
17521,30,154,19,95,263,561,2022-05-12 17:28:29.291813
17535,1166,67697,586,413,13564,83426,2022-05-12 17:28:32.444667
17549,24195,185994,14253,10045,145177,379664,2022-05-12 17:28:32.634799
17551,121,3096,141,174,2466,5998,2022-05-12 17:28:35.431786
17563,28,180,19,33,303,563,2022-05-12 17:28:36.860365
17599,12,73,12,61,97,255,2022-05-12 17:28:39.391583
17603,27,212,4,61,219,523,2022-05-12 17:28:44.020005
17605,19,199,4,58,134,414,2022-05-12 17:28:45.606152
17615,33,194,19,50,402,698,2022-05-12 17:28:48.643527
17619,24,102,14,69,234,443,2022-05-12 17:28:49.833906
17621,25,220,13,78,282,618,2022-05-12 17:28:51.570885
17624,18,95,11,65,123,312,2022-05-12 17:28:53.148566
17635,746,7929,433,275,6777,16160,2022-05-12 17:28:55.964966
17637,644,14465,446,501,6751,22807,2022-05-12 17:28:56.386841
17641,2443,149154,963,733,25761,179054,2022-05-12 17:28:56.577244
17643,430,18710,322,155,7814,27431,2022-05-12 17:29:00.235106
17651,3079,22771,2418,4951,18071,51290,2022-05-12 17:29:05.464382
17655,137,2600,91,119,1740,4687,2022-05-12 17:29:08.135289
17657,10,60,12,40,153,275,2022-05-12 17:29:09.725798
17659,72,1983,51,65,871,3042,2022-05-12 17:29:13.086009
17665,11,86,5,55,120,277,2022-05-12 17:29:14.243673
17667,21,119,26,94,229,489,2022-05-12 17:29:15.698615
17671,25,149,23,111,254,562,2022-05-12 17:29:16.937295
17673,24,93,14,70,239,440,2022-05-12 17:29:18.111359
17675,11,61,9,86,120,287,2022-05-12 17:29:19.4957
17677,381,5417,137,83,5237,11255,2022-05-12 17:29:22.456077
17679,172,4968,79,66,2846,8131,2022-05-12 17:29:24.637175
17689,32,365,20,54,535,1006,2022-05-12 17:29:29.776157
17697,91,293,50,67,434,935,2022-05-12 17:29:32.692948
17703,49,127,48,147,539,910,2022-05-12 17:29:36.827073
17705,195,1712,149,295,1371,3722,2022-05-12 17:29:39.69078
17717,134,6388,79,95,1835,8531,2022-05-12 17:29:42.577574
17719,25,373,10,56,268,732,2022-05-12 17:29:44.174084
17721,24,67,12,47,304,454,2022-05-12 17:29:46.007482
17727,173,1677,183,125,1493,3651,2022-05-12 17:29:51.39481
17729,25183,370809,12207,17216,122366,547781,2022-05-12 17:29:51.584092
17731,583,6182,552,761,2487,10565,2022-05-12 17:29:58.450474
17733,90,155,117,181,366,909,2022-05-12 17:30:00.846319
17739,328,7717,170,192,4007,12414,2022-05-12 17:30:03.811079
17741,6971,74365,3795,5856,49537,140524,2022-05-12 17:30:04.785495
43226,0,5,2,13,16,36,2022-05-12 21:41:28.612144
17743,728,14898,338,334,6921,23219,2022-05-12 17:30:08.085019
17749,17,150,15,42,201,425,2022-05-12 17:30:09.833473
17753,22,163,9,44,202,440,2022-05-12 17:30:11.759202
17777,8508,92928,4327,9043,41756,156562,2022-05-12 17:30:14.8935
17787,39,1078,17,42,607,1783,2022-05-12 17:30:19.193153
17811,56,3455,34,53,518,4116,2022-05-12 17:30:21.613593
17813,276,9046,140,153,2378,11993,2022-05-12 17:30:23.704793
17815,67,3589,34,56,562,4308,2022-05-12 17:30:26.387581
17821,3251,24359,2245,4478,17565,51898,2022-05-12 17:30:31.845025
17823,44,263,32,91,309,739,2022-05-12 17:30:33.267946
17827,8090,68319,4004,5619,39383,125415,2022-05-12 17:30:34.180985
17831,7818,81265,4447,10255,31735,135520,2022-05-12 17:30:34.824342
17849,424,6093,225,879,2007,9628,2022-05-12 17:30:40.301091
17855,144,6069,70,70,1856,8209,2022-05-12 17:30:42.520373
17871,241,2849,119,89,2112,5410,2022-05-12 17:30:46.06121
17875,3053,26277,1047,498,5333,36208,2022-05-12 17:30:53.129124
17879,924,17536,753,532,10243,29988,2022-05-12 17:30:56.198264
17887,70,968,27,38,548,1651,2022-05-12 17:30:58.396892
17891,6,163,2,31,78,280,2022-05-12 17:30:59.684515
17895,50224,568688,32265,39304,204022,894503,2022-05-12 17:31:01.129724
17897,43,1255,17,45,484,1844,2022-05-12 17:31:03.794576
17903,18,73,6,49,190,336,2022-05-12 17:31:07.555314
17909,8706,59783,5964,5793,74028,154274,2022-05-12 17:31:10.400955
17917,306,2356,200,294,1267,4423,2022-05-12 17:31:13.688769
17933,36,175,28,54,465,758,2022-05-12 17:31:15.717074
17951,24,386,7,46,161,624,2022-05-12 17:31:23.565102
17955,26,335,4,47,153,565,2022-05-12 17:31:25.898382
17961,30,369,21,79,405,904,2022-05-12 17:31:30.006494
17963,35,436,23,77,447,1018,2022-05-12 17:31:31.787131
17969,118,234,82,147,674,1255,2022-05-12 17:31:35.177624
17977,14,172,7,38,126,357,2022-05-12 17:31:36.445258
17979,15,160,8,41,117,341,2022-05-12 17:31:37.519999
17981,14,120,8,43,121,306,2022-05-12 17:31:38.713537
17983,14,204,9,48,120,395,2022-05-12 17:31:40.004696
17989,32,168,13,53,273,539,2022-05-12 17:31:43.060715
18001,6127,114975,4053,5487,23194,153836,2022-05-12 17:31:44.813392
18003,23,474,12,65,295,869,2022-05-12 17:31:46.82034
18005,19,136,19,75,143,392,2022-05-12 17:31:48.042832
18007,68,58,46,102,257,531,2022-05-12 17:31:49.387108
18029,15,221,7,45,126,414,2022-05-12 17:31:51.375501
18031,13,164,6,44,120,347,2022-05-12 17:31:52.645895
18033,14,176,8,46,122,366,2022-05-12 17:31:54.408474
18039,966,20579,398,409,6518,28870,2022-05-12 17:31:54.741221
18045,676,26906,335,198,7405,35520,2022-05-12 17:31:55.556177
18053,362,4803,272,193,4243,9873,2022-05-12 17:31:56.181192
18063,23,342,18,98,363,844,2022-05-12 17:31:58.88809
18071,21,81,10,48,183,343,2022-05-12 17:32:01.993411
18081,14,142,5,45,91,297,2022-05-12 17:32:03.202193
18083,18,230,4,46,121,419,2022-05-12 17:32:04.632538
18087,13,169,9,46,124,361,2022-05-12 17:32:06.992614
18095,10820,92147,5714,8858,55257,172796,2022-05-12 17:32:09.870206
18097,1593,32402,919,1715,5231,41860,2022-05-12 17:32:10.292081
18099,693,16278,335,417,4077,21800,2022-05-12 17:32:13.504024
18109,31,295,32,69,465,892,2022-05-12 17:32:15.488173
18115,33295,546868,17371,13240,146527,757301,2022-05-12 17:32:15.659694
43227,0,24,2,8,15,49,2022-05-12 21:41:29.655279
18119,10693,109901,6013,6319,66976,199902,2022-05-12 17:32:19.85755
18121,804,22990,430,384,4516,29124,2022-05-12 17:32:22.613665
18133,38,496,7,87,163,791,2022-05-12 17:32:24.026594
18137,30,81,21,115,185,432,2022-05-12 17:32:26.8921
18139,14491,119391,9053,8044,55463,206442,2022-05-12 17:32:27.323306
18149,45,2730,28,36,359,3198,2022-05-12 17:32:29.625926
18153,54761,635074,32294,30695,294000,1046824,2022-05-12 17:32:29.875925
43241,0,8,0,12,14,34,2022-05-12 21:41:42.932951
18177,294,13594,148,160,3828,18024,2022-05-12 17:32:35.046029
18191,17,93,17,79,131,337,2022-05-12 17:32:41.807656
18195,5669,91504,3582,3103,49199,153057,2022-05-12 17:32:42.245233
18197,73,246,26,81,311,737,2022-05-12 17:32:44.335837
18199,62,219,25,74,223,603,2022-05-12 17:32:46.49329
18227,44,109,22,114,212,501,2022-05-12 17:32:52.219363
18241,24,143,14,98,171,450,2022-05-12 17:32:56.725929
18245,9623,122795,5207,5847,81515,224987,2022-05-12 17:32:59.596706
18247,11759,287684,6215,11006,41394,358058,2022-05-12 17:33:02.610325
18269,10,45,1,53,55,164,2022-05-12 17:33:03.567409
18275,14,72,5,49,87,227,2022-05-12 17:33:09.71426
18295,3170,66535,1917,1936,14560,88118,2022-05-12 17:33:14.293161
18301,7,55,3,40,60,165,2022-05-12 17:33:16.375792
18303,12,64,2,50,69,197,2022-05-12 17:33:18.701075
18305,20,178,12,81,196,487,2022-05-12 17:33:20.128747
18309,11,114,6,78,94,303,2022-05-12 17:33:21.929849
18313,14,90,3,64,98,269,2022-05-12 17:33:23.923196
18317,7,60,1,41,64,173,2022-05-12 17:33:26.317827
18319,13,87,3,59,94,256,2022-05-12 17:33:27.546387
18323,11,69,3,49,66,198,2022-05-12 17:33:29.612556
18325,14,98,3,51,94,260,2022-05-12 17:33:32.16899
18329,14,85,4,50,72,225,2022-05-12 17:33:35.697846
18331,11,86,4,51,73,225,2022-05-12 17:33:36.999193
18339,13,80,2,64,94,253,2022-05-12 17:33:38.109342
18353,7,133,6,39,66,251,2022-05-12 17:33:41.370305
18355,11,107,8,70,100,296,2022-05-12 17:33:43.102067
18357,13,119,8,69,98,307,2022-05-12 17:33:44.834882
18365,36,337,39,123,388,923,2022-05-12 17:33:46.441148
18375,15,603,11,32,124,785,2022-05-12 17:33:48.017774
18389,22,133,10,48,139,352,2022-05-12 17:33:50.500679
18393,1673,98428,694,520,15982,117297,2022-05-12 17:33:53.796701
18397,14479,330888,6732,2602,48021,402722,2022-05-12 17:33:54.062368
18411,2859,27669,2194,3265,17987,53974,2022-05-12 17:33:57.139391
18413,447,6576,428,440,1629,9520,2022-05-12 17:34:00.421046
18419,86,2580,48,62,898,3674,2022-05-12 17:34:02.944188
18425,18,387,4,37,94,540,2022-05-12 17:34:05.683378
18429,472,21222,239,230,5984,28147,2022-05-12 17:34:06.105254
18441,1619,83067,665,504,17267,103122,2022-05-12 17:34:08.919518
18443,15,117,10,50,116,308,2022-05-12 17:34:10.463191
18447,44,149,22,61,357,633,2022-05-12 17:34:11.920335
18449,72,1499,53,91,991,2706,2022-05-12 17:34:14.481589
18451,24,104,6,53,220,407,2022-05-12 17:34:15.673688
18463,10,374,3,22,60,469,2022-05-12 17:34:19.623362
18465,2317,27501,1498,1584,16073,48973,2022-05-12 17:34:20.706669
18475,19,62,7,52,112,252,2022-05-12 17:34:22.980564
18489,9,225,7,80,88,409,2022-05-12 17:34:24.499934
18491,10,203,7,79,89,388,2022-05-12 17:34:26.404309
18495,3249,18315,2206,5015,18518,47303,2022-05-12 17:34:27.291468
18499,1353,13892,715,302,10881,27143,2022-05-12 17:34:31.248498
18507,38066,518345,21818,34199,114193,726621,2022-05-12 17:34:34.382563
18523,1505,42764,840,705,8609,54423,2022-05-12 17:34:41.079024
18527,19,105,5,52,124,305,2022-05-12 17:34:44.251943
18533,16,378,11,48,243,696,2022-05-12 17:34:47.262602
18549,90,1619,61,104,1247,3121,2022-05-12 17:34:49.21745
18557,47,528,25,63,555,1218,2022-05-12 17:34:51.283937
18561,9,361,4,28,55,457,2022-05-12 17:34:52.832576
18573,17,84,6,59,115,281,2022-05-12 17:34:57.378119
18575,10,149,5,50,81,295,2022-05-12 17:34:58.674294
18577,15,104,7,44,81,251,2022-05-12 17:35:00.108309
18583,26,81,7,50,167,331,2022-05-12 17:35:01.189049
18587,14,274,10,48,159,505,2022-05-12 17:35:03.021378
18589,13,158,8,51,115,345,2022-05-12 17:35:04.255395
18603,34,736,28,70,400,1268,2022-05-12 17:35:10.119707
18617,2078,65096,700,666,24991,93531,2022-05-12 17:35:10.575753
18629,14,85,3,51,108,261,2022-05-12 17:35:17.7991
18631,20,66,15,37,196,334,2022-05-12 17:35:19.02656
18635,32,188,24,123,274,641,2022-05-12 17:35:20.640453
18637,30,408,23,75,414,950,2022-05-12 17:35:22.158318
18639,116,1388,80,68,1382,3034,2022-05-12 17:35:24.22965
18661,6087,88075,1191,525,17205,113083,2022-05-12 17:35:28.422368
18669,30,656,33,57,505,1281,2022-05-12 17:35:31.430358
18671,23065,511586,14686,13440,99785,662562,2022-05-12 17:35:31.855679
18677,15837,164572,8024,12397,75954,276784,2022-05-12 17:35:32.740395
18679,102540,997025,74590,82894,283872,1540921,2022-05-12 17:35:33.612177
18683,35,174,19,58,338,624,2022-05-12 17:35:37.242517
18689,23788,114182,15048,10337,52799,216154,2022-05-12 17:35:37.409661
18703,22,134,5,44,191,396,2022-05-12 17:35:41.006959
18723,32,392,9,34,216,683,2022-05-12 17:35:43.973543
18729,83,732,37,119,1124,2095,2022-05-12 17:35:46.196404
18743,21,113,9,40,231,414,2022-05-12 17:35:51.278352
18745,667,27566,386,263,11747,40629,2022-05-12 17:35:53.965221
18747,12,217,8,34,122,393,2022-05-12 17:35:55.337263
18753,2692,210208,1007,542,25788,240237,2022-05-12 17:35:55.508158
18755,195,2782,192,227,1235,4631,2022-05-12 17:35:58.972424
18759,15,149,11,74,143,392,2022-05-12 17:36:00.706857
18767,4963,43291,3879,9062,23396,84591,2022-05-12 17:36:04.917713
18781,135,1810,181,126,1107,3359,2022-05-12 17:36:11.656951
18795,24,461,12,53,166,716,2022-05-12 17:36:13.222788
18799,36,2207,25,64,637,2969,2022-05-12 17:36:15.473447
18815,21,244,15,58,203,541,2022-05-12 17:36:17.778982
18817,8,85,6,64,96,259,2022-05-12 17:36:18.822636
18819,15,134,18,81,140,388,2022-05-12 17:36:20.533462
18821,14,133,7,51,113,318,2022-05-12 17:36:21.563667
18823,10,167,4,40,98,319,2022-05-12 17:36:23.561227
18827,15,273,7,48,162,505,2022-05-12 17:36:26.652134
18829,13,161,6,44,120,344,2022-05-12 17:36:27.992428
18835,155,1922,112,89,2086,4364,2022-05-12 17:36:31.562613
18841,24,691,8,49,204,976,2022-05-12 17:36:32.90749
18845,91,1656,62,200,298,2307,2022-05-12 17:36:35.843125
18849,481,22454,282,167,7991,31375,2022-05-12 17:36:39.152154
18857,1459,114401,754,1049,14870,132533,2022-05-12 17:36:45.425358
18881,204,5401,242,316,3770,9933,2022-05-12 17:36:47.832699
18983,17,83,13,74,94,281,2022-05-12 17:37:04.634984
18897,48023,748963,26433,34880,193514,1051813,2022-05-12 17:36:50.984781
18907,9,52,4,53,64,182,2022-05-12 17:36:53.125776
18919,25,40,9,68,235,377,2022-05-12 17:36:54.620756
18937,15,134,13,75,107,344,2022-05-12 17:36:56.412616
18939,13,100,11,83,95,302,2022-05-12 17:36:57.495161
18943,13,91,10,71,101,286,2022-05-12 17:37:00.261764
18953,54,1846,19,42,532,2493,2022-05-12 17:37:02.065036
18967,12,102,5,66,124,309,2022-05-12 17:37:03.395417
19009,14,270,8,35,225,552,2022-05-12 17:37:06.827091
19021,1736,67343,1072,648,25054,95853,2022-05-12 17:37:07.280215
19049,14,66,3,57,98,238,2022-05-12 17:37:12.998714
19053,14,115,4,43,92,268,2022-05-12 17:37:14.472359
19063,18,76,8,59,136,297,2022-05-12 17:37:17.250119
19067,750,5203,528,932,2257,9670,2022-05-12 17:37:20.035695
19071,13,75,3,31,60,182,2022-05-12 17:37:22.198129
19073,10,67,3,35,59,174,2022-05-12 17:37:23.200774
19081,31,2172,6,29,204,2442,2022-05-12 17:37:25.230884
19087,20,134,8,81,113,356,2022-05-12 17:37:26.341512
19117,5387,49596,3200,4481,32033,94697,2022-05-12 17:37:34.721259
19121,39,182,19,76,305,621,2022-05-12 17:37:35.916989
19123,1333,43018,399,443,7953,53146,2022-05-12 17:37:36.16699
19125,12,440,11,47,113,623,2022-05-12 17:37:38.736058
19133,344,4601,238,494,2046,7723,2022-05-12 17:37:40.852301
19135,30,291,14,53,366,754,2022-05-12 17:37:43.470027
19137,26,1812,14,32,246,2130,2022-05-12 17:37:45.163769
19151,8445,64833,4423,10181,38225,126107,2022-05-12 17:37:48.097389
19157,4272,7725,3548,5376,5670,26591,2022-05-12 17:37:48.518165
19163,16020,463836,8022,9542,65232,562652,2022-05-12 17:37:52.477444
19165,647,6434,553,512,12023,20169,2022-05-12 17:37:52.917692
19171,54,298,35,79,266,732,2022-05-12 17:38:00.233655
19177,14,87,5,62,130,298,2022-05-12 17:38:01.484636
19185,29,2105,13,31,259,2437,2022-05-12 17:38:03.371694
19187,16,1491,6,23,175,1711,2022-05-12 17:38:05.116195
19193,722,26990,368,210,13532,41822,2022-05-12 17:38:09.510263
19195,669,23118,375,197,13487,37846,2022-05-12 17:38:12.703465
19209,10,270,12,37,152,481,2022-05-12 17:38:16.636722
19213,17,846,11,33,233,1140,2022-05-12 17:38:21.863406
19217,10,825,5,36,140,1016,2022-05-12 17:38:23.517989
19221,14517,263662,6591,9185,83893,377848,2022-05-12 17:38:28.152762
19231,16,720,5,29,110,880,2022-05-12 17:38:30.235143
19233,18,867,12,44,218,1159,2022-05-12 17:38:32.315088
19235,15,670,2,23,122,832,2022-05-12 17:38:33.877306
19237,12,540,6,22,95,675,2022-05-12 17:38:35.871425
19251,457,16604,247,285,7652,25245,2022-05-12 17:38:39.103761
19255,475,7946,251,161,3698,12531,2022-05-12 17:38:42.526605
19257,1787,10344,1756,6442,9235,29564,2022-05-12 17:38:45.006727
19271,37,407,24,60,309,837,2022-05-12 17:38:49.577332
19285,2290,101158,934,1050,20168,125600,2022-05-12 17:38:50.888064
19287,69,2096,45,86,569,2865,2022-05-12 17:38:54.279749
19291,8567,110088,6432,8174,11057,144318,2022-05-12 17:38:54.729176
19297,83,2510,47,79,727,3446,2022-05-12 17:38:57.577367
19311,18,58,6,60,83,225,2022-05-12 17:39:01.571259
19319,3838,44560,2227,2802,14488,67915,2022-05-12 17:39:04.621884
19337,18,245,12,69,199,543,2022-05-12 17:39:08.596621
19351,132,2217,55,108,776,3288,2022-05-12 17:39:10.960056
19363,3906,103942,2436,1230,22743,134257,2022-05-12 17:39:11.413111
19365,8546,48020,7802,13162,46472,124002,2022-05-12 17:39:14.420076
19369,16140,214609,8179,10208,76102,325238,2022-05-12 17:39:17.759428
19391,3312,32515,3014,2754,9646,51241,2022-05-12 17:39:22.612628
19397,74,970,48,77,758,1927,2022-05-12 17:39:24.395763
19429,11894,153464,7183,13541,63182,249264,2022-05-12 17:39:27.970225
19431,192,3574,76,89,1311,5242,2022-05-12 17:39:30.505849
19433,12,121,5,69,94,301,2022-05-12 17:39:32.434434
19437,15,137,9,47,145,353,2022-05-12 17:39:33.690467
19445,28,84,16,117,170,415,2022-05-12 17:39:34.717438
19457,17,69,8,59,82,235,2022-05-12 17:39:36.297844
19463,10,60,2,49,64,185,2022-05-12 17:39:37.483125
19467,39,84,20,64,432,639,2022-05-12 17:39:39.246229
19469,808,25570,343,350,8722,35793,2022-05-12 17:39:39.563318
19489,2347,122778,985,518,32705,159333,2022-05-12 17:39:43.495167
19495,45,117,21,46,300,529,2022-05-12 17:39:44.976217
19497,11,71,3,48,81,214,2022-05-12 17:39:46.399553
19501,29,80,13,63,172,357,2022-05-12 17:39:47.686124
19505,23,123,21,97,257,521,2022-05-12 17:39:49.400293
19511,785,51889,378,295,8302,61649,2022-05-12 17:39:49.728858
19513,26,90,9,53,248,426,2022-05-12 17:39:50.948801
19515,25,93,11,54,195,378,2022-05-12 17:39:52.388899
19517,10,78,3,63,77,231,2022-05-12 17:39:53.676267
19519,23,968,14,19,165,1189,2022-05-12 17:39:55.841303
19521,33,2174,13,31,312,2563,2022-05-12 17:39:57.428272
19533,15,217,8,47,204,491,2022-05-12 17:39:58.623956
19547,26,112,9,67,89,303,2022-05-12 17:40:01.467188
19555,12,63,3,50,68,196,2022-05-12 17:40:02.662603
19557,18,183,13,73,101,388,2022-05-12 17:40:04.44772
19559,16,69,8,45,118,256,2022-05-12 17:40:06.08093
19575,340,6032,154,173,2828,9527,2022-05-12 17:40:11.768311
19581,467,9622,189,209,5529,16016,2022-05-12 17:40:14.341441
19583,9,61,2,48,67,187,2022-05-12 17:40:15.539348
19587,12,149,9,55,154,379,2022-05-12 17:40:17.183646
19597,25,301,10,50,220,606,2022-05-12 17:40:18.522022
19613,570,21930,225,242,8052,31019,2022-05-12 17:40:18.943971
19647,9455,155717,3418,1776,43498,213864,2022-05-12 17:40:25.081195
19653,2033,24198,639,451,20067,47388,2022-05-12 17:40:28.653699
19669,628,39207,315,264,8057,48471,2022-05-12 17:40:32.933691
19671,2802,47580,2307,1078,15079,68846,2022-05-12 17:40:33.089941
19685,10704,107263,5910,12974,42501,179352,2022-05-12 17:40:40.97251
19687,21,198,13,52,230,514,2022-05-12 17:40:43.64168
19695,30,106,17,66,323,542,2022-05-12 17:40:45.469795
19697,974,20759,685,305,9290,32013,2022-05-12 17:40:45.62784
19703,10385,58241,7009,4747,90445,170827,2022-05-12 17:40:49.33661
19705,12,97,4,40,70,223,2022-05-12 17:40:50.947531
19717,17,111,7,49,112,296,2022-05-12 17:40:52.578091
19729,15,78,6,42,104,245,2022-05-12 17:40:56.552372
19731,13,203,5,39,151,411,2022-05-12 17:40:58.316968
19745,13,75,4,41,91,224,2022-05-12 17:40:59.343544
19749,14,69,4,42,79,208,2022-05-12 17:41:00.981169
19751,17,106,5,58,123,309,2022-05-12 17:41:02.014057
19753,12,68,5,41,77,203,2022-05-12 17:41:03.451773
19755,48,352,36,108,186,730,2022-05-12 17:41:03.876318
19759,2236,52472,1047,892,16697,73344,2022-05-12 17:41:06.802082
19773,27,256,20,68,282,653,2022-05-12 17:41:11.068707
19783,19,64,4,38,128,253,2022-05-12 17:41:18.085227
19797,15,62,4,35,96,212,2022-05-12 17:41:20.203246
19799,1060,9272,493,786,8405,20016,2022-05-12 17:41:23.023906
19811,59,656,32,47,466,1260,2022-05-12 17:41:24.587038
19815,78453,1741212,33915,49678,239106,2142364,2022-05-12 17:41:24.915162
19817,12,75,6,45,106,244,2022-05-12 17:41:26.120883
19825,126,625,83,179,697,1710,2022-05-12 17:41:28.032802
19831,27,108,17,67,241,460,2022-05-12 17:41:29.347916
19839,19,76,10,52,137,294,2022-05-12 17:41:30.83755
19841,1320,18904,861,1456,8368,30909,2022-05-12 17:41:31.259425
19845,343,5122,329,363,4338,10495,2022-05-12 17:41:36.030254
19873,15,92,14,66,165,352,2022-05-12 17:41:45.07835
19877,80,724,49,115,708,1676,2022-05-12 17:41:47.078443
19887,15,65,3,61,154,298,2022-05-12 17:41:50.069636
19889,230,3649,233,120,2881,7113,2022-05-12 17:41:53.160973
19897,21,144,6,70,183,424,2022-05-12 17:41:54.412348
19899,10,106,7,50,148,321,2022-05-12 17:41:55.635248
19905,17,74,8,50,181,330,2022-05-12 17:41:58.122929
19907,20,68,8,50,202,348,2022-05-12 17:41:59.27235
19917,12,87,5,61,113,278,2022-05-12 17:42:01.410009
19919,692,2914,517,779,6453,11355,2022-05-12 17:42:04.150662
19921,27,103,7,51,227,415,2022-05-12 17:42:05.131194
19925,31,441,22,61,216,771,2022-05-12 17:42:07.56748
19941,15,59,6,44,139,263,2022-05-12 17:42:09.435866
19943,14,65,12,66,151,308,2022-05-12 17:42:10.957293
19945,169,4269,136,217,3134,7925,2022-05-12 17:42:13.071784
19951,2315,113962,1175,671,34042,152165,2022-05-12 17:42:14.990631
19953,723,5017,542,523,3953,10758,2022-05-12 17:42:17.554252
19957,14,160,6,54,135,369,2022-05-12 17:42:19.110899
19959,20,468,16,101,134,739,2022-05-12 17:42:20.701035
19961,27,238,28,113,251,657,2022-05-12 17:42:22.630405
19965,14,91,11,63,126,305,2022-05-12 17:42:23.616626
19971,20,195,6,54,215,490,2022-05-12 17:42:24.936067
19973,112,2541,56,126,1512,4347,2022-05-12 17:42:28.132941
19977,54,681,51,100,775,1661,2022-05-12 17:42:30.19416
19981,14,88,11,102,127,342,2022-05-12 17:42:31.410922
19985,13,64,13,101,90,281,2022-05-12 17:42:33.928458
19987,21,77,12,82,116,308,2022-05-12 17:42:35.075908
19989,18,91,13,100,164,386,2022-05-12 17:42:36.330374
19991,13,88,13,91,94,299,2022-05-12 17:42:37.363594
19995,19,100,13,105,152,389,2022-05-12 17:42:40.092152
19999,13,94,9,98,84,298,2022-05-12 17:42:43.105986
20001,22,93,10,90,151,366,2022-05-12 17:42:44.16679
20003,19,93,10,101,130,353,2022-05-12 17:42:45.140554
20005,18,112,11,92,117,350,2022-05-12 17:42:46.374947
20021,3854,249463,1450,1778,31163,287708,2022-05-12 17:42:50.022598
20023,16,85,5,85,107,298,2022-05-12 17:42:51.318181
20025,12,122,8,83,88,313,2022-05-12 17:42:52.414418
20027,24,126,12,87,219,468,2022-05-12 17:42:53.60067
20031,15466,236678,8738,9912,88782,359576,2022-05-12 17:42:56.421097
20033,1940,27568,1251,3003,13000,46762,2022-05-12 17:42:59.168409
20039,232,9716,137,108,3249,13442,2022-05-12 17:43:03.595807
20045,935,43319,480,373,10209,55316,2022-05-12 17:43:03.868996
20047,13442,134785,8822,15680,68653,241382,2022-05-12 17:43:04.29087
43245,0,16,2,10,13,41,2022-05-12 21:41:45.953442
20053,3391,26173,2527,7402,15500,54993,2022-05-12 17:43:07.240584
20057,20668,157096,16118,12934,107476,314292,2022-05-12 17:43:07.411098
20075,37,284,26,117,164,628,2022-05-12 17:43:12.139929
20077,19,141,9,87,105,361,2022-05-12 17:43:13.442818
20079,25,102,14,86,158,385,2022-05-12 17:43:15.307425
20081,17,82,12,61,127,299,2022-05-12 17:43:16.404582
20083,26,107,12,75,185,405,2022-05-12 17:43:17.519303
20085,19,64,14,56,159,312,2022-05-12 17:43:18.619793
20093,21,128,8,60,116,333,2022-05-12 17:43:19.446788
20095,15,93,8,46,112,274,2022-05-12 17:43:19.917646
20117,22,237,12,90,122,483,2022-05-12 17:43:25.11763
20127,24,116,16,75,171,402,2022-05-12 17:43:29.887126
20145,18,149,6,62,227,462,2022-05-12 17:43:34.824395
20147,18,85,9,79,117,308,2022-05-12 17:43:36.219447
20153,12,519,4,30,137,702,2022-05-12 17:43:38.100731
20155,131,2205,88,142,1482,4048,2022-05-12 17:43:40.431663
20159,3251,191108,1596,1150,13220,210325,2022-05-12 17:43:40.7474
20173,13,58,8,50,103,232,2022-05-12 17:43:41.929761
20183,21,115,16,80,180,412,2022-05-12 17:43:45.850244
20187,142,4394,90,75,2014,6715,2022-05-12 17:43:50.241916
20189,30,235,17,54,253,589,2022-05-12 17:43:51.51654
20201,12,89,8,83,148,340,2022-05-12 17:43:53.63211
20205,10,81,7,62,83,243,2022-05-12 17:43:54.6709
20207,26,249,23,50,343,691,2022-05-12 17:43:56.30838
20221,381,11913,211,117,4568,17190,2022-05-12 17:43:58.829482
20223,26,106,7,79,237,455,2022-05-12 17:44:00.110221
20225,19,179,10,56,218,482,2022-05-12 17:44:01.352179
20227,9,64,5,48,74,200,2022-05-12 17:44:02.453428
20229,18,74,13,44,239,388,2022-05-12 17:44:03.848691
20231,18,71,14,75,138,316,2022-05-12 17:44:05.127965
20233,16,88,9,89,133,335,2022-05-12 17:44:06.510231
20235,36,187,22,50,415,710,2022-05-12 17:44:08.229305
20239,21,87,9,81,166,364,2022-05-12 17:44:09.859473
20241,15,70,6,66,90,247,2022-05-12 17:44:11.174602
20261,34,207,25,59,188,513,2022-05-12 17:44:14.24482
20267,243,4204,142,319,1220,6128,2022-05-12 17:44:16.544856
20329,343,3210,186,587,2623,6949,2022-05-12 17:44:18.765444
20353,65,192,29,55,689,1030,2022-05-12 17:44:20.70245
20355,40,2193,23,73,442,2771,2022-05-12 17:44:22.63138
20365,280,18177,264,311,4384,23416,2022-05-12 17:44:26.639219
20371,1087,45294,374,485,13099,60339,2022-05-12 17:44:26.830207
20383,13,86,10,58,120,287,2022-05-12 17:44:30.064157
20391,51,1963,48,63,976,3101,2022-05-12 17:44:34.569155
20431,7908,51012,5375,6475,49591,120361,2022-05-12 17:44:39.689526
20441,33,367,12,64,372,848,2022-05-12 17:44:41.504937
20449,1120,61266,564,483,18779,82212,2022-05-12 17:44:44.106568
20453,10,51,6,52,75,194,2022-05-12 17:44:45.972708
20457,8184,77673,4416,4608,55825,150706,2022-05-12 17:44:48.647774
20463,18,523,8,39,235,823,2022-05-12 17:44:50.245561
20471,0,1,0,0,6281,6282,2022-05-12 17:44:55.041704
20479,587,22839,285,217,7393,31321,2022-05-12 17:45:01.12728
20499,24,88,11,50,217,390,2022-05-12 17:45:02.554882
20505,88,918,53,71,1519,2649,2022-05-12 17:45:04.959132
20507,78404,1464356,39526,31145,307831,1921262,2022-05-12 17:45:05.302881
20509,4493,102377,2407,2368,35455,147100,2022-05-12 17:45:06.385568
20517,2519,30954,1785,854,15183,51295,2022-05-12 17:45:06.778929
20533,2341,20674,1404,3431,10838,38688,2022-05-12 17:45:13.807889
20539,53,356,30,95,372,906,2022-05-12 17:45:15.529703
20541,16494,216327,8485,8185,109875,359366,2022-05-12 17:45:15.763204
20545,937,33353,401,219,9596,44506,2022-05-12 17:45:22.539412
20547,54,764,42,87,743,1690,2022-05-12 17:45:24.516387
20557,126,2657,180,263,1696,4922,2022-05-12 17:45:27.531928
20583,108358,1291791,45054,34621,200779,1680603,2022-05-12 17:45:28.28876
43249,0,12,2,9,14,37,2022-05-12 21:41:47.205186
20613,42,4201,23,69,558,4893,2022-05-12 17:45:34.305066
20655,436,24437,249,274,5859,31255,2022-05-12 17:45:42.094688
20667,65,963,49,90,838,2005,2022-05-12 17:45:43.819212
20673,659,10826,271,125,10515,22396,2022-05-12 17:45:47.577952
20689,15560,158734,10386,13074,84061,281815,2022-05-12 17:45:51.373976
20703,8,83,4,37,71,203,2022-05-12 17:45:53.308888
20707,46,3066,26,52,492,3682,2022-05-12 17:45:54.13803
20709,8692,65061,4867,6297,57984,142901,2022-05-12 17:45:56.676338
20723,478,7183,453,375,2091,10580,2022-05-12 17:46:01.298211
20725,11,288,3,20,59,381,2022-05-12 17:46:03.942133
20743,94,5778,91,132,1518,7613,2022-05-12 17:46:06.710041
20745,610,38455,305,226,7565,47161,2022-05-12 17:46:07.210116
20755,13,90,10,82,179,374,2022-05-12 17:46:08.787261
20767,12712,248540,4016,1201,34309,300778,2022-05-12 17:46:09.240385
20785,55527,646898,29267,56787,152293,940772,2022-05-12 17:46:09.497276
43253,0,10,1,11,20,42,2022-05-12 21:41:48.432534
20787,34380,586010,18594,28141,172785,839910,2022-05-12 17:46:09.883501
20835,95,189,58,72,790,1204,2022-05-12 17:46:14.089138
20843,285,5987,194,139,3124,9729,2022-05-12 17:46:19.162045
20847,11865,152649,6882,5250,55706,232352,2022-05-12 17:46:23.553148
20853,18182,212694,10774,13011,96144,350805,2022-05-12 17:46:26.78555
20855,45,3897,14,43,406,4405,2022-05-12 17:46:29.251074
20873,23,171,6,53,120,373,2022-05-12 17:46:41.721797
43256,0,0,0,0,0,0,2022-05-12 21:41:50.153012
43257,0,0,0,0,0,0,2022-05-12 21:41:50.934443
20877,129,10121,74,110,1597,12031,2022-05-12 17:46:42.174922
20889,328,11558,159,94,6021,18160,2022-05-12 17:46:45.016917
20899,46768,870995,15697,9301,67996,1010757,2022-05-12 17:46:45.345042
20903,1109,34517,484,213,17773,54096,2022-05-12 17:46:45.660393
20907,99,2848,55,65,1387,4454,2022-05-12 17:46:49.323725
20909,1238,22105,916,674,14451,39384,2022-05-12 17:46:52.132542
20913,64,3065,29,84,879,4121,2022-05-12 17:46:56.372801
20919,474,18487,200,320,4397,23878,2022-05-12 17:46:59.085034
20931,4160,75553,1785,3106,22687,107291,2022-05-12 17:47:05.876355
20939,1295,53407,485,299,13105,68591,2022-05-12 17:47:06.313907
20945,135,3304,91,186,528,4244,2022-05-12 17:47:09.86629
20951,28,841,9,31,314,1223,2022-05-12 17:47:12.076648
20961,72,1583,36,59,954,2704,2022-05-12 17:47:14.641906
20965,86,5602,45,46,1296,7075,2022-05-12 17:47:17.632928
20969,121,1550,59,57,1752,3539,2022-05-12 17:47:20.461656
20973,8038,66020,4680,6360,49635,134733,2022-05-12 17:47:24.152581
20975,27,169,15,60,323,594,2022-05-12 17:47:25.531443
20977,397,31205,243,115,4609,36569,2022-05-12 17:47:28.877766
20987,424,3171,285,180,4931,8991,2022-05-12 17:47:31.459229
20999,28,493,13,68,261,863,2022-05-12 17:47:33.132718
21009,368,4236,190,201,2472,7467,2022-05-12 17:47:36.717369
21013,798,2023,538,1564,3040,7963,2022-05-12 17:47:39.87084
21019,12,58,5,59,71,205,2022-05-12 17:47:41.906394
21021,14,66,11,52,189,332,2022-05-12 17:47:43.208477
21027,127,1308,71,75,2625,4206,2022-05-12 17:47:47.215936
21033,10104,136401,4298,9100,39480,199383,2022-05-12 17:47:50.66963
21039,4062,33739,3340,3599,25194,69934,2022-05-12 17:47:53.678835
21065,23,1016,8,47,205,1299,2022-05-12 17:48:01.096206
21075,168,6225,111,115,3020,9639,2022-05-12 17:48:06.920545
21077,99,1506,75,136,1336,3152,2022-05-12 17:48:09.932603
21081,26,488,11,51,176,752,2022-05-12 17:48:11.232074
21085,16245,186567,7916,11906,69343,291977,2022-05-12 17:48:11.541439
21089,22,633,8,27,210,900,2022-05-12 17:48:12.966153
21099,17,105,9,52,202,385,2022-05-12 17:48:15.074884
21101,12,67,4,44,93,220,2022-05-12 17:48:16.985844
21105,8177,180923,3627,7504,33935,234166,2022-05-12 17:48:19.479362
21129,16,164,9,60,195,444,2022-05-12 17:48:25.156372
21161,8,82,5,61,86,242,2022-05-12 17:48:26.216483
21167,3887,27238,3077,6056,18057,58315,2022-05-12 17:48:31.590912
21177,8534,40695,6221,13094,26049,94593,2022-05-12 17:48:35.032396
21179,54,761,25,48,551,1439,2022-05-12 17:48:36.870078
21185,7046,85867,4974,5540,33724,137151,2022-05-12 17:48:37.307613
21201,110,8077,65,92,1409,9753,2022-05-12 17:48:46.359773
21215,82,432,50,89,695,1348,2022-05-12 17:48:48.946801
21241,2108,22102,1739,1240,7900,35089,2022-05-12 17:48:55.358952
21255,26,344,15,69,343,797,2022-05-12 17:48:57.102225
21267,339,7790,172,404,2404,11109,2022-05-12 17:49:00.856065
21275,18,126,10,59,101,314,2022-05-12 17:49:05.981071
21277,13,123,8,60,90,294,2022-05-12 17:49:07.444445
21291,12,136,4,66,88,306,2022-05-12 17:49:08.616538
21295,13,131,4,69,82,299,2022-05-12 17:49:11.45237
21327,15077,168682,11078,10110,83809,288756,2022-05-12 17:49:18.754026
21329,2825,80021,1120,592,39333,123891,2022-05-12 17:49:19.207138
21333,21,621,4,36,164,846,2022-05-12 17:49:20.597286
21335,444,1800,416,817,2023,5500,2022-05-12 17:49:22.549566
21427,289,2501,185,402,1815,5192,2022-05-12 17:49:43.50076
21339,4172,165131,1895,869,72612,244679,2022-05-12 17:49:22.955892
21353,9794,88743,6774,13887,41884,161082,2022-05-12 17:49:23.127692
21395,74,3807,46,102,661,4690,2022-05-12 17:49:26.859362
21405,15107,229854,7924,9228,91373,353486,2022-05-12 17:49:27.323811
21409,111,2339,46,95,1513,4104,2022-05-12 17:49:33.669887
21415,1592,23720,1058,596,7681,34647,2022-05-12 17:49:37.391444
21419,560,31975,256,287,4489,37567,2022-05-12 17:49:37.56804
21421,1411,5913,1033,2519,5301,16177,2022-05-12 17:49:41.333102
21433,15,153,13,90,199,470,2022-05-12 17:49:46.166067
21437,3911,50019,2175,4142,20713,80960,2022-05-12 17:49:53.436495
21439,3231,34568,2043,2453,13474,55769,2022-05-12 17:49:56.294111
21447,28,110,12,86,213,449,2022-05-12 17:49:59.284493
21451,66,2938,19,32,579,3634,2022-05-12 17:50:02.813427
21467,16,124,8,64,120,332,2022-05-12 17:50:03.960572
21469,714,38494,206,305,4847,44566,2022-05-12 17:50:04.720371
21479,85,2021,60,141,1104,3411,2022-05-12 17:50:14.005879
21483,24,78,8,67,161,338,2022-05-12 17:50:15.682062
21487,19,136,17,86,151,409,2022-05-12 17:50:18.556053
21491,24,124,8,76,120,352,2022-05-12 17:50:20.931514
21493,21,347,10,80,152,610,2022-05-12 17:50:22.631946
21495,484,4880,253,386,3739,9742,2022-05-12 17:50:25.149724
21497,206,3285,82,121,1889,5583,2022-05-12 17:50:27.997833
21509,17,75,5,64,100,261,2022-05-12 17:50:30.497964
21511,11931,104726,7332,13622,67405,205016,2022-05-12 17:50:32.250737
21517,7,80,4,46,58,195,2022-05-12 17:50:34.302852
21523,60,1266,39,143,494,2002,2022-05-12 17:50:37.922577
21525,14,125,4,49,115,307,2022-05-12 17:50:40.543836
21539,14,132,10,95,140,391,2022-05-12 17:50:42.189292
21541,949,20653,518,407,9080,31607,2022-05-12 17:50:45.141219
21545,17,91,9,47,164,328,2022-05-12 17:50:46.33148
21547,21,75,7,51,129,283,2022-05-12 17:50:48.103536
21549,18,113,9,74,157,371,2022-05-12 17:50:49.463134
21551,14,71,6,76,117,284,2022-05-12 17:50:50.686764
21553,10,82,4,74,74,244,2022-05-12 17:50:52.295902
21557,4311,175017,1739,767,68677,250511,2022-05-12 17:50:52.845259
21561,12728,121006,6406,7577,75124,222841,2022-05-12 17:50:55.795539
21563,6806,82852,3626,7774,33321,134379,2022-05-12 17:50:56.735737
21571,83,3809,81,121,1483,5577,2022-05-12 17:51:02.3727
21573,2138,25907,1026,875,12742,42688,2022-05-12 17:51:05.227653
21591,24,618,15,42,241,940,2022-05-12 17:51:10.647966
21595,98,1685,70,137,1345,3335,2022-05-12 17:51:14.063916
21603,23157,242485,16893,22745,111819,417099,2022-05-12 17:51:17.226397
21635,636,27006,283,180,7059,35164,2022-05-12 17:51:22.004329
21639,8290,28053,4077,5906,9799,56125,2022-05-12 17:51:22.191796
21641,67,710,15,37,820,1649,2022-05-12 17:51:27.966768
21647,9234,200119,3204,1414,118502,332473,2022-05-12 17:51:28.373055
21649,139,2789,67,63,1529,4587,2022-05-12 17:51:31.066205
21659,3843,151319,1459,843,28039,185503,2022-05-12 17:51:37.661959
21663,35,1334,17,31,256,1673,2022-05-12 17:51:39.560349
21667,823,45676,411,186,12355,59451,2022-05-12 17:51:42.135937
21677,5480,26089,4555,11153,16812,64089,2022-05-12 17:51:49.544018
21681,6370,44899,4402,5911,42160,103742,2022-05-12 17:51:53.204425
21695,112,5467,100,134,1776,7589,2022-05-12 17:51:55.887954
21701,47,674,32,44,579,1376,2022-05-12 17:51:57.972933
21707,85,763,49,107,1027,2031,2022-05-12 17:52:02.790721
21711,9,187,3,35,46,280,2022-05-12 17:52:04.589234
21713,22,153,16,64,135,390,2022-05-12 17:52:05.873869
21715,7,243,3,27,52,332,2022-05-12 17:52:06.962083
21729,632,10020,388,529,2802,14371,2022-05-12 17:52:12.245715
21749,30,134,13,47,291,515,2022-05-12 17:52:19.023922
21755,691,10521,309,214,3938,15673,2022-05-12 17:52:19.46791
21761,10,86,23,113,88,320,2022-05-12 17:52:20.719462
21771,297,9483,111,163,2811,12865,2022-05-12 17:52:25.978107
21781,594,8842,159,110,4332,14037,2022-05-12 17:52:34.94806
21797,1846,60911,1251,795,16467,81270,2022-05-12 17:52:35.87519
21809,4706,28000,2633,7523,21239,64101,2022-05-12 17:52:38.512884
21821,1870,10257,1029,3244,8725,25125,2022-05-12 17:52:39.994416
21833,8,260,2,40,51,361,2022-05-12 17:52:41.88316
21843,20908,213721,11578,11769,117268,375244,2022-05-12 17:52:43.167213
21845,5652,38428,3598,7437,31347,86462,2022-05-12 17:52:46.834668
21851,211,1977,127,144,1992,4451,2022-05-12 17:52:47.960605
21853,182,5057,157,192,3262,8850,2022-05-12 17:52:51.506764
21855,9277,279334,4511,1815,95426,390363,2022-05-12 17:52:53.88181
21861,56,3391,23,56,863,4389,2022-05-12 17:52:57.365643
21863,12364,158038,6020,8963,69466,254851,2022-05-12 17:52:57.670254
21869,17,122,4,52,132,327,2022-05-12 17:53:03.363158
21875,41,843,11,37,358,1290,2022-05-12 17:53:05.097944
21877,11416,139072,5484,8948,58840,223760,2022-05-12 17:53:05.491344
21981,14,39,3,68,65,189,2022-05-12 17:53:38.527978
21879,1008,42565,708,878,15270,60429,2022-05-12 17:53:05.892951
21881,72025,1482623,27611,78995,94589,1755843,2022-05-12 17:53:06.049202
21913,10,67,5,45,54,181,2022-05-12 17:53:08.269807
21933,12,122,4,67,81,286,2022-05-12 17:53:09.449565
21937,17,195,8,62,93,375,2022-05-12 17:53:14.41021
21939,14306,131648,7023,3021,111968,267966,2022-05-12 17:53:14.870295
21945,13,109,5,65,80,272,2022-05-12 17:53:20.324389
21951,13,107,6,68,81,275,2022-05-12 17:53:23.684822
21953,16,107,7,69,87,286,2022-05-12 17:53:24.766519
21955,12,103,5,63,70,253,2022-05-12 17:53:27.424086
21957,14,113,6,65,78,276,2022-05-12 17:53:28.520802
21959,14,125,6,66,81,292,2022-05-12 17:53:29.574002
21961,11,130,5,68,88,302,2022-05-12 17:53:30.58696
21963,12,118,4,66,86,286,2022-05-12 17:53:31.692618
21971,12,129,4,67,80,292,2022-05-12 17:53:34.989978
21995,32357,565887,15552,16460,171084,801340,2022-05-12 17:53:38.902978
21997,51,385,21,118,420,995,2022-05-12 17:53:40.342767
22013,210,2510,198,297,4129,7344,2022-05-12 17:53:42.955338
22037,13,96,4,64,62,239,2022-05-12 17:53:47.507853
22043,107765,556108,49104,60669,103330,876976,2022-05-12 17:53:47.937467
22049,29,1926,10,33,263,2261,2022-05-12 17:53:50.16117
22053,37,324,35,58,634,1088,2022-05-12 17:53:52.144685
23085,17,77,6,43,125,268,2022-05-12 18:00:05.820692
22055,72,924,63,101,735,1895,2022-05-12 17:53:55.573381
22057,418,17995,205,132,5721,24471,2022-05-12 17:53:58.903175
22059,11,434,3,18,96,562,2022-05-12 17:54:00.373851
22065,14,114,10,69,102,309,2022-05-12 17:54:01.869282
22093,12,310,3,22,59,406,2022-05-12 17:54:05.753181
22097,8043,79765,3513,1834,25980,119135,2022-05-12 17:54:09.33378
22099,291,610,198,750,914,2763,2022-05-12 17:54:12.181803
22101,14361,166148,8270,11228,76335,276342,2022-05-12 17:54:14.866193
22111,20,81,7,53,140,301,2022-05-12 17:54:16.504001
22113,163,1608,105,132,1704,3712,2022-05-12 17:54:20.855107
22117,561,23493,300,145,6830,31329,2022-05-12 17:54:23.948621
22123,2915,45631,1337,2496,19935,72314,2022-05-12 17:54:24.198619
22125,538,35134,294,239,7860,44065,2022-05-12 17:54:27.399955
22135,14394,180979,8751,6835,128765,339724,2022-05-12 17:54:28.24572
22137,42,542,14,32,421,1051,2022-05-12 17:54:29.98399
22145,12041,267367,6038,4963,68327,358736,2022-05-12 17:54:30.171525
22147,22977,409784,13320,15672,128567,590320,2022-05-12 17:54:30.672626
22163,15,322,7,28,99,471,2022-05-12 17:54:33.068568
22167,11,370,11,32,140,564,2022-05-12 17:54:35.761386
22169,18,1612,15,46,277,1968,2022-05-12 17:54:38.154919
22173,10,738,6,35,109,898,2022-05-12 17:54:42.18085
22177,15,906,12,41,212,1186,2022-05-12 17:54:45.343462
22179,17,1715,12,77,228,2049,2022-05-12 17:54:47.231856
22181,29,543,7,31,150,760,2022-05-12 17:54:49.374977
22189,2666,19350,1793,3405,15941,43155,2022-05-12 17:54:52.47101
22199,79429,1419337,33886,56626,240808,1830086,2022-05-12 17:54:53.940734
22205,30,381,2,43,131,587,2022-05-12 17:54:55.981182
22219,12,66,7,91,92,268,2022-05-12 17:54:58.03104
22221,19,316,20,123,145,623,2022-05-12 17:55:00.113343
22225,2434,10708,1477,5048,11895,31562,2022-05-12 17:55:02.780822
22231,32,324,19,46,265,686,2022-05-12 17:55:04.813202
22239,14,199,9,41,163,426,2022-05-12 17:55:06.017983
22247,23,105,18,65,211,422,2022-05-12 17:55:07.852551
22249,60,1636,23,52,730,2501,2022-05-12 17:55:10.206455
22255,16,684,4,40,118,862,2022-05-12 17:55:11.888802
22271,25,111,9,58,227,430,2022-05-12 17:55:14.993561
22273,6454,75048,4114,7006,47975,140597,2022-05-12 17:55:16.508861
22279,11,44,5,65,87,212,2022-05-12 17:55:19.317143
22293,16,310,9,31,131,497,2022-05-12 17:55:21.41657
22295,143,1966,72,86,2191,4458,2022-05-12 17:55:24.529321
22297,31104,753304,12278,8172,135031,939889,2022-05-12 17:55:24.951195
22319,93885,2085659,31979,50741,210393,2472657,2022-05-12 17:55:27.945939
22327,19,110,5,44,112,290,2022-05-12 17:55:30.670264
22329,15,146,8,50,167,386,2022-05-12 17:55:31.855074
22345,23,242,7,58,121,451,2022-05-12 17:55:33.754267
22361,21,340,16,38,223,638,2022-05-12 17:55:35.411699
22377,246,3684,136,638,1656,6360,2022-05-12 17:55:38.478977
24121,15,71,9,47,83,225,2022-05-12 18:06:55.514201
22381,59,542,43,145,416,1205,2022-05-12 17:55:41.650113
22385,13,686,2,34,110,845,2022-05-12 17:55:43.974659
22393,10,161,4,31,72,278,2022-05-12 17:55:49.241043
22411,9,333,6,37,78,463,2022-05-12 17:55:50.531753
22417,17,364,4,37,90,512,2022-05-12 17:55:54.115375
22419,263,3303,181,323,3732,7802,2022-05-12 17:55:56.757417
22427,9,361,3,38,57,468,2022-05-12 17:55:58.306969
22433,4314,47907,2522,3019,29626,87388,2022-05-12 17:55:58.849783
22439,23,251,16,67,204,561,2022-05-12 17:56:01.032312
22441,19,222,19,66,234,560,2022-05-12 17:56:02.817035
22443,34,611,10,52,239,946,2022-05-12 17:56:04.601488
22445,13,203,5,45,118,384,2022-05-12 17:56:05.792548
22447,20,284,5,52,143,504,2022-05-12 17:56:08.281397
22449,14,208,3,47,119,391,2022-05-12 17:56:09.479475
22451,14,220,3,52,112,401,2022-05-12 17:56:10.590733
22457,10,141,7,45,99,302,2022-05-12 17:56:13.558937
22461,15,202,6,45,122,390,2022-05-12 17:56:17.926419
22465,43,102,20,97,354,616,2022-05-12 17:56:19.727708
22471,9,225,5,40,72,351,2022-05-12 17:56:22.701428
22479,12,198,8,44,122,384,2022-05-12 17:56:26.407017
22481,16,200,6,46,109,377,2022-05-12 17:56:27.488385
22483,15,197,3,46,117,378,2022-05-12 17:56:28.877989
22485,21,264,3,48,140,476,2022-05-12 17:56:30.593003
22489,21,256,4,47,104,432,2022-05-12 17:56:33.129824
22491,18,201,6,43,117,385,2022-05-12 17:56:34.351923
22493,17,161,5,47,105,335,2022-05-12 17:56:35.386003
22495,13,175,5,44,110,347,2022-05-12 17:56:37.019954
22497,27,405,11,57,247,747,2022-05-12 17:56:38.789756
22503,22,116,14,115,194,461,2022-05-12 17:56:41.356651
22507,2830,82175,1010,655,27733,114403,2022-05-12 17:56:41.797444
22509,24,124,21,60,231,460,2022-05-12 17:56:43.145334
22511,19,199,27,118,137,500,2022-05-12 17:56:44.510165
22513,30,2333,15,28,304,2710,2022-05-12 17:56:46.715569
22523,11,39,4,41,97,192,2022-05-12 17:56:47.893107
22535,83173,1229273,39319,29038,240857,1621660,2022-05-12 17:56:48.205641
22537,1607,34160,775,776,7303,44621,2022-05-12 17:56:51.559644
22547,7296,64006,4678,13328,27872,117180,2022-05-12 17:56:55.121408
22563,13,182,5,44,103,347,2022-05-12 17:56:59.209896
22567,13,149,2,41,86,291,2022-05-12 17:57:00.700078
22569,17,164,5,47,111,344,2022-05-12 17:57:01.7767
22571,13,222,6,59,122,422,2022-05-12 17:57:04.124435
22573,14,162,4,43,100,323,2022-05-12 17:57:05.946632
22583,182,2235,141,109,3958,6625,2022-05-12 17:57:11.343931
22585,34,37,6,94,102,273,2022-05-12 17:57:12.571352
22593,12,169,6,43,96,326,2022-05-12 17:57:14.541076
22595,8,68,5,45,72,198,2022-05-12 17:57:16.003443
22607,15,203,12,61,118,409,2022-05-12 17:57:21.152435
22609,12,133,4,46,70,265,2022-05-12 17:57:22.319231
22611,12,206,8,61,133,420,2022-05-12 17:57:24.110982
22615,12,134,6,42,96,290,2022-05-12 17:57:25.589747
22617,11,116,5,45,91,268,2022-05-12 17:57:26.701317
22619,10,105,7,44,87,253,2022-05-12 17:57:27.875423
22623,12,103,5,43,87,250,2022-05-12 17:57:30.282201
22625,15,127,6,46,101,295,2022-05-12 17:57:31.436382
22631,15,136,10,74,178,413,2022-05-12 17:57:32.941973
22633,13,114,9,72,140,348,2022-05-12 17:57:34.276811
22639,10,125,5,41,97,278,2022-05-12 17:57:37.897286
22657,14,106,7,45,79,251,2022-05-12 17:57:41.153002
22661,179,4898,183,224,2602,8086,2022-05-12 17:57:43.8151
22663,13113,202645,4878,10564,47114,278314,2022-05-12 17:57:44.236975
22669,77,0,21,109,143,350,2022-05-12 17:57:45.544799
22673,1927,46606,852,601,10208,60194,2022-05-12 17:57:48.665238
22675,16,205,12,66,145,444,2022-05-12 17:57:50.135634
43312,0,4,0,9,18,31,2022-05-12 21:42:18.978345
22689,1213,25235,928,1006,6074,34456,2022-05-12 17:57:59.093543
22695,202,8634,166,199,2754,11955,2022-05-12 17:57:59.705124
22699,274,11106,176,227,3295,15078,2022-05-12 17:58:02.000417
22729,18536,335814,10275,16628,97550,478803,2022-05-12 17:58:04.317193
22733,594,1406,423,1055,1311,4789,2022-05-12 17:58:07.717479
22735,269,643,164,615,699,2390,2022-05-12 17:58:09.425793
22745,299,16286,175,161,4013,20934,2022-05-12 17:58:13.446517
22755,20,94,7,92,121,334,2022-05-12 17:58:15.165703
22757,66,173,27,73,560,899,2022-05-12 17:58:18.188687
22759,628,21174,373,194,8064,30433,2022-05-12 17:58:21.765484
22777,7846,127698,3479,4231,18399,161653,2022-05-12 17:58:25.123231
22785,464,1793,179,248,4233,6917,2022-05-12 17:58:25.340084
22789,27744,378171,16516,9481,163395,595307,2022-05-12 17:58:25.731313
22817,1183,7696,870,1344,5764,16857,2022-05-12 17:58:29.448651
22819,185,4619,83,161,2087,7135,2022-05-12 17:58:33.569565
22821,30,120,13,115,158,436,2022-05-12 17:58:34.857392
22827,17,135,10,57,187,406,2022-05-12 17:58:36.749594
22835,4966,68883,2263,6311,30097,112520,2022-05-12 17:58:43.135374
22841,17,953,8,26,208,1212,2022-05-12 17:58:46.601078
22845,13,45,4,52,49,163,2022-05-12 17:58:47.75949
22847,193,5871,135,182,2937,9318,2022-05-12 17:58:49.904159
22849,76,192,31,80,805,1184,2022-05-12 17:58:51.857197
22851,10,77,2,64,93,246,2022-05-12 17:58:53.161871
22865,10036,102544,5024,6504,43146,167254,2022-05-12 17:58:56.225694
22893,55,121,35,84,569,864,2022-05-12 17:59:00.644707
22943,16,513,8,29,155,721,2022-05-12 17:59:02.237102
22953,16,156,4,42,69,287,2022-05-12 17:59:04.925308
22955,812,1575,817,1852,4327,9383,2022-05-12 17:59:07.262257
22961,2258,137522,824,482,20386,161472,2022-05-12 17:59:12.188632
22973,23,98,6,63,140,330,2022-05-12 17:59:14.487712
22975,15,143,10,74,132,374,2022-05-12 17:59:14.918347
22977,14,133,7,66,101,321,2022-05-12 17:59:16.558565
22979,22,125,9,51,177,384,2022-05-12 17:59:17.777049
22983,22,554,12,55,205,848,2022-05-12 17:59:20.074942
22991,9,87,6,70,76,248,2022-05-12 17:59:21.657625
22995,6,49,14,75,52,196,2022-05-12 17:59:23.635548
22999,15,74,6,88,143,326,2022-05-12 17:59:26.046597
23001,19,121,9,91,98,338,2022-05-12 17:59:27.157681
23003,14,68,8,106,117,313,2022-05-12 17:59:28.273407
23007,9,78,10,80,116,293,2022-05-12 17:59:31.117844
23009,12,89,8,84,158,351,2022-05-12 17:59:32.328993
23011,26,111,13,86,178,414,2022-05-12 17:59:33.529706
23015,11,71,11,72,94,259,2022-05-12 17:59:36.033135
23023,80,3071,61,111,1043,4366,2022-05-12 17:59:38.383734
23029,11,331,6,24,76,448,2022-05-12 17:59:39.749583
23031,21,72,12,55,234,394,2022-05-12 17:59:40.946147
23043,52,2670,27,43,607,3399,2022-05-12 17:59:45.04847
23053,18,476,8,29,231,762,2022-05-12 17:59:47.317651
23057,71,3274,18,61,779,4203,2022-05-12 17:59:51.372815
23059,24,1222,15,27,359,1647,2022-05-12 17:59:53.550002
23061,19,491,10,38,253,811,2022-05-12 17:59:54.898048
23063,37,1118,13,43,455,1666,2022-05-12 17:59:55.319922
23065,17,492,13,31,242,795,2022-05-12 17:59:56.614196
23067,285,2109,265,381,1158,4198,2022-05-12 17:59:58.967191
23083,74,1941,58,99,1109,3281,2022-05-12 18:00:04.672831
23089,14,441,5,56,70,586,2022-05-12 18:00:07.973345
23097,9,69,10,81,83,252,2022-05-12 18:00:09.053783
23099,63,2137,36,80,694,3010,2022-05-12 18:00:11.235593
23107,27,176,19,90,281,593,2022-05-12 18:00:11.469881
23115,215,3666,199,175,3502,7757,2022-05-12 18:00:14.348114
23121,4613,27954,3317,6902,21992,64778,2022-05-12 18:00:14.613984
23125,14,47,4,55,79,199,2022-05-12 18:00:17.343776
23129,17,281,13,38,212,561,2022-05-12 18:00:18.971937
23133,4653,19292,3653,7071,19789,54458,2022-05-12 18:00:21.82798
23137,205,1992,151,174,2591,5113,2022-05-12 18:00:25.060669
23149,13,164,10,100,147,434,2022-05-12 18:00:27.157243
23151,1001,4632,936,2543,5925,15037,2022-05-12 18:00:29.649752
23153,524,7245,317,171,4123,12380,2022-05-12 18:00:32.450993
23157,11,376,6,26,131,550,2022-05-12 18:00:33.811186
23179,237,2728,117,190,2047,5319,2022-05-12 18:00:37.676444
23183,21,104,25,115,120,385,2022-05-12 18:00:40.163023
23185,17,100,27,120,104,368,2022-05-12 18:00:41.593458
23187,17,109,27,119,115,387,2022-05-12 18:00:42.95455
23189,38,683,38,126,298,1183,2022-05-12 18:00:44.821457
23191,16,120,27,125,110,398,2022-05-12 18:00:46.068501
23201,1332,13956,1028,1217,8977,26510,2022-05-12 18:00:50.950135
23213,323,2969,240,700,2368,6600,2022-05-12 18:00:55.355311
23227,731,38573,367,168,8380,48219,2022-05-12 18:01:01.698578
23229,131,520,78,147,1444,2320,2022-05-12 18:01:04.75168
23233,29450,436712,12651,25206,93594,597613,2022-05-12 18:01:05.173556
23249,430,6275,201,159,5371,12436,2022-05-12 18:01:11.578744
23259,2600,10963,2214,4778,7384,27939,2022-05-12 18:01:18.817011
23267,17,360,9,61,98,545,2022-05-12 18:01:22.804418
23269,3233,44815,2176,1557,21982,73763,2022-05-12 18:01:25.411818
23273,101258,1394972,51631,47011,327222,1922094,2022-05-12 18:01:25.667478
23277,33108,347507,16344,17870,164810,579639,2022-05-12 18:01:27.72395
23279,1558,13945,542,353,25809,42207,2022-05-12 18:01:30.659141
23281,20952,409818,12532,13869,135468,592639,2022-05-12 18:01:34.421649
23283,44998,665621,23433,19948,264544,1018544,2022-05-12 18:01:34.75221
23289,42406,574412,23410,20912,171929,833069,2022-05-12 18:01:35.353304
23301,1264,22187,828,491,3048,27818,2022-05-12 18:01:36.170874
23317,5569,160631,2189,1726,49534,219649,2022-05-12 18:01:37.33125
23341,985,17289,730,798,6057,25859,2022-05-12 18:01:41.602445
23345,15,143,5,51,124,338,2022-05-12 18:01:44.60035
23349,20,379,17,94,99,609,2022-05-12 18:01:49.539998
23351,43,159,42,108,427,779,2022-05-12 18:01:53.137103
23353,23,88,6,45,169,331,2022-05-12 18:01:54.417961
23359,354,9116,369,355,6218,16412,2022-05-12 18:01:57.12411
23363,265,4368,234,246,3132,8245,2022-05-12 18:01:57.910856
23365,14,1097,10,38,161,1320,2022-05-12 18:02:04.549693
23367,71,1324,48,65,670,2178,2022-05-12 18:02:06.633105
23369,219,9697,199,196,4444,14755,2022-05-12 18:02:09.263878
23383,807,48807,376,178,9638,59806,2022-05-12 18:02:12.50634
23385,2061,85203,969,356,28144,116733,2022-05-12 18:02:15.49521
23387,65,756,32,76,580,1509,2022-05-12 18:02:17.034815
23393,16,296,14,95,117,538,2022-05-12 18:02:18.39173
23401,23,305,10,39,226,603,2022-05-12 18:02:20.081916
23405,459,5873,356,217,5544,12449,2022-05-12 18:02:20.316321
23407,14,56,3,51,98,222,2022-05-12 18:02:21.849239
23409,51,357,27,137,472,1044,2022-05-12 18:02:25.067583
23421,8636,98987,6319,5986,37827,157755,2022-05-12 18:02:27.966759
23425,243,3718,254,157,4978,9350,2022-05-12 18:02:34.596862
23427,359,20834,168,91,3087,24539,2022-05-12 18:02:37.345021
23433,596,8370,305,520,3683,13474,2022-05-12 18:02:40.479384
23439,108,3297,42,43,1287,4777,2022-05-12 18:02:43.378521
23447,767,33900,390,205,9560,44822,2022-05-12 18:02:47.412504
23459,450,12755,217,119,5486,19027,2022-05-12 18:02:50.504237
23483,23,1698,6,25,213,1965,2022-05-12 18:02:52.710774
23487,635,6701,417,286,5703,13742,2022-05-12 18:02:56.382923
23499,179,843,167,105,1102,2396,2022-05-12 18:02:58.702735
23517,16,486,4,49,133,688,2022-05-12 18:03:04.22917
23523,26,76,9,65,224,400,2022-05-12 18:03:05.597854
23537,6,64,5,66,93,234,2022-05-12 18:03:06.720717
23539,2678,1,1127,1037,6024,10867,2022-05-12 18:03:06.980776
23551,455,8150,243,397,2800,12045,2022-05-12 18:03:09.590361
23575,13,104,6,52,93,268,2022-05-12 18:03:13.81932
23579,1396,6512,816,921,3395,13040,2022-05-12 18:03:16.667322
23581,31,356,19,58,404,868,2022-05-12 18:03:18.627625
23585,16,182,8,55,161,422,2022-05-12 18:03:20.373747
23587,4851,33886,2947,3033,25673,70390,2022-05-12 18:03:23.5807
23593,17,62,4,41,109,233,2022-05-12 18:03:24.826743
23595,28,345,32,64,478,947,2022-05-12 18:03:26.504994
23597,20,252,9,48,157,486,2022-05-12 18:03:27.9187
23607,14,93,10,68,142,327,2022-05-12 18:03:29.660015
23613,15,80,3,67,86,251,2022-05-12 18:03:33.453272
23615,21,179,15,49,286,550,2022-05-12 18:03:34.831903
23617,12,126,7,70,98,313,2022-05-12 18:03:36.187906
23621,27,164,10,40,263,504,2022-05-12 18:03:38.566843
23623,9893,111457,5299,2613,51302,180564,2022-05-12 18:03:38.764883
23633,10,66,12,77,86,251,2022-05-12 18:03:43.327982
23635,10,61,10,81,66,228,2022-05-12 18:03:44.387762
23637,9,74,10,80,88,261,2022-05-12 18:03:45.921166
23639,16,214,5,54,100,389,2022-05-12 18:03:47.463214
23641,10,56,8,88,80,242,2022-05-12 18:03:48.560876
23643,12,133,5,55,94,299,2022-05-12 18:03:49.726387
23647,12,304,9,69,139,533,2022-05-12 18:03:52.13248
23651,12,112,17,82,75,298,2022-05-12 18:03:54.175425
23659,19,160,17,63,248,507,2022-05-12 18:03:56.004309
23661,23,195,9,47,192,466,2022-05-12 18:03:57.271956
23673,16706,307678,7839,15320,72149,419692,2022-05-12 18:03:57.442477
23675,15,96,20,73,236,440,2022-05-12 18:04:03.262874
23701,1079,44263,705,654,13299,60000,2022-05-12 18:04:13.821165
23703,301,11941,172,152,4035,16601,2022-05-12 18:04:16.200849
23707,18,110,6,55,107,296,2022-05-12 18:04:17.911628
23709,12,76,5,31,72,196,2022-05-12 18:04:19.108191
23711,19,350,9,50,189,617,2022-05-12 18:04:20.81025
23713,10,35,4,43,52,144,2022-05-12 18:04:22.054642
23721,22,118,14,69,145,368,2022-05-12 18:04:23.406907
23725,1083,12981,514,282,8318,23178,2022-05-12 18:04:26.867665
23727,9,38,4,39,63,153,2022-05-12 18:04:27.947765
23735,349,4596,187,177,2200,7509,2022-05-12 18:04:33.85104
23737,75,87,74,126,202,564,2022-05-12 18:04:35.664043
23739,12,165,3,42,149,371,2022-05-12 18:04:37.064052
23753,53,472,32,62,563,1182,2022-05-12 18:04:39.310263
23755,73758,1507260,27444,47994,156825,1813281,2022-05-12 18:04:39.504312
23763,14,162,4,53,110,343,2022-05-12 18:04:42.491789
23765,11,120,10,49,174,364,2022-05-12 18:04:44.133577
23769,17,61,5,46,101,230,2022-05-12 18:04:47.6832
23775,1858,70249,1048,1192,30252,104599,2022-05-12 18:04:48.12075
23777,2163,68722,1103,1275,34882,108145,2022-05-12 18:04:48.540376
23779,18,125,11,82,197,433,2022-05-12 18:04:50.685634
23781,415,4139,376,295,2627,7852,2022-05-12 18:04:53.308842
23787,620,5769,504,1168,3140,11201,2022-05-12 18:04:56.474617
23799,10,78,7,73,77,245,2022-05-12 18:04:58.263281
23801,10,55,4,55,93,217,2022-05-12 18:04:59.651544
23815,15,117,16,86,147,381,2022-05-12 18:05:01.284086
23819,22,95,8,46,206,377,2022-05-12 18:05:04.483837
23825,22,447,10,39,235,753,2022-05-12 18:05:05.99078
23831,330,7710,285,308,5686,14319,2022-05-12 18:05:07.333059
23835,31,1315,12,34,300,1692,2022-05-12 18:05:08.971492
23837,54,1678,11,44,435,2222,2022-05-12 18:05:10.917672
23847,31256,761425,11788,8484,114838,927791,2022-05-12 18:05:11.167674
23849,125,4306,140,190,2479,7240,2022-05-12 18:05:13.779365
23855,17,126,12,48,188,391,2022-05-12 18:05:15.43263
23857,23,92,9,68,106,298,2022-05-12 18:05:17.646142
23863,13,57,6,55,78,209,2022-05-12 18:05:19.850736
23865,12,79,4,54,137,286,2022-05-12 18:05:21.945088
23871,64,1150,59,91,1075,2439,2022-05-12 18:05:25.568947
23877,44,1758,14,44,481,2341,2022-05-12 18:05:27.704096
23881,24,113,11,47,144,339,2022-05-12 18:05:29.273029
23885,9,116,7,39,94,265,2022-05-12 18:05:30.32211
23889,17,87,9,46,192,351,2022-05-12 18:05:33.370343
23897,95,404,62,135,617,1313,2022-05-12 18:05:36.916187
23899,17,113,12,66,180,388,2022-05-12 18:05:38.418849
23901,32,288,23,106,369,818,2022-05-12 18:05:40.100383
23903,17,660,7,39,238,961,2022-05-12 18:05:42.187199
23909,13,201,4,46,99,363,2022-05-12 18:05:43.520931
23911,11,58,10,87,91,257,2022-05-12 18:05:44.586206
23917,11,245,3,21,56,336,2022-05-12 18:05:47.913429
23933,57,1287,50,101,695,2190,2022-05-12 18:05:50.362166
23935,57,1207,54,107,686,2111,2022-05-12 18:05:52.877476
23943,102,735,71,97,1300,2305,2022-05-12 18:05:55.258487
23945,4424,37960,2654,4562,19745,69345,2022-05-12 18:05:58.608334
23967,9,65,4,52,78,208,2022-05-12 18:06:00.01103
23969,14,112,16,94,167,403,2022-05-12 18:06:01.320353
23971,11,101,14,97,105,328,2022-05-12 18:06:02.42451
23979,20,46,7,47,218,338,2022-05-12 18:06:06.08095
23987,626,16517,290,178,12897,30508,2022-05-12 18:06:10.722916
23989,789,15491,371,313,6258,23222,2022-05-12 18:06:14.278385
23991,148,3731,70,144,1657,5750,2022-05-12 18:06:17.115926
24011,3405,21919,2037,10143,10200,47704,2022-05-12 18:06:19.964656
24023,0,0,0,0,1248,1248,2022-05-12 18:06:23.217331
24029,427,7289,186,153,3534,11589,2022-05-12 18:06:25.936422
24031,7583,61282,4560,6614,41476,121515,2022-05-12 18:06:28.847234
24041,12,49,7,75,76,219,2022-05-12 18:06:31.145113
24045,22,98,13,34,171,338,2022-05-12 18:06:33.504076
24051,14,152,7,34,87,294,2022-05-12 18:06:37.336009
24071,21,382,25,68,337,833,2022-05-12 18:06:40.536222
24073,27,140,16,62,208,453,2022-05-12 18:06:42.527433
24085,16,59,6,49,159,289,2022-05-12 18:06:49.317146
24089,27,184,17,40,235,503,2022-05-12 18:06:51.319827
24123,42,1218,34,78,684,2056,2022-05-12 18:06:57.584869
24127,43,1021,19,32,606,1721,2022-05-12 18:07:00.163228
24133,17176,182633,7043,11350,63615,281817,2022-05-12 18:07:04.452941
24135,2820,25488,1851,2782,21249,54190,2022-05-12 18:07:07.631833
24139,29,946,18,49,391,1433,2022-05-12 18:07:09.987263
24151,3077,105712,1537,612,20695,131633,2022-05-12 18:07:10.406901
24159,15,103,8,51,195,372,2022-05-12 18:07:11.957748
24169,97,4562,85,118,1544,6406,2022-05-12 18:07:14.638374
24175,2159,18884,991,893,10062,32989,2022-05-12 18:07:18.698817
24179,19,902,7,16,88,1032,2022-05-12 18:07:21.434238
24181,11,935,4,48,128,1126,2022-05-12 18:07:23.827393
24197,15,809,4,21,106,955,2022-05-12 18:07:25.395643
24199,14,775,6,22,93,910,2022-05-12 18:07:26.691074
24201,13,731,4,24,96,868,2022-05-12 18:07:27.974587
24211,4077,73361,2061,4268,19150,102917,2022-05-12 18:07:29.031242
24231,7475,138533,4477,3751,34661,188897,2022-05-12 18:07:33.229739
24237,18,163,3,46,113,343,2022-05-12 18:07:35.138211
24257,14,102,5,43,123,287,2022-05-12 18:07:36.567611
24259,26,193,11,44,179,453,2022-05-12 18:07:36.991941
24269,19,110,10,53,145,337,2022-05-12 18:07:40.131685
24275,47,254,62,88,599,1050,2022-05-12 18:07:42.752766
24277,6946,94479,3694,2690,16860,124669,2022-05-12 18:07:43.315241
24315,12,197,3,28,49,289,2022-05-12 18:07:44.481545
24321,14,724,4,22,113,877,2022-05-12 18:07:46.255416
24347,152,7419,94,126,1703,9494,2022-05-12 18:07:46.66043
24355,13,113,7,43,68,244,2022-05-12 18:07:48.092731
24365,499,24676,334,138,4279,29926,2022-05-12 18:07:51.424402
24371,108,2332,72,117,1602,4231,2022-05-12 18:07:53.647913
24373,16,207,11,71,252,557,2022-05-12 18:07:54.729718
24405,47302,129441,25191,31353,127338,360625,2022-05-12 18:07:57.624866
24415,30268,540956,10735,6481,72111,660551,2022-05-12 18:07:58.046741
24429,58,5516,28,73,682,6357,2022-05-12 18:08:02.40188
24437,41,372,14,91,227,745,2022-05-12 18:08:05.135421
24441,22,129,4,56,74,285,2022-05-12 18:08:09.838796
24443,21,274,8,67,208,578,2022-05-12 18:08:11.345941
24447,13,107,3,63,111,297,2022-05-12 18:08:13.340306
24455,18135,215572,8026,12882,61188,315803,2022-05-12 18:08:15.01197
24457,138,1223,101,111,1240,2813,2022-05-12 18:08:17.503536
24465,13,61,11,58,74,217,2022-05-12 18:08:19.371872
24469,435,20437,181,147,3216,24416,2022-05-12 18:08:22.677257
24471,832,9754,581,226,4630,16023,2022-05-12 18:08:26.319927
24475,2122,36270,1394,594,8734,49114,2022-05-12 18:08:28.950884
24489,23,99,6,39,179,346,2022-05-12 18:08:30.155624
24501,41,30,13,69,160,313,2022-05-12 18:08:32.71144
24527,37,573,22,35,327,994,2022-05-12 18:08:34.587003
24531,2640,18444,983,1151,14507,37725,2022-05-12 18:08:37.512345
24543,1224,42075,549,291,21289,65428,2022-05-12 18:08:38.469476
24573,20,126,25,117,110,398,2022-05-12 18:08:40.39221
24591,85,4085,41,103,937,5251,2022-05-12 18:08:46.79779
24603,13,189,4,69,113,388,2022-05-12 18:08:47.945756
24619,29,203,7,62,208,509,2022-05-12 18:08:49.767114
24627,2557,66782,1407,848,15877,87471,2022-05-12 18:08:55.141891
24629,5278,30609,4136,7478,27796,75297,2022-05-12 18:08:57.470375
24637,43,445,21,47,351,907,2022-05-12 18:09:00.33816
24655,3156,134550,1374,694,38751,178525,2022-05-12 18:09:05.287138
24675,30,361,15,78,259,743,2022-05-12 18:09:14.1096
24681,12,134,4,46,128,324,2022-05-12 18:09:19.836364
24687,1826,59041,803,395,27985,90050,2022-05-12 18:09:21.298416
24695,666,31725,312,188,7646,40537,2022-05-12 18:09:25.717494
24699,2576,12264,1632,3141,12819,32432,2022-05-12 18:09:28.556323
24701,12433,117253,5811,2811,96952,235260,2022-05-12 18:09:28.978182
24703,22512,615804,8623,11418,58645,717002,2022-05-12 18:09:32.258265
24705,9169,75484,5528,13081,43672,146934,2022-05-12 18:09:35.589185
24713,106,6147,76,79,1269,7677,2022-05-12 18:09:38.999691
24719,50,171,17,60,443,741,2022-05-12 18:09:42.031788
24727,538,16689,369,261,6160,24017,2022-05-12 18:09:42.919199
24763,95,1579,63,52,1157,2946,2022-05-12 18:09:47.515054
24765,23186,234116,15224,16714,113937,403177,2022-05-12 18:09:47.93701
24775,33,18,7,67,103,228,2022-05-12 18:09:49.846778
24781,2569,24506,1051,647,17717,46490,2022-05-12 18:09:52.516656
24791,6,65,7,57,64,199,2022-05-12 18:09:57.976223
24793,24,313,15,62,255,669,2022-05-12 18:10:00.046972
24795,5,69,6,57,68,205,2022-05-12 18:10:01.129684
24797,8,54,5,38,47,152,2022-05-12 18:10:02.1569
24803,7,40,4,59,55,165,2022-05-12 18:10:03.31197
24809,12,89,5,55,71,232,2022-05-12 18:10:04.99006
24817,106,593,67,93,593,1452,2022-05-12 18:10:08.124936
24823,121,4828,40,100,1332,6421,2022-05-12 18:10:15.852726
24833,104053,1248331,65423,55909,244813,1718529,2022-05-12 18:10:16.118351
24835,287,4546,178,399,1578,6988,2022-05-12 18:10:18.602499
24843,7,236,3,36,55,337,2022-05-12 18:10:21.201665
24845,67,45,24,146,220,502,2022-05-12 18:10:23.060175
24855,2838,12811,1907,6071,17056,40683,2022-05-12 18:10:27.317012
24859,13,68,6,48,117,252,2022-05-12 18:10:30.132215
24861,6,326,3,52,73,460,2022-05-12 18:10:33.023821
24865,7,60,7,56,90,220,2022-05-12 18:10:34.44848
24873,8740,92925,4319,9454,28969,144407,2022-05-12 18:10:35.859127
24875,13,74,7,58,81,233,2022-05-12 18:10:37.836862
24877,18,160,13,47,141,379,2022-05-12 18:10:40.227131
24881,12,141,19,105,112,389,2022-05-12 18:10:41.386336
24883,12,167,7,47,134,367,2022-05-12 18:10:43.252382
24893,5001,76608,2843,2402,24305,111159,2022-05-12 18:10:47.286594
24901,6,228,3,38,54,329,2022-05-12 18:10:48.612086
24913,722,35997,348,186,8461,45714,2022-05-12 18:10:54.538879
24919,703,15055,352,234,8470,24814,2022-05-12 18:10:57.524002
24921,907,16115,451,300,11434,29207,2022-05-12 18:10:57.932604
24923,7,56,3,64,68,198,2022-05-12 18:10:59.091115
24969,17,97,7,72,103,296,2022-05-12 18:11:05.458377
24975,65,878,58,77,1051,2129,2022-05-12 18:11:08.708006
24977,73,0,27,77,134,311,2022-05-12 18:11:08.926756
24981,11,117,13,93,81,315,2022-05-12 18:11:10.119021
24985,47,254,19,91,272,683,2022-05-12 18:11:11.84832
24989,30,169,15,77,223,514,2022-05-12 18:11:13.464918
24991,4330,126793,2276,2234,32098,167731,2022-05-12 18:11:16.648889
24997,2242,89425,840,788,26199,119494,2022-05-12 18:11:21.15025
24999,6,247,4,44,59,360,2022-05-12 18:11:23.064128
25013,40453,459830,23352,22138,197926,743699,2022-05-12 18:11:26.171317
25015,3127,99444,1436,866,42949,147822,2022-05-12 18:11:26.599419
25033,27,249,11,60,195,542,2022-05-12 18:11:33.705418
25049,57,254,32,111,201,655,2022-05-12 18:11:38.085115
25051,7,72,3,47,82,211,2022-05-12 18:11:39.201839
25059,16,70,7,56,59,208,2022-05-12 18:11:43.449596
25063,17,93,8,75,92,285,2022-05-12 18:11:46.387858
25071,15,110,4,55,142,326,2022-05-12 18:11:52.11778
25073,14,119,8,55,143,339,2022-05-12 18:11:53.380885
25075,18,100,7,60,147,332,2022-05-12 18:11:54.806906
25077,71,703,57,98,1291,2220,2022-05-12 18:11:57.041605
25081,16,107,10,60,146,339,2022-05-12 18:11:59.646901
25085,15,92,3,57,113,280,2022-05-12 18:12:02.54047
25089,13,150,8,73,150,394,2022-05-12 18:12:05.318992
25093,9,56,3,58,80,206,2022-05-12 18:12:07.80343
25095,8,36,3,47,50,144,2022-05-12 18:12:08.961524
25099,13265,160989,5101,8105,61383,248843,2022-05-12 18:12:11.819646
25101,8,104,2,44,48,206,2022-05-12 18:12:12.945697
25103,8,158,4,35,39,244,2022-05-12 18:12:15.005333
25113,53,982,23,44,475,1577,2022-05-12 18:12:17.272481
25117,488,3484,334,218,4894,9418,2022-05-12 18:12:17.602677
25139,21,93,12,58,160,344,2022-05-12 18:12:19.120093
25143,389,15799,159,233,5872,22452,2022-05-12 18:12:22.436447
25149,10,179,2,38,87,316,2022-05-12 18:12:24.288257
25157,31048,551103,13835,25350,126907,748243,2022-05-12 18:12:24.695167
25161,1190,68508,420,338,7800,78256,2022-05-12 18:12:33.385606
25169,73,532,57,76,993,1731,2022-05-12 18:12:35.078773
25173,13,313,7,55,112,500,2022-05-12 18:12:38.128463
25183,37299,310821,20305,23919,124115,516459,2022-05-12 18:12:39.037338
25241,1600,39029,1021,1638,7937,51225,2022-05-12 18:12:43.357385
25253,49,117,27,45,467,705,2022-05-12 18:12:47.201817
25257,185,1915,128,137,3533,5898,2022-05-12 18:12:49.440426
25259,175,2573,134,131,3571,6584,2022-05-12 18:12:52.498135
25265,53,706,26,51,681,1517,2022-05-12 18:12:54.330635
25267,51,547,29,56,397,1080,2022-05-12 18:12:56.046287
25363,26,295,15,69,238,643,2022-05-12 18:13:17.639049
25283,11485,161422,3996,10599,43708,231210,2022-05-12 18:12:58.598167
25285,1305,25780,617,414,7018,35134,2022-05-12 18:13:04.62614
25299,9,56,3,60,77,205,2022-05-12 18:13:10.341591
25303,1523,99245,700,400,17131,118999,2022-05-12 18:13:11.018125
25305,14,101,5,48,185,353,2022-05-12 18:13:13.054478
25313,871,23971,422,329,10771,36364,2022-05-12 18:13:13.492416
25329,11,53,4,61,93,222,2022-05-12 18:13:15.808772
25341,863,10123,891,288,3445,15610,2022-05-12 18:13:16.230615
25365,76,4697,84,113,1322,6292,2022-05-12 18:13:20.40963
25377,11,221,5,42,69,348,2022-05-12 18:13:22.443057
25389,1301,141345,361,320,8859,152186,2022-05-12 18:13:23.054349
25397,20695,377945,10263,24482,69177,502562,2022-05-12 18:13:25.082124
25429,7193,83985,3736,10581,30556,136051,2022-05-12 18:13:29.150777
25431,546,4133,199,265,4870,10013,2022-05-12 18:13:32.443513
25439,64,2383,53,65,1010,3575,2022-05-12 18:13:34.853306
25441,86,683,71,86,923,1849,2022-05-12 18:13:36.876968
25461,17,418,4,32,100,571,2022-05-12 18:13:38.57925
25473,15,65,3,43,117,243,2022-05-12 18:13:39.939607
25491,44,516,22,51,361,994,2022-05-12 18:13:41.864783
25495,16,1227,8,22,168,1441,2022-05-12 18:13:43.464378
25503,23,90,12,90,144,359,2022-05-12 18:13:44.976843
25517,8123,64797,5917,5637,27438,111912,2022-05-12 18:13:45.226843
25519,7954,62906,5023,6277,57925,140085,2022-05-12 18:13:49.259408
25533,10,345,5,23,43,426,2022-05-12 18:13:51.044938
25537,7566,257033,2278,1017,114375,382269,2022-05-12 18:13:51.201261
25541,13,179,8,51,154,405,2022-05-12 18:13:53.253801
25543,68,909,45,86,701,1809,2022-05-12 18:13:55.539017
25545,8,191,2,33,36,270,2022-05-12 18:13:56.887543
25567,428,23049,248,424,5873,30022,2022-05-12 18:14:02.590769
25589,9,81,4,57,55,206,2022-05-12 18:14:03.838224
25597,9,76,5,57,101,248,2022-05-12 18:14:06.478859
25599,9,104,6,45,76,240,2022-05-12 18:14:08.144579
25601,14,58,3,61,99,235,2022-05-12 18:14:10.824212
25605,9,50,4,49,64,176,2022-05-12 18:14:11.941687
25607,8,36,4,58,60,166,2022-05-12 18:14:13.198917
25609,7,84,7,69,80,247,2022-05-12 18:14:14.798232
25617,8,63,4,51,51,177,2022-05-12 18:14:19.336573
25619,7,65,5,58,55,190,2022-05-12 18:14:20.44805
25623,37,80,12,61,387,577,2022-05-12 18:14:22.551566
25627,14,154,8,105,138,419,2022-05-12 18:14:22.957748
25633,6,39,4,42,67,158,2022-05-12 18:14:24.078013
25635,210,2046,210,137,2319,4922,2022-05-12 18:14:26.237999
25639,11,277,3,25,67,383,2022-05-12 18:14:27.43746
25641,29,1118,14,31,283,1475,2022-05-12 18:14:29.042027
25647,888,11238,825,313,4480,17744,2022-05-12 18:14:32.351186
25681,13677,255725,6488,4304,55589,335783,2022-05-12 18:14:37.57366
25687,2056,80606,800,764,23077,107303,2022-05-12 18:14:41.581943
25689,1105,10961,464,294,7946,20770,2022-05-12 18:14:44.292834
25719,158,7449,83,75,1921,9686,2022-05-12 18:14:49.278521
25729,408,4229,261,138,5957,10993,2022-05-12 18:14:52.980153
25731,12084,93524,5700,8610,59694,179612,2022-05-12 18:14:53.136402
25749,24,236,20,74,263,617,2022-05-12 18:14:54.691624
25755,238,6763,142,187,3772,11102,2022-05-12 18:14:58.153716
25777,81521,2022902,16588,14376,161391,2296778,2022-05-12 18:14:58.466216
25781,9767,371596,3009,1223,58330,443925,2022-05-12 18:14:58.781383
25805,310,40863,211,221,4211,45816,2022-05-12 18:15:02.333051
25809,20,84,6,60,130,300,2022-05-12 18:15:04.330617
25833,90,399,45,83,1794,2411,2022-05-12 18:15:07.131895
25835,29762,146263,21879,14942,194235,407081,2022-05-12 18:15:07.41311
25839,2938,35294,1578,3216,11964,54990,2022-05-12 18:15:12.342565
25859,4015,26595,2911,7327,16331,57179,2022-05-12 18:15:16.208383
25861,208,12221,104,78,2135,14746,2022-05-12 18:15:16.554875
25867,5987,28864,4866,9601,35239,84557,2022-05-12 18:15:19.860979
25875,282,3253,181,305,1743,5764,2022-05-12 18:15:27.337202
25879,8839,156704,4231,3715,53362,226851,2022-05-12 18:15:29.752878
25883,77,3843,27,35,719,4701,2022-05-12 18:15:32.322266
25889,29,385,13,54,266,747,2022-05-12 18:15:34.137168
25891,22,339,17,62,258,698,2022-05-12 18:15:36.014557
25915,45,474,22,55,740,1336,2022-05-12 18:15:41.529371
25921,16,119,10,59,132,336,2022-05-12 18:15:43.359375
25939,1473,11668,940,1247,8695,24023,2022-05-12 18:15:46.114397
25941,11,131,9,69,142,362,2022-05-12 18:15:47.312492
25943,399,3067,175,213,4577,8431,2022-05-12 18:15:50.332664
25963,7,311,7,64,93,482,2022-05-12 18:15:52.06438
25965,20,568,9,71,88,756,2022-05-12 18:15:53.566914
25967,18,465,10,75,98,666,2022-05-12 18:15:54.955804
25971,12,304,8,43,137,504,2022-05-12 18:15:57.397341
25973,23,326,2,41,79,471,2022-05-12 18:15:58.631705
25977,5,350,5,41,56,457,2022-05-12 18:16:00.252234
25979,10,150,3,40,62,265,2022-05-12 18:16:01.520578
25981,10,142,1,39,48,240,2022-05-12 18:16:02.664464
25985,5,368,6,51,66,496,2022-05-12 18:16:04.292453
25987,20,63,8,55,178,324,2022-05-12 18:16:05.536877
25991,78,1579,24,59,713,2453,2022-05-12 18:16:07.570718
26007,9,166,2,42,54,273,2022-05-12 18:16:09.690588
26009,7,117,3,35,53,215,2022-05-12 18:16:11.349255
26011,7,277,5,46,55,390,2022-05-12 18:16:13.18721
26013,9,258,6,59,55,387,2022-05-12 18:16:14.513317
26017,8,271,7,60,60,406,2022-05-12 18:16:17.411485
26019,237,3816,132,142,2356,6683,2022-05-12 18:16:19.905738
26023,1208,38905,479,287,12201,53080,2022-05-12 18:16:22.61296
26033,11,55,6,50,127,249,2022-05-12 18:16:24.790715
26035,25,250,10,49,269,603,2022-05-12 18:16:26.20693
26053,62,990,46,70,790,1958,2022-05-12 18:16:30.238993
26055,28094,810678,6994,4217,71959,921942,2022-05-12 18:16:30.573413
26057,797,25633,420,282,10531,37663,2022-05-12 18:16:32.185398
26063,98,1124,51,63,879,2215,2022-05-12 18:16:33.943917
26085,1947,22922,895,2801,10642,39207,2022-05-12 18:16:37.456024
26087,9,65,4,62,65,205,2022-05-12 18:16:39.203412
26089,8,56,5,62,54,185,2022-05-12 18:16:40.224693
26091,9,32,3,42,59,145,2022-05-12 18:16:41.471146
26093,11,36,3,51,65,166,2022-05-12 18:16:42.562239
26095,11,35,4,44,60,154,2022-05-12 18:16:46.192039
26105,8,35,2,51,56,152,2022-05-12 18:16:53.890776
26107,10,33,4,50,61,158,2022-05-12 18:16:55.58246
26109,10,33,4,45,61,153,2022-05-12 18:16:57.208478
26111,28,218,11,77,446,780,2022-05-12 18:16:58.908975
26117,17,175,9,66,181,448,2022-05-12 18:17:02.549017
26123,22355,17321,7699,1667,23225,72267,2022-05-12 18:17:06.634551
26133,11,42,2,41,64,160,2022-05-12 18:17:08.801413
26135,14,97,9,81,199,400,2022-05-12 18:17:10.09645
26149,9,48,2,52,42,153,2022-05-12 18:17:17.436723
26151,9,34,2,40,46,131,2022-05-12 18:17:18.887317
26157,13,64,6,58,105,246,2022-05-12 18:17:21.743828
26163,14,82,10,78,97,281,2022-05-12 18:17:24.129061
26165,5562,35759,4342,8330,40063,94056,2022-05-12 18:17:25.130785
26183,638,5991,285,187,5686,12787,2022-05-12 18:17:27.549353
26197,10,57,6,51,132,256,2022-05-12 18:17:31.286799
26199,6,73,3,54,58,194,2022-05-12 18:17:32.2916
26213,1728,66670,775,1028,16920,87121,2022-05-12 18:17:36.752802
26217,15,55,4,47,76,197,2022-05-12 18:17:38.674314
26221,8,32,3,45,42,130,2022-05-12 18:17:41.085023
26223,11,62,3,44,57,177,2022-05-12 18:17:43.117759
26227,12,35,2,44,58,151,2022-05-12 18:17:44.747565
26229,8,36,2,44,45,135,2022-05-12 18:17:45.784644
26233,6,32,4,43,48,133,2022-05-12 18:17:47.793766
26235,7,56,3,42,43,151,2022-05-12 18:17:48.764766
26237,14,48,9,54,99,224,2022-05-12 18:17:50.055076
26241,8,50,5,40,57,160,2022-05-12 18:17:51.887445
26243,51882,835251,22964,30170,219837,1160104,2022-05-12 18:17:52.153072
26255,6,33,3,42,41,125,2022-05-12 18:17:55.907136
26259,6,33,5,46,61,151,2022-05-12 18:18:00.08486
26267,11,47,6,42,106,212,2022-05-12 18:18:05.505985
26271,8,41,3,46,62,160,2022-05-12 18:18:06.921657
26281,8,39,3,45,109,204,2022-05-12 18:18:09.553776
26283,18,98,8,54,168,346,2022-05-12 18:18:10.958127
26289,9,47,5,49,71,181,2022-05-12 18:18:14.705855
26291,9,45,3,53,54,164,2022-05-12 18:18:16.500059
26295,8,34,3,49,61,155,2022-05-12 18:18:18.850874
26297,10,33,1,47,55,146,2022-05-12 18:18:20.57719
26301,11,77,7,36,109,240,2022-05-12 18:18:22.845417
26303,10,206,10,39,187,452,2022-05-12 18:18:24.160628
26305,10,44,3,50,51,158,2022-05-12 18:18:25.288401
26307,9,57,4,52,57,179,2022-05-12 18:18:26.470413
26313,8,62,5,54,73,202,2022-05-12 18:18:30.62804
26315,8,28,4,45,59,144,2022-05-12 18:18:31.702608
26317,7,31,3,50,44,135,2022-05-12 18:18:33.277502
26321,8,29,2,50,51,140,2022-05-12 18:18:35.564245
26325,6,30,4,46,43,129,2022-05-12 18:18:37.147893
26327,12,44,5,48,94,203,2022-05-12 18:18:38.35582
26329,10,33,4,48,52,147,2022-05-12 18:18:39.610191
26331,9,41,4,46,62,162,2022-05-12 18:18:40.581708
26335,14,77,3,43,99,236,2022-05-12 18:18:43.620322
26339,8,31,3,51,43,136,2022-05-12 18:18:45.706199
26345,6,37,3,50,53,149,2022-05-12 18:18:48.754736
26347,14,141,5,38,102,300,2022-05-12 18:18:49.886229
26349,11632,223596,5428,7038,71095,318789,2022-05-12 18:18:53.545855
26351,8215,57431,6197,10761,42041,124645,2022-05-12 18:18:53.988477
26359,231,6760,153,114,4546,11804,2022-05-12 18:18:56.304399
26395,544,15764,276,267,3624,20475,2022-05-12 18:18:59.172752
26441,8858,74417,6482,8859,43399,142015,2022-05-12 18:19:02.39021
26443,10136,76506,4629,10922,41973,144166,2022-05-12 18:19:06.041294
26447,9,167,3,39,65,283,2022-05-12 18:19:07.511488
26449,826,25470,487,685,8181,35649,2022-05-12 18:19:07.747432
26453,515,1396,447,1208,1088,4654,2022-05-12 18:19:11.453048
27369,7,82,9,74,74,246,2022-05-12 18:19:13.320784
27371,13,119,5,65,81,283,2022-05-12 18:19:14.58842
27373,11,100,6,62,79,258,2022-05-12 18:19:16.417845
27375,18,76,11,78,185,368,2022-05-12 18:19:19.475617
27377,9,54,6,84,71,224,2022-05-12 18:19:20.643602
27393,17,76,6,54,114,267,2022-05-12 18:19:29.405118
27405,18,329,9,50,120,526,2022-05-12 18:19:32.246079
27411,1043,21606,507,285,20254,43695,2022-05-12 18:19:35.21941
27417,698,27535,274,341,7330,36178,2022-05-12 18:19:36.1901
27419,253,4771,141,83,3140,8388,2022-05-12 18:19:38.837636
27437,15,212,4,39,109,379,2022-05-12 18:19:40.153393
27453,10,148,9,52,57,276,2022-05-12 18:19:43.427176
27457,13,202,10,85,74,384,2022-05-12 18:19:45.230631
27459,13,199,9,79,78,378,2022-05-12 18:19:46.903423
27461,11,104,7,52,52,226,2022-05-12 18:19:48.080437
27463,12,143,6,57,64,282,2022-05-12 18:19:49.180478
27467,13,132,5,68,59,277,2022-05-12 18:19:51.242802
27491,13,148,7,69,115,352,2022-05-12 18:19:53.01746
27493,13,93,6,63,76,251,2022-05-12 18:19:54.045358
27495,15,164,8,63,109,359,2022-05-12 18:19:55.140938
27497,16,127,4,66,90,303,2022-05-12 18:19:56.112877
27509,401,7834,214,190,4447,13086,2022-05-12 18:20:02.809561
27519,42,149,26,94,255,566,2022-05-12 18:20:04.267687
27521,36,91,16,103,129,375,2022-05-12 18:20:05.364104
27539,33,1036,20,58,361,1508,2022-05-12 18:20:11.122209
27551,14,74,11,62,81,242,2022-05-12 18:20:12.198951
27561,11,66,2,62,84,225,2022-05-12 18:20:16.520948
27567,63,1501,47,43,929,2583,2022-05-12 18:20:18.858416
27571,10,101,5,63,79,258,2022-05-12 18:20:21.805672
27573,14,833,6,56,147,1056,2022-05-12 18:20:23.754384
27575,21,102,14,105,197,439,2022-05-12 18:20:25.520105
27589,13,215,13,86,144,471,2022-05-12 18:20:29.900023
27601,1894,91847,982,514,22810,118047,2022-05-12 18:20:33.231991
27613,450,4652,397,325,3251,9075,2022-05-12 18:20:35.604109
27619,661,5744,345,286,5014,12050,2022-05-12 18:20:38.847187
27629,476,3909,362,625,3117,8489,2022-05-12 18:20:43.268366
27631,36831,288365,18133,35328,122851,501508,2022-05-12 18:20:43.617113
27633,3805,100053,1962,959,19521,126300,2022-05-12 18:20:43.929612
27651,30,202,29,58,392,711,2022-05-12 18:20:46.608358
27653,56,2940,31,93,609,3729,2022-05-12 18:20:47.605734
27655,9723,230931,5491,9728,35513,291386,2022-05-12 18:20:47.958713
43314,0,16,0,6,17,39,2022-05-12 21:42:21.190507
27663,4629,65240,2306,1433,11155,84763,2022-05-12 18:20:48.193124
27723,18,111,10,61,141,341,2022-05-12 18:20:51.472857
27727,5604,36089,4619,10143,21323,77778,2022-05-12 18:20:54.21605
27737,365,1373,206,435,1241,3620,2022-05-12 18:20:57.475215
27741,317,2620,272,455,2612,6276,2022-05-12 18:21:01.24903
27757,27,308,24,142,193,694,2022-05-12 18:21:03.792003
27775,41104,510233,24981,27508,224868,828694,2022-05-12 18:21:04.213878
43317,0,6,0,16,15,37,2022-05-12 21:42:23.269585
27783,2960,36316,1295,4152,17762,62485,2022-05-12 18:21:05.107171
27785,69,853,70,213,615,1820,2022-05-12 18:21:08.769024
27787,19649,503292,9994,12145,75787,620867,2022-05-12 18:21:08.940931
27789,23,860,11,30,173,1097,2022-05-12 18:21:14.586905
27793,17,2112,16,39,158,2342,2022-05-12 18:21:17.731032
27815,970,8899,560,1079,2704,14212,2022-05-12 18:21:18.580842
27821,4120,248434,1318,812,33139,287823,2022-05-12 18:21:21.359212
27825,139,2842,60,102,1536,4679,2022-05-12 18:21:25.56565
27831,14052,250269,8198,4032,85857,362408,2022-05-12 18:21:30.972379
27833,12968,228335,8028,4271,92886,346488,2022-05-12 18:21:35.789284
27839,9,30,3,49,88,179,2022-05-12 18:21:37.998312
27843,6,59,5,44,61,175,2022-05-12 18:21:40.747632
27845,12,46,5,51,64,178,2022-05-12 18:21:42.696156
27849,8,43,4,55,53,163,2022-05-12 18:21:46.614845
27851,9,45,3,53,69,179,2022-05-12 18:21:47.686538
27853,11,38,2,45,50,146,2022-05-12 18:21:48.688886
27855,8,51,4,53,64,180,2022-05-12 18:21:51.209116
27857,630,10898,402,477,3018,15425,2022-05-12 18:21:53.99082
27891,1753,92882,728,984,14371,110718,2022-05-12 18:21:55.038576
27899,48179,1386346,17643,38010,86458,1576636,2022-05-12 18:21:55.3667
27907,116,2889,52,103,1174,4334,2022-05-12 18:21:59.532908
27921,8,40,4,47,64,163,2022-05-12 18:22:06.413479
43383,0,8,0,19,18,45,2022-05-12 21:42:59.336581
27927,845,6833,422,1431,5483,15014,2022-05-12 18:22:08.908738
27939,204,7328,107,144,2315,10098,2022-05-12 18:22:11.603892
27945,550,7104,375,184,5949,14162,2022-05-12 18:22:14.287655
27947,5422,23112,3446,1938,28309,62227,2022-05-12 18:22:14.727676
27949,30,259,12,37,300,638,2022-05-12 18:22:18.676515
27951,25,195,15,31,199,465,2022-05-12 18:22:21.472514
27957,1878,75936,1001,551,19418,98784,2022-05-12 18:22:22.529969
27963,17,55,8,47,119,246,2022-05-12 18:22:25.733673
27965,12,62,10,57,61,202,2022-05-12 18:22:27.040431
27967,726,10255,346,184,6665,18176,2022-05-12 18:22:29.823973
27969,1159,13691,531,410,20550,36341,2022-05-12 18:22:33.252725
27989,20635,203928,12476,10299,156728,404066,2022-05-12 18:22:33.67835
27991,17912,196376,9861,8461,70532,303142,2022-05-12 18:22:37.215373
27993,16,150,11,100,150,427,2022-05-12 18:22:38.451945
27997,68,450,33,54,770,1375,2022-05-12 18:22:40.400038
43386,0,15,2,10,15,42,2022-05-12 21:43:00.582526
28013,7422,28057,3337,4240,27330,70386,2022-05-12 18:22:40.812348
28021,11,58,3,55,90,217,2022-05-12 18:22:43.761598
28023,10,46,2,72,78,208,2022-05-12 18:22:44.942093
28025,8426,276537,3423,1390,90897,380673,2022-05-12 18:22:48.598521
28041,30,1026,9,66,192,1323,2022-05-12 18:22:52.541227
28049,21,384,7,60,108,580,2022-05-12 18:22:58.694109
28051,20,559,6,61,117,763,2022-05-12 18:23:00.035166
28053,24,588,21,53,335,1021,2022-05-12 18:23:01.774017
28055,10,305,5,48,84,452,2022-05-12 18:23:02.999593
28057,9,323,5,43,75,455,2022-05-12 18:23:04.22056
28067,8,206,4,39,79,336,2022-05-12 18:23:08.614286
28069,1240,78909,686,361,18152,99348,2022-05-12 18:23:11.974708
28071,76,208,18,94,386,782,2022-05-12 18:23:14.121315
28073,9,53,3,55,83,203,2022-05-12 18:23:16.453563
28077,51,2499,28,41,460,3079,2022-05-12 18:23:18.888752
28087,16,77,18,64,146,321,2022-05-12 18:23:23.141699
28091,22,74,9,61,195,361,2022-05-12 18:23:25.75794
28097,14,78,5,46,107,250,2022-05-12 18:23:27.397996
28099,11,69,6,46,78,210,2022-05-12 18:23:28.897643
28103,22,214,15,75,242,568,2022-05-12 18:23:31.826403
28109,16,46,7,52,150,271,2022-05-12 18:23:36.221307
28113,8,51,4,54,63,180,2022-05-12 18:23:39.022226
28115,10,66,5,49,97,227,2022-05-12 18:23:40.102786
28117,11,69,9,55,123,267,2022-05-12 18:23:42.002932
28121,47553,1085080,17715,28020,157434,1335802,2022-05-12 18:23:43.231947
28143,25,478,7,64,220,794,2022-05-12 18:23:46.570684
28145,22,109,11,87,134,363,2022-05-12 18:23:47.667558
28151,36,278,15,43,273,645,2022-05-12 18:23:50.946509
28171,79313,1124698,33850,37827,188357,1464045,2022-05-12 18:23:53.886822
28179,130,4483,72,69,1369,6123,2022-05-12 18:23:58.092785
28185,14,122,6,50,97,289,2022-05-12 18:23:59.360062
28201,16,105,7,54,147,329,2022-05-12 18:24:03.493985
28205,1530,1146,877,544,1679,5776,2022-05-12 18:24:06.086118
28207,134,3224,102,140,1089,4689,2022-05-12 18:24:08.43648
28211,1822,22360,820,778,29030,54810,2022-05-12 18:24:12.456402
28215,1674,18537,916,1403,4911,27441,2022-05-12 18:24:13.426935
28223,74461,1073799,43679,33969,307264,1533172,2022-05-12 18:24:17.619211
28227,246,3243,138,128,2899,6654,2022-05-12 18:24:20.63968
28235,80,1618,35,76,1344,3153,2022-05-12 18:24:23.545166
28237,14,197,9,50,159,429,2022-05-12 18:24:24.931574
28241,15,744,8,65,156,988,2022-05-12 18:24:28.232936
28245,10,616,6,52,128,812,2022-05-12 18:24:31.341829
28249,25529,186032,17293,19310,96953,345117,2022-05-12 18:24:32.161854
28251,40,865,23,70,655,1653,2022-05-12 18:24:35.010091
28285,2320,103698,760,466,19677,126921,2022-05-12 18:24:40.718641
28293,11,82,6,60,93,252,2022-05-12 18:24:43.795894
28297,52532,327815,35024,34748,142598,592717,2022-05-12 18:24:46.392633
28299,892,38260,404,269,10327,50152,2022-05-12 18:24:47.309481
28339,24,1910,11,72,294,2311,2022-05-12 18:24:51.513904
28347,14,283,6,33,115,451,2022-05-12 18:24:52.782737
28351,85,5577,25,60,843,6590,2022-05-12 18:24:55.938333
28353,8,50,3,32,55,148,2022-05-12 18:24:58.433267
28355,6,210,2,33,42,293,2022-05-12 18:24:59.813059
28361,134,90,11,43,109,387,2022-05-12 18:25:01.120935
28367,29,300,18,62,352,761,2022-05-12 18:25:02.926552
28369,35,374,30,62,366,867,2022-05-12 18:25:04.451161
28381,67,802,27,74,439,1409,2022-05-12 18:25:08.462932
28385,139,1431,103,136,1519,3328,2022-05-12 18:25:10.689617
28391,9001,75716,5162,13001,37145,140025,2022-05-12 18:25:14.15097
28405,2797,88983,1221,928,27938,121867,2022-05-12 18:25:17.602724
28419,13,471,7,35,94,620,2022-05-12 18:25:19.651945
28423,8153,34409,6330,9964,24661,83517,2022-05-12 18:25:23.214317
28431,95,7559,72,123,1472,9321,2022-05-12 18:25:29.866827
28433,12,1288,9,38,241,1588,2022-05-12 18:25:31.999194
28447,384,10167,175,244,4084,15054,2022-05-12 18:25:36.146415
28479,539,28854,215,222,4167,33997,2022-05-12 18:25:36.571072
28483,6,36,4,44,48,138,2022-05-12 18:25:38.297348
28485,6,43,2,40,48,139,2022-05-12 18:25:39.462853
28487,5,35,2,43,37,122,2022-05-12 18:25:40.743849
28489,14,65,5,53,127,264,2022-05-12 18:25:41.968857
28497,27618,396991,11779,17530,115898,569816,2022-05-12 18:25:45.45321
28511,87,1925,47,90,916,3065,2022-05-12 18:25:48.539944
28531,182,3159,118,161,1313,4933,2022-05-12 18:25:51.2826
28537,2107,9404,1459,4178,11736,28884,2022-05-12 18:25:54.14271
28539,713,11045,317,257,10400,22732,2022-05-12 18:25:58.614546
28545,9,34,3,57,65,168,2022-05-12 18:26:01.896449
28551,4,49,3,57,52,165,2022-05-12 18:26:06.47574
28553,7,32,2,48,40,129,2022-05-12 18:26:07.437678
28559,7,36,2,47,40,132,2022-05-12 18:26:10.717264
28561,8,37,1,52,46,144,2022-05-12 18:26:12.104059
28567,7,46,2,63,49,167,2022-05-12 18:26:16.028383
28573,7,28,1,47,39,122,2022-05-12 18:26:19.168488
28575,8,45,3,44,44,144,2022-05-12 18:26:20.367785
28577,7,26,2,44,43,122,2022-05-12 18:26:21.377727
28579,8,91,3,53,61,216,2022-05-12 18:26:22.549163
28581,12,63,6,68,75,224,2022-05-12 18:26:23.702423
28583,13,73,6,67,80,239,2022-05-12 18:26:24.850734
28585,5,62,5,71,52,195,2022-05-12 18:26:26.41376
28587,10,539,7,26,128,710,2022-05-12 18:26:27.778106
28593,446,6440,275,178,4549,11888,2022-05-12 18:26:30.818786
28595,102,1232,61,340,332,2067,2022-05-12 18:26:33.530774
28603,132,2365,132,173,2027,4829,2022-05-12 18:26:35.740112
28607,1725,24615,1055,832,10546,38773,2022-05-12 18:26:39.150816
28617,13124,107057,8315,18262,68223,214981,2022-05-12 18:26:44.142879
28619,7628,55686,4693,12526,29797,110330,2022-05-12 18:26:44.408597
43390,0,8,0,13,13,34,2022-05-12 21:43:01.804234
28621,8477,76339,5989,8891,56479,156175,2022-05-12 18:26:47.083485
28623,48405,474352,16150,28091,154414,721412,2022-05-12 18:26:47.349111
28631,23,368,2,35,116,544,2022-05-12 18:26:51.440506
28637,17,821,16,43,217,1114,2022-05-12 18:26:54.574211
28639,9,654,9,30,133,835,2022-05-12 18:26:56.206852
28647,13,685,8,28,107,841,2022-05-12 18:27:03.096432
28653,10,202,5,29,83,329,2022-05-12 18:27:04.245963
28655,13,430,1,30,83,557,2022-05-12 18:27:05.478154
28657,14,869,5,39,141,1068,2022-05-12 18:27:08.050696
28673,404,1165,218,367,3678,5832,2022-05-12 18:27:12.884635
28675,5333,163668,2111,880,61044,233036,2022-05-12 18:27:13.353385
28677,29047,514046,14525,16444,121883,695945,2022-05-12 18:27:17.461137
28683,269,10196,190,221,3004,13880,2022-05-12 18:27:17.872346
28685,17,219,2,38,158,434,2022-05-12 18:27:20.288781
28687,17,656,6,30,82,791,2022-05-12 18:27:21.494133
28689,7,67,13,73,80,240,2022-05-12 18:27:22.579497
28691,15,757,4,42,108,926,2022-05-12 18:27:25.566859
28693,10,51,7,68,101,237,2022-05-12 18:27:26.776109
28695,45,538,9,67,215,874,2022-05-12 18:27:28.309657
28701,20010,639785,6215,4230,90470,760710,2022-05-12 18:27:28.719644
28713,524,13958,213,196,5528,20419,2022-05-12 18:27:33.074536
28723,74,752,32,120,707,1685,2022-05-12 18:27:39.186866
28725,8195,176020,2704,986,104591,292496,2022-05-12 18:27:39.452566
28735,18285,95866,11516,7838,130542,264047,2022-05-12 18:27:42.449212
28749,25,63,12,58,240,398,2022-05-12 18:27:44.288719
28755,7054,369400,1296,1717,33136,412603,2022-05-12 18:27:44.622082
28759,13,168,7,38,114,340,2022-05-12 18:27:48.07409
28761,70,7995,34,97,881,9077,2022-05-12 18:27:51.754935
28771,1011,53469,335,316,11737,66868,2022-05-12 18:27:53.873955
28789,185,10500,122,176,2733,13716,2022-05-12 18:27:58.70361
28805,8154,257349,2449,851,107559,376362,2022-05-12 18:28:02.723272
28809,44,288,30,68,536,966,2022-05-12 18:28:05.14903
28811,63,469,36,77,756,1401,2022-05-12 18:28:07.214639
28813,31,477,42,71,579,1200,2022-05-12 18:28:09.525174
28815,34,461,35,62,473,1065,2022-05-12 18:28:11.381303
28819,12532,182556,4481,9008,55943,264520,2022-05-12 18:28:18.434167
28825,32539,420159,17936,31899,115410,617943,2022-05-12 18:28:18.640046
28831,17,526,5,41,231,820,2022-05-12 18:28:28.751703
28833,10166,47330,4242,8066,40454,110258,2022-05-12 18:28:31.909848
28835,233,1595,134,314,1602,3878,2022-05-12 18:28:34.699532
28841,250,4460,140,106,4062,9018,2022-05-12 18:28:37.563909
28843,37,1990,9,43,426,2505,2022-05-12 18:28:39.976112
28851,39421,1661338,5405,2611,240530,1949305,2022-05-12 18:28:40.226049
28853,97,3368,91,127,1468,5151,2022-05-12 18:28:40.460516
28861,528,9345,294,608,2861,13636,2022-05-12 18:28:43.208368
28869,271,3619,161,208,1551,5810,2022-05-12 18:28:46.216248
28881,461,17391,189,208,6393,24642,2022-05-12 18:28:49.928457
28887,19,27,7,63,75,191,2022-05-12 18:28:54.073521
28891,54632,1056650,15104,7642,96123,1230151,2022-05-12 18:28:54.347521
28897,8,258,5,29,44,344,2022-05-12 18:28:56.800344
28907,31691,521466,13272,19494,126331,712254,2022-05-12 18:28:57.127776
28911,34,621,31,81,580,1347,2022-05-12 18:29:00.433442
28913,33,545,34,77,511,1200,2022-05-12 18:29:02.2183
28915,41,519,33,81,531,1205,2022-05-12 18:29:03.285027
28921,127,275,79,163,390,1034,2022-05-12 18:29:03.69159
28925,18,309,18,80,279,704,2022-05-12 18:29:06.98413
28927,23128,566157,9700,8592,82438,690015,2022-05-12 18:29:07.415484
28951,13,796,10,34,257,1110,2022-05-12 18:29:13.685132
28953,18,548,6,32,216,820,2022-05-12 18:29:15.220713
28955,6,295,5,33,72,411,2022-05-12 18:29:16.451952
28957,3112,60155,1216,660,49040,114183,2022-05-12 18:29:16.858414
28959,11,626,9,25,134,805,2022-05-12 18:29:20.4632
28963,49,512,19,45,588,1213,2022-05-12 18:29:23.493553
28965,10,51,3,51,73,188,2022-05-12 18:29:25.936486
28977,58969,219267,20890,14747,215861,529734,2022-05-12 18:29:26.376734
28979,9366,170275,4263,3805,45688,233397,2022-05-12 18:29:29.06849
28981,958,14205,594,2479,7303,25539,2022-05-12 18:29:33.33051
28983,11,138,5,61,164,379,2022-05-12 18:29:34.401172
28989,19,239,6,39,115,418,2022-05-12 18:29:37.092498
28993,18,613,8,41,233,913,2022-05-12 18:29:39.00547
43430,2,8,4,17,34,65,2022-05-12 21:43:27.759587
28999,51425,1070783,21608,28223,218903,1390942,2022-05-12 18:29:39.209671
29003,14,50,4,60,121,249,2022-05-12 18:29:41.945353
29027,2347,91569,746,684,16687,112033,2022-05-12 18:29:42.659133
29035,336,3745,180,226,2086,6573,2022-05-12 18:29:45.243149
29067,5411,147050,2413,1567,24371,180812,2022-05-12 18:29:45.855368
29073,13,187,3,48,67,318,2022-05-12 18:29:48.983051
29087,479,472,260,295,1790,3296,2022-05-12 18:29:51.687218
43431,3,8,6,16,29,62,2022-05-12 21:43:29.030773
29089,2390,5618,947,1172,13706,23833,2022-05-12 18:29:55.629187
29093,3977,172777,1146,698,29783,208381,2022-05-12 18:29:55.803316
29099,14,86,10,89,93,292,2022-05-12 18:29:57.987318
29101,2019,59691,981,710,10409,73810,2022-05-12 18:30:00.921064
29103,6,143,3,31,35,218,2022-05-12 18:30:02.069938
29107,7,278,4,34,55,378,2022-05-12 18:30:05.728918
29129,384,10908,239,233,4263,16027,2022-05-12 18:30:08.908805
29151,13,87,6,42,99,247,2022-05-12 18:30:14.38092
29153,8,206,4,36,53,307,2022-05-12 18:30:16.20283
29163,2940,20679,2095,2804,20783,49301,2022-05-12 18:30:17.213294
29165,427,3566,397,275,2859,7524,2022-05-12 18:30:19.95618
29173,19,476,5,37,112,649,2022-05-12 18:30:21.728764
29177,11,136,2,35,48,232,2022-05-12 18:30:23.379345
29179,4,181,2,35,36,258,2022-05-12 18:30:24.627624
29207,8,88,2,42,62,202,2022-05-12 18:30:27.162759
29209,9,41,3,46,50,149,2022-05-12 18:30:28.627597
29223,388,7964,267,322,5216,14157,2022-05-12 18:30:32.225894
29247,12,166,6,36,113,333,2022-05-12 18:30:38.64878
29249,12,123,7,36,98,276,2022-05-12 18:30:39.870015
29267,11,79,3,38,60,191,2022-05-12 18:30:44.016537
29269,13,84,4,44,67,212,2022-05-12 18:30:45.101622
29271,14,94,5,42,70,225,2022-05-12 18:30:46.110234
29275,9,65,1,45,65,185,2022-05-12 18:30:48.304383
29283,19,133,16,45,161,374,2022-05-12 18:30:49.602804
29291,12,749,4,21,100,886,2022-05-12 18:30:51.652009
29293,10,665,9,38,179,901,2022-05-12 18:30:53.190192
29301,315,6822,151,94,6846,14228,2022-05-12 18:30:55.720717
29311,12,444,6,31,88,581,2022-05-12 18:30:57.055784
29323,12,354,2,33,108,509,2022-05-12 18:31:01.825451
29347,25,1454,21,62,403,1965,2022-05-12 18:31:02.859679
29349,6,89,1,31,64,191,2022-05-12 18:31:03.986626
29355,5,153,3,27,43,231,2022-05-12 18:31:08.460777
29357,5,111,4,36,40,196,2022-05-12 18:31:09.515831
29359,13,84,8,51,65,221,2022-05-12 18:31:10.551712
29361,34,31,3,68,105,241,2022-05-12 18:31:12.007435
29365,7,32,2,43,59,143,2022-05-12 18:31:15.880976
29367,18,94,8,55,99,274,2022-05-12 18:31:17.207965
29371,11,42,3,42,53,151,2022-05-12 18:31:20.174696
29377,14,312,6,38,101,471,2022-05-12 18:31:25.522745
29379,6,45,8,49,63,171,2022-05-12 18:31:26.624583
29387,34,37,9,65,79,224,2022-05-12 18:31:32.04669
29391,11,201,4,48,67,331,2022-05-12 18:31:34.413605
29393,9,152,0,36,49,246,2022-05-12 18:31:36.085493
29395,8,201,1,41,53,304,2022-05-12 18:31:37.235313
29397,10,178,4,38,59,289,2022-05-12 18:31:38.444603
29399,36,27,10,87,119,279,2022-05-12 18:31:39.837042
29401,12,54,8,51,61,186,2022-05-12 18:31:41.039732
29403,11,51,6,53,49,170,2022-05-12 18:31:42.088026
29409,7,226,5,39,50,327,2022-05-12 18:31:43.178828
29411,11,551,12,84,124,782,2022-05-12 18:31:44.658922
29413,166,3043,111,167,1687,5174,2022-05-12 18:31:47.134717
29419,71,2454,73,119,1081,3798,2022-05-12 18:31:49.823663
29421,63,0,17,82,95,257,2022-05-12 18:31:50.69012
29425,37,16,6,60,71,190,2022-05-12 18:31:52.376817
29429,55,44,31,87,88,305,2022-05-12 18:31:53.830314
29437,79,2515,60,111,1040,3805,2022-05-12 18:31:55.061697
29467,14,65,5,58,66,208,2022-05-12 18:31:56.978824
29471,14,102,7,56,122,301,2022-05-12 18:31:58.478788
29473,13,50,3,63,57,186,2022-05-12 18:31:59.451167
29477,8,72,5,51,63,199,2022-05-12 18:32:01.103815
29479,9,48,2,56,46,161,2022-05-12 18:32:02.182892
29485,16,39,5,59,62,181,2022-05-12 18:32:04.154957
29491,11,45,4,54,60,174,2022-05-12 18:32:07.049861
29495,10,163,4,39,51,267,2022-05-12 18:32:09.492686
29497,7,70,7,44,52,180,2022-05-12 18:32:10.515113
29507,9,58,6,62,62,197,2022-05-12 18:32:16.913726
29511,393,7148,150,169,4291,12151,2022-05-12 18:32:19.717574
29513,567,12976,215,134,7106,20998,2022-05-12 18:32:21.115147
29515,44,486,45,76,734,1385,2022-05-12 18:32:22.915477
29517,53,859,40,69,810,1831,2022-05-12 18:32:24.797525
29527,15,70,9,68,149,311,2022-05-12 18:32:26.101074
29529,13,70,7,69,135,294,2022-05-12 18:32:27.236402
29535,13,134,7,47,95,296,2022-05-12 18:32:28.623681
29537,12,108,6,54,85,265,2022-05-12 18:32:29.77274
29539,14,116,4,48,88,270,2022-05-12 18:32:30.878881
29541,11,97,8,49,78,243,2022-05-12 18:32:31.764559
29543,8,66,5,48,75,202,2022-05-12 18:32:32.808731
29545,11,75,2,42,54,184,2022-05-12 18:32:33.928687
29555,11,267,4,40,62,384,2022-05-12 18:32:38.036547
29557,13,253,6,46,99,417,2022-05-12 18:32:39.708796
29559,11,199,4,52,61,327,2022-05-12 18:32:40.907893
29583,385,16172,256,217,5493,22523,2022-05-12 18:32:43.609993
29585,9,361,3,40,94,507,2022-05-12 18:32:45.042326
29587,9,221,3,42,54,329,2022-05-12 18:32:46.129166
29603,44,85,16,96,190,431,2022-05-12 18:32:50.844359
29609,13,283,1,36,75,408,2022-05-12 18:32:52.996089
29613,10,258,8,64,119,459,2022-05-12 18:32:56.088674
29615,9,868,6,35,106,1024,2022-05-12 18:32:57.571059
29619,9,766,7,38,107,927,2022-05-12 18:33:00.920812
29623,13,269,4,39,97,422,2022-05-12 18:33:02.423706
29633,9,350,7,41,99,506,2022-05-12 18:33:04.093161
29635,7,336,6,38,94,481,2022-05-12 18:33:05.348467
29637,8,315,8,40,97,468,2022-05-12 18:33:06.855186
29643,573,0,320,282,3638,4813,2022-05-12 18:33:07.259722
29647,12,206,5,40,62,325,2022-05-12 18:33:09.012984
29651,11,197,3,39,59,309,2022-05-12 18:33:10.812544
29673,8,275,4,41,94,422,2022-05-12 18:33:14.790387
29677,11,301,6,39,146,503,2022-05-12 18:33:17.514729
29679,9,245,2,39,112,407,2022-05-12 18:33:18.725755
29697,76,1207,51,89,858,2281,2022-05-12 18:33:22.325644
29707,33,1455,13,40,272,1813,2022-05-12 18:33:26.267611
29711,10,83,8,45,65,211,2022-05-12 18:33:31.95173
29712,11,54,8,50,103,226,2022-05-12 18:33:33.25264
29715,93,181,65,217,2019,2575,2022-05-12 18:33:35.080089
29719,9,76,5,37,55,182,2022-05-12 18:33:36.645464
29722,83,308,78,196,591,1256,2022-05-12 18:33:38.191202
29729,13,131,8,75,132,359,2022-05-12 18:33:40.74968
29733,8,47,5,49,71,180,2022-05-12 18:33:43.311631
29738,19,82,9,67,111,288,2022-05-12 18:33:44.380671
29740,9,43,4,55,62,173,2022-05-12 18:33:48.235196
29741,12,34,3,31,68,148,2022-05-12 18:33:49.29464
29742,8,53,4,33,50,148,2022-05-12 18:33:50.485962
29743,10,66,11,35,59,181,2022-05-12 18:33:51.495063
29744,7,159,2,27,27,222,2022-05-12 18:33:53.00581
29745,8,51,5,55,62,181,2022-05-12 18:33:54.643849
29746,12,50,3,67,76,208,2022-05-12 18:33:55.661707
29747,10,46,4,62,56,178,2022-05-12 18:33:56.660837
29748,12,49,6,63,69,199,2022-05-12 18:33:57.775063
29749,8,89,2,31,73,203,2022-05-12 18:33:58.82601
29750,21,108,7,74,129,339,2022-05-12 18:33:59.975482
29752,14,153,9,68,121,365,2022-05-12 18:34:02.399834
29755,1859,51990,849,677,26058,81433,2022-05-12 18:34:02.821241
29756,68,704,42,66,1088,1968,2022-05-12 18:34:05.414312
29757,11,378,3,25,87,504,2022-05-12 18:34:06.832564
29758,21319,137595,9143,32492,57374,257923,2022-05-12 18:34:07.258975
29759,11,51,4,64,56,186,2022-05-12 18:34:09.069134
29766,12,478,6,27,88,611,2022-05-12 18:34:14.663904
29770,13,520,6,21,117,677,2022-05-12 18:34:19.225671
29772,24,1234,15,32,295,1600,2022-05-12 18:34:21.41245
29777,28,1400,9,73,270,1780,2022-05-12 18:34:23.097935
29778,14,931,10,20,147,1122,2022-05-12 18:34:24.831886
29780,15,181,6,34,94,330,2022-05-12 18:34:25.913704
29785,14564,148888,6581,11063,58384,239480,2022-05-12 18:34:30.018032
29786,38630,485391,18848,25593,138533,706995,2022-05-12 18:34:30.75004
29787,6006,68289,3548,2610,37164,117617,2022-05-12 18:34:34.496328
43469,0,10,1,8,14,33,2022-05-12 21:43:51.387461
29791,9,190,5,50,89,343,2022-05-12 18:34:37.274931
29793,7,205,6,46,78,342,2022-05-12 18:34:40.698823
29795,10,127,4,42,69,252,2022-05-12 18:34:43.257806
29796,9,147,4,36,54,250,2022-05-12 18:34:44.261203
29798,6,160,4,40,50,260,2022-05-12 18:34:46.591157
29799,6,163,3,46,57,275,2022-05-12 18:34:48.244768
29800,8,154,4,49,50,265,2022-05-12 18:34:49.38424
29803,59023,1017395,25666,34549,198815,1335448,2022-05-12 18:34:50.28465
29812,13,214,6,63,125,421,2022-05-12 18:34:51.475228
29814,12,118,2,43,73,248,2022-05-12 18:34:53.582531
29820,22,207,21,69,225,544,2022-05-12 18:34:54.691763
29821,27,218,24,67,252,588,2022-05-12 18:34:55.808995
29823,44,308,28,71,381,832,2022-05-12 18:34:57.573755
29825,19,174,3,53,148,397,2022-05-12 18:34:59.771776
29829,331,3841,206,149,4591,9118,2022-05-12 18:35:00.172935
29830,305,3647,201,131,4420,8704,2022-05-12 18:35:00.571501
29853,155,2095,127,131,1966,4474,2022-05-12 18:35:07.988751
29855,583,1160,266,199,9099,11307,2022-05-12 18:35:13.38966
29861,21,195,22,65,189,492,2022-05-12 18:35:20.322686
29863,30,512,25,83,634,1284,2022-05-12 18:35:23.230222
29865,208,855,343,581,572,2559,2022-05-12 18:35:25.429987
29868,87,1932,54,95,1153,3321,2022-05-12 18:35:27.793593
29871,10,444,5,34,98,591,2022-05-12 18:35:30.113813
29876,1856,5035,968,1650,6786,16295,2022-05-12 18:35:32.546805
29888,7,170,4,30,32,243,2022-05-12 18:35:35.493865
29889,6,90,4,57,58,215,2022-05-12 18:35:36.459637
29893,1023,12072,502,332,10635,24564,2022-05-12 18:35:39.445789
29897,7,238,5,41,75,366,2022-05-12 18:35:41.171996
29900,14,114,3,42,61,234,2022-05-12 18:35:43.866383
29902,17,509,2,52,87,667,2022-05-12 18:35:46.424225
29904,12,427,2,35,149,625,2022-05-12 18:35:47.818612
29905,13,467,5,35,91,611,2022-05-12 18:35:48.942958
29907,9,532,4,28,131,704,2022-05-12 18:35:52.635
29908,9,460,2,27,92,590,2022-05-12 18:35:53.918579
29917,9,158,2,49,67,285,2022-05-12 18:35:57.758575
29918,10,164,6,39,95,314,2022-05-12 18:35:59.055695
29920,6,169,6,46,84,311,2022-05-12 18:36:01.552763
29921,8,219,3,47,62,339,2022-05-12 18:36:02.592896
29922,6,130,2,35,64,237,2022-05-12 18:36:03.731469
29923,15,424,8,56,156,659,2022-05-12 18:36:05.07505
29924,10,57,20,78,66,231,2022-05-12 18:36:06.78124
29925,9,132,2,51,57,251,2022-05-12 18:36:07.792934
29926,8,222,4,41,70,345,2022-05-12 18:36:09.558728
29927,41,943,32,71,831,1918,2022-05-12 18:36:09.965618
29928,6,151,1,46,65,269,2022-05-12 18:36:11.539808
29933,9,340,5,19,54,427,2022-05-12 18:36:17.385318
29935,59,205,22,73,428,787,2022-05-12 18:36:19.325204
29936,100,250,36,104,502,992,2022-05-12 18:36:20.986351
29941,652,5089,369,1846,3008,10964,2022-05-12 18:36:25.28364
29946,10,453,6,21,58,548,2022-05-12 18:36:30.241038
29947,7,81,8,86,95,277,2022-05-12 18:36:31.285712
29948,6,74,7,85,79,251,2022-05-12 18:36:32.329699
29952,13,637,5,28,90,773,2022-05-12 18:36:36.645171
29955,10,272,4,19,48,353,2022-05-12 18:36:40.974556
29957,9,743,4,29,71,856,2022-05-12 18:36:43.574661
29961,15,209,5,38,115,382,2022-05-12 18:36:45.462679
29963,6,158,1,29,42,236,2022-05-12 18:36:46.468707
29973,8,384,6,32,106,536,2022-05-12 18:36:52.029218
29974,5779,100142,2675,7165,20639,136400,2022-05-12 18:36:52.304946
29975,245,2094,96,205,1736,4376,2022-05-12 18:36:54.698658
29976,6325,69043,3213,9245,27319,115145,2022-05-12 18:36:57.920954
29979,22,1504,13,40,155,1734,2022-05-12 18:37:02.380299
29980,31,1841,15,56,388,2331,2022-05-12 18:37:04.439438
29985,11,77,7,60,69,224,2022-05-12 18:37:07.969609
29986,8,54,5,71,58,196,2022-05-12 18:37:09.208031
29987,5,68,6,58,69,206,2022-05-12 18:37:10.142163
29989,9,339,6,30,74,458,2022-05-12 18:37:12.602454
29995,17,1432,8,36,154,1647,2022-05-12 18:37:13.026564
29998,270,6857,151,149,2818,10245,2022-05-12 18:37:15.991474
29999,23,87,16,47,615,788,2022-05-12 18:37:18.203503
30010,75,543,30,47,632,1327,2022-05-12 18:37:20.290036
30012,9,222,4,47,62,344,2022-05-12 18:37:21.3887
30013,27,187,5,55,286,560,2022-05-12 18:37:22.888126
30014,7881,41003,4488,5531,33421,92324,2022-05-12 18:37:23.137851
30015,39402,628243,18867,18156,195413,900081,2022-05-12 18:37:23.304236
30016,23994,158734,12880,20799,75257,291664,2022-05-12 18:37:27.636652
30018,8,238,13,51,70,380,2022-05-12 18:37:29.301799
30024,9,49,2,55,56,171,2022-05-12 18:37:33.469058
30026,10,62,6,66,49,193,2022-05-12 18:37:35.066123
43610,0,8,1,11,13,33,2022-05-12 21:44:49.183509
30027,12,59,5,64,66,206,2022-05-12 18:37:37.415235
30028,19,130,7,77,179,412,2022-05-12 18:37:39.180879
30029,13,65,3,68,114,263,2022-05-12 18:37:41.221551
30034,13,75,9,59,103,259,2022-05-12 18:37:44.978157
30036,16,96,9,45,120,286,2022-05-12 18:37:46.358766
30039,334,3177,189,337,1013,5050,2022-05-12 18:37:48.842722
30042,20,217,13,42,225,517,2022-05-12 18:37:50.522998
30046,5,214,3,28,55,305,2022-05-12 18:37:52.370831
30048,8,51,5,59,65,188,2022-05-12 18:37:53.398006
30049,8,49,1,45,38,141,2022-05-12 18:37:54.464164
30051,10,72,4,53,75,214,2022-05-12 18:37:56.697958
30052,11,64,4,54,63,196,2022-05-12 18:37:57.818401
30054,7,40,1,44,43,135,2022-05-12 18:37:59.706864
30056,1242,26595,927,747,9356,38867,2022-05-12 18:38:01.451692
30057,7,43,3,43,48,144,2022-05-12 18:38:04.333975
30060,12,60,5,56,71,204,2022-05-12 18:38:08.008964
30061,16,113,8,45,112,294,2022-05-12 18:38:09.307501
30064,11,106,6,56,108,287,2022-05-12 18:38:11.013803
30065,9,196,3,32,61,301,2022-05-12 18:38:12.205677
30066,28,246,14,37,209,534,2022-05-12 18:38:13.53231
30070,11,127,5,38,55,236,2022-05-12 18:38:14.712245
30071,6,135,3,41,61,246,2022-05-12 18:38:15.77924
30073,5,235,2,31,45,318,2022-05-12 18:38:18.869015
30074,6,257,3,33,47,346,2022-05-12 18:38:20.512577
30076,6,228,2,32,46,314,2022-05-12 18:38:23.809303
30077,7,239,1,28,40,315,2022-05-12 18:38:25.039656
30078,6,253,4,40,64,367,2022-05-12 18:38:27.087756
30079,13,237,7,60,110,427,2022-05-12 18:38:28.184911
30080,32,290,8,32,248,610,2022-05-12 18:38:29.739972
30081,6,246,2,32,28,314,2022-05-12 18:38:30.88033
30085,6,151,4,35,39,235,2022-05-12 18:38:34.402672
30086,19,773,7,63,108,970,2022-05-12 18:38:36.38718
30089,19,164,10,56,127,376,2022-05-12 18:38:38.50933
30090,12,203,1,50,71,337,2022-05-12 18:38:39.568579
30091,7372,46497,4795,18694,26791,104149,2022-05-12 18:38:39.894491
30093,10,266,2,43,70,391,2022-05-12 18:38:43.264743
30095,19,205,5,65,109,403,2022-05-12 18:38:45.172887
30096,18,172,5,58,89,342,2022-05-12 18:38:46.653692
30097,16,174,3,55,91,339,2022-05-12 18:38:47.759628
30098,14,127,3,44,79,267,2022-05-12 18:38:49.128844
30100,443,10996,295,271,6266,18271,2022-05-12 18:38:51.387544
30103,44,1030,28,60,514,1676,2022-05-12 18:38:53.962688
30104,9,197,2,19,43,270,2022-05-12 18:38:55.114118
30105,7,250,2,41,78,378,2022-05-12 18:38:56.298841
30107,7,70,2,48,63,190,2022-05-12 18:38:59.195345
30116,13,91,5,63,62,234,2022-05-12 18:39:00.214913
30117,10,40,4,41,46,141,2022-05-12 18:39:01.126832
30118,9,66,8,68,52,203,2022-05-12 18:39:02.235865
30119,62,0,14,112,146,334,2022-05-12 18:39:03.366816
30123,31975,369547,20576,21619,143354,587071,2022-05-12 18:39:06.264325
30125,15,92,4,48,101,260,2022-05-12 18:39:07.930392
30133,18,338,7,36,273,672,2022-05-12 18:39:10.668946
30134,14,57,5,55,66,197,2022-05-12 18:39:12.157037
30137,1128,25719,407,794,9440,37488,2022-05-12 18:39:14.682725
30139,9,62,2,47,54,174,2022-05-12 18:39:16.219806
30140,11,68,2,71,49,201,2022-05-12 18:39:17.367465
30143,52,986,32,74,616,1760,2022-05-12 18:39:19.297736
30144,18,132,12,98,201,461,2022-05-12 18:39:20.63978
30145,41,320,23,49,403,836,2022-05-12 18:39:22.17889
30148,14,87,9,61,101,272,2022-05-12 18:39:23.201865
30149,13,87,9,62,104,275,2022-05-12 18:39:25.495823
30150,17,112,11,70,129,339,2022-05-12 18:39:26.82392
30151,164,0,41,247,436,888,2022-05-12 18:39:26.986922
30152,11,131,9,60,101,312,2022-05-12 18:39:28.314819
30153,17,103,15,75,146,356,2022-05-12 18:39:29.351696
30155,37,1167,17,47,366,1634,2022-05-12 18:39:32.212441
30157,6,187,1,35,40,269,2022-05-12 18:39:33.866011
30159,8,117,7,40,68,240,2022-05-12 18:39:36.161637
30160,9,278,3,27,57,374,2022-05-12 18:39:37.29873
30161,9,100,6,42,47,204,2022-05-12 18:39:38.339797
30163,5,170,4,29,34,242,2022-05-12 18:39:41.262162
30166,49,512,28,47,473,1109,2022-05-12 18:39:45.065402
30167,6,220,1,37,36,300,2022-05-12 18:39:46.576643
30168,50,1947,33,56,614,2700,2022-05-12 18:39:48.218645
30173,38,226,23,54,292,633,2022-05-12 18:39:50.822908
30176,9,108,6,72,88,283,2022-05-12 18:39:52.236325
30177,13,327,7,63,100,510,2022-05-12 18:39:53.925422
30178,60,701,38,97,751,1647,2022-05-12 18:39:55.626575
30187,12699,101962,8197,10903,63353,197114,2022-05-12 18:39:56.043367
30191,1259,40687,731,358,18750,61785,2022-05-12 18:39:59.157364
30196,186,2467,83,83,2236,5055,2022-05-12 18:40:04.864833
30198,9,62,4,41,65,181,2022-05-12 18:40:06.259655
30199,5,247,2,27,49,330,2022-05-12 18:40:07.441198
30200,9,75,3,42,44,173,2022-05-12 18:40:08.480997
30201,10,130,6,27,61,234,2022-05-12 18:40:09.843555
30202,5,182,4,43,52,286,2022-05-12 18:40:11.136534
30204,16,96,8,39,160,319,2022-05-12 18:40:12.328803
30206,1093,72164,508,246,13454,87465,2022-05-12 18:40:15.831718
30207,9,101,3,44,42,199,2022-05-12 18:40:17.107883
30208,8,77,3,38,28,154,2022-05-12 18:40:18.099687
30209,8,81,4,36,32,161,2022-05-12 18:40:19.06794
30212,14,704,5,32,107,862,2022-05-12 18:40:24.298804
30214,17,524,5,55,152,753,2022-05-12 18:40:26.678111
30218,117,1673,73,113,1664,3640,2022-05-12 18:40:30.238872
30228,12,71,4,47,76,210,2022-05-12 18:40:32.444119
30230,9904,84653,4194,2414,20553,121718,2022-05-12 18:40:32.844983
30234,13,1164,5,49,147,1378,2022-05-12 18:40:37.324089
30237,385,5674,180,127,2763,9129,2022-05-12 18:40:40.32768
30240,35638,651809,17391,34194,138557,877589,2022-05-12 18:40:40.52705
30241,7,200,2,21,35,265,2022-05-12 18:40:42.851097
30247,12,133,8,47,104,304,2022-05-12 18:40:46.159748
30249,35,117,18,52,329,551,2022-05-12 18:40:48.324802
30250,716,14043,275,182,7128,22344,2022-05-12 18:40:50.901271
30251,386,2038,228,771,3316,6739,2022-05-12 18:40:53.139171
30262,190,3158,80,134,1043,4605,2022-05-12 18:40:55.972842
30263,16,321,4,45,132,518,2022-05-12 18:40:58.425734
30264,13,335,4,50,117,519,2022-05-12 18:41:00.163955
30268,9,49,1,36,49,144,2022-05-12 18:41:03.334762
30276,119624,2416289,39269,34991,165676,2775849,2022-05-12 18:41:03.601891
30279,4778,77703,2294,1564,27252,113591,2022-05-12 18:41:07.016995
30284,12,54,2,47,48,163,2022-05-12 18:41:09.219529
43639,0,30,1,7,8,46,2022-05-12 21:45:03.662734
30289,17,273,9,48,149,496,2022-05-12 18:41:11.500696
30290,307,2497,213,200,5301,8518,2022-05-12 18:41:13.035551
30291,175,1543,175,170,2385,4448,2022-05-12 18:41:15.669162
30292,115,1292,68,58,1242,2775,2022-05-12 18:41:17.803936
30296,34146,634374,11467,18323,120950,819260,2022-05-12 18:41:17.965919
30298,29,266,10,65,253,623,2022-05-12 18:41:20.905552
30300,2571,120851,947,696,19977,145042,2022-05-12 18:41:24.922585
30305,13,91,6,74,97,281,2022-05-12 18:41:26.29056
30307,31560,492537,14762,32270,93784,664913,2022-05-12 18:41:26.461254
30309,56,156,30,80,758,1080,2022-05-12 18:41:29.029151
30311,1495,29358,636,432,8813,40734,2022-05-12 18:41:33.021005
30312,9,56,5,48,57,175,2022-05-12 18:41:34.250622
30313,20,142,9,64,174,409,2022-05-12 18:41:36.076124
30321,2499,64403,903,563,18207,86575,2022-05-12 18:41:38.73305
30327,11,289,2,38,73,413,2022-05-12 18:41:45.013689
30328,10,318,3,38,70,439,2022-05-12 18:41:46.646808
30329,8,319,3,36,57,423,2022-05-12 18:41:47.807043
30330,10,263,2,45,70,390,2022-05-12 18:41:49.066005
30331,10,287,4,33,68,402,2022-05-12 18:41:50.784396
30332,11,556,4,37,121,729,2022-05-12 18:41:52.552516
30336,11,273,3,36,60,383,2022-05-12 18:41:55.736903
30337,9,290,5,29,59,392,2022-05-12 18:41:56.793183
30339,13,280,4,26,54,377,2022-05-12 18:41:57.793456
30340,8,324,2,27,63,424,2022-05-12 18:41:58.821865
30342,22,88,9,85,125,329,2022-05-12 18:42:00.944827
30343,9,55,2,53,64,183,2022-05-12 18:42:02.108229
30344,1665,21013,952,704,9430,33764,2022-05-12 18:42:04.946964
30346,4178,158786,1243,1366,60508,226081,2022-05-12 18:42:05.11329
30347,3835,144801,1409,736,22049,172830,2022-05-12 18:42:05.596895
30349,10,52,3,53,68,186,2022-05-12 18:42:08.544595
30358,78,1518,28,42,766,2432,2022-05-12 18:42:14.559646
30360,9,92,0,39,62,202,2022-05-12 18:42:15.706882
30362,25,83,20,52,395,575,2022-05-12 18:42:17.729668
30363,15041,271422,6791,9423,48159,350836,2022-05-12 18:42:20.628677
30364,1674,47041,770,652,23878,74015,2022-05-12 18:42:20.879119
30365,1692,55183,658,441,14911,72885,2022-05-12 18:42:24.794478
30367,17,903,9,53,95,1077,2022-05-12 18:42:27.581038
30370,8380,83287,3620,1088,21954,118329,2022-05-12 18:42:27.743559
30376,194,3616,191,148,2881,7030,2022-05-12 18:42:31.588665
30378,14,95,7,50,226,392,2022-05-12 18:42:33.579937
30379,524,13160,352,236,8106,22378,2022-05-12 18:42:36.569422
30382,1794,7428,1109,3339,7914,21584,2022-05-12 18:42:41.455714
30383,7216,54278,5020,11236,37231,114981,2022-05-12 18:42:41.738851
30384,997,12215,694,790,4578,19274,2022-05-12 18:42:44.950648
30385,8837,60202,4221,12734,38421,124415,2022-05-12 18:42:45.367664
30392,6,210,3,28,78,325,2022-05-12 18:42:50.967003
30393,10,219,1,24,63,317,2022-05-12 18:42:52.094535
30394,9,214,1,32,56,312,2022-05-12 18:42:53.213088
30395,6,189,1,23,59,278,2022-05-12 18:42:54.288821
30396,8,439,2,39,79,567,2022-05-12 18:42:55.556813
30397,9,241,1,27,58,336,2022-05-12 18:42:56.643092
30400,11,284,5,42,82,424,2022-05-12 18:43:00.289821
30401,9,229,4,30,47,319,2022-05-12 18:43:01.695959
30403,10,197,1,24,57,289,2022-05-12 18:43:02.857698
30404,10,269,4,35,60,378,2022-05-12 18:43:03.89207
30405,10,278,2,32,48,370,2022-05-12 18:43:04.858991
30409,11,51,8,61,67,198,2022-05-12 18:43:07.895825
30410,22,268,14,85,168,557,2022-05-12 18:43:09.811007
30412,272,885,139,211,1367,2874,2022-05-12 18:43:14.061009
30415,1600,54943,836,525,26120,84024,2022-05-12 18:43:17.443153
30417,20,78,13,76,165,352,2022-05-12 18:43:19.063735
30419,210,3964,121,101,3486,7882,2022-05-12 18:43:22.683724
30420,21,322,21,51,279,694,2022-05-12 18:43:25.592286
30424,8,547,4,26,50,635,2022-05-12 18:43:27.911093
30425,10,392,5,26,42,475,2022-05-12 18:43:29.136895
30427,7,313,1,20,37,378,2022-05-12 18:43:30.579248
30428,5,424,5,21,50,505,2022-05-12 18:43:32.116042
30429,8,228,2,31,52,321,2022-05-12 18:43:33.377173
30435,14,91,6,38,118,267,2022-05-12 18:43:39.84698
30442,17,153,4,58,98,330,2022-05-12 18:43:45.565714
30443,15,143,4,56,85,303,2022-05-12 18:43:46.632996
30444,14,128,4,54,85,285,2022-05-12 18:43:47.663698
30446,12,286,3,39,98,438,2022-05-12 18:43:50.881839
30447,13,90,4,41,76,224,2022-05-12 18:43:52.711104
30450,27,402,32,72,417,950,2022-05-12 18:43:55.521808
30453,28,299,17,69,333,746,2022-05-12 18:43:57.657625
30455,0,0,0,0,35950,35950,2022-05-12 18:43:57.82188
30457,17,113,18,102,114,364,2022-05-12 18:43:59.431544
30458,2613,187828,1085,906,32658,225090,2022-05-12 18:44:03.461667
30463,138,387,66,141,1177,1909,2022-05-12 18:44:05.62082
30468,10,161,4,41,123,339,2022-05-12 18:44:10.811885
30470,38,108,13,109,143,411,2022-05-12 18:44:12.896065
30473,60,422,34,65,1071,1652,2022-05-12 18:44:14.587769
30480,12,305,3,32,68,420,2022-05-12 18:44:15.763425
30484,63708,407596,24075,15675,243779,754833,2022-05-12 18:44:19.702082
30485,7538,48409,3920,8520,54248,122635,2022-05-12 18:44:23.844474
30489,34,306,18,51,302,711,2022-05-12 18:44:27.043454
30499,216,1806,200,150,1528,3900,2022-05-12 18:44:29.324378
30503,47246,1055387,20253,12248,165111,1300245,2022-05-12 18:44:29.581236
30512,31,98,23,44,633,829,2022-05-12 18:44:30.506945
30519,75,358,44,147,718,1342,2022-05-12 18:44:35.121377
30524,1658,14481,974,3767,10354,31234,2022-05-12 18:44:38.236537
30530,6,56,2,49,60,173,2022-05-12 18:44:40.324289
30531,111,2649,61,163,1681,4665,2022-05-12 18:44:43.191332
30533,228,8671,83,148,1935,11065,2022-05-12 18:44:45.765287
43643,0,9,1,8,14,32,2022-05-12 21:45:04.794795
30544,25376,451813,9102,21754,83678,591723,2022-05-12 18:44:50.023865
30547,346,4825,124,70,3531,8896,2022-05-12 18:44:52.944385
30549,712,7046,319,325,5356,13758,2022-05-12 18:44:55.482479
30559,8,284,4,40,77,413,2022-05-12 18:44:57.086984
30567,506,13654,197,221,3383,17961,2022-05-12 18:44:59.543639
30571,27,207,13,45,249,541,2022-05-12 18:45:01.810634
30573,131,2381,78,86,1567,4243,2022-05-12 18:45:04.56414
30582,11,64,5,66,63,209,2022-05-12 18:45:08.024613
30585,897,19991,393,151,14170,35602,2022-05-12 18:45:10.893158
30600,91,3784,41,69,1038,5023,2022-05-12 18:45:13.545383
30605,21,91,7,108,94,321,2022-05-12 18:45:16.521278
30617,286,761,160,180,3276,4663,2022-05-12 18:45:18.59645
30634,11,67,6,38,114,236,2022-05-12 18:45:20.424823
30641,623,13610,385,251,8460,23329,2022-05-12 18:45:21.392556
30646,11,288,10,64,98,471,2022-05-12 18:45:22.810747
30647,44,244,12,39,452,791,2022-05-12 18:45:24.99867
30648,23,344,14,54,252,687,2022-05-12 18:45:27.366949
30649,328,1501,159,379,786,3153,2022-05-12 18:45:29.619653
30652,1863,10345,1043,2827,9340,25418,2022-05-12 18:45:36.039378
30654,57588,964651,28223,16705,148879,1216046,2022-05-12 18:45:36.232996
30659,18,531,8,33,132,722,2022-05-12 18:45:37.919889
30663,54,1268,19,58,505,1904,2022-05-12 18:45:41.1908
30664,8,279,6,35,82,410,2022-05-12 18:45:43.906611
30665,15,704,6,76,168,969,2022-05-12 18:45:45.48531
30667,12,245,4,38,79,378,2022-05-12 18:45:47.280925
30668,11,587,6,39,151,794,2022-05-12 18:45:48.69888
30673,13,210,1,43,144,411,2022-05-12 18:45:50.691409
30679,722,3910,285,266,5222,10405,2022-05-12 18:45:54.911816
30686,77,2923,75,124,1124,4323,2022-05-12 18:45:57.293752
30694,102246,497972,25136,32895,52225,710474,2022-05-12 18:45:57.538244
30695,314,2301,148,217,7656,10636,2022-05-12 18:46:00.352945
30704,14,125,16,53,145,353,2022-05-12 18:46:01.777617
30705,1733,24849,798,4567,7550,39497,2022-05-12 18:46:04.528371
30709,8196,101617,2447,1274,31246,144780,2022-05-12 18:46:07.670083
30711,1390,54546,777,460,22447,79620,2022-05-12 18:46:11.547343
30714,2856,56978,1250,958,20872,82914,2022-05-12 18:46:11.790279
30721,2930,20550,1412,3256,19070,47218,2022-05-12 18:46:14.656973
30723,10,70,6,57,87,230,2022-05-12 18:46:16.662185
30727,17578,205741,7491,5737,82024,318571,2022-05-12 18:46:20.512835
30732,12,149,9,75,149,394,2022-05-12 18:46:23.229753
30736,21829,98901,8846,9158,79324,218058,2022-05-12 18:46:23.579744
30740,5430,39726,4053,7847,21598,78654,2022-05-12 18:46:33.338649
30745,1423,38222,574,462,15007,55688,2022-05-12 18:46:36.473666
30746,592,7522,320,997,3080,12511,2022-05-12 18:46:39.886873
30749,20178,238102,7311,14732,70409,350732,2022-05-12 18:46:41.066673
30753,16,109,6,77,126,334,2022-05-12 18:46:47.341603
30754,13,100,5,56,91,265,2022-05-12 18:46:49.269688
30757,2929,5508,1514,2713,10254,22918,2022-05-12 18:46:52.754847
30762,8,59,3,39,45,154,2022-05-12 18:46:58.491135
30763,10,132,5,49,89,285,2022-05-12 18:46:59.601626
30764,6,62,3,35,38,144,2022-05-12 18:47:00.601429
30765,7,31,1,45,41,125,2022-05-12 18:47:01.774785
30767,8,94,9,65,96,272,2022-05-12 18:47:04.395598
30771,74,3843,24,41,801,4783,2022-05-12 18:47:06.639883
30778,2672,123426,1034,653,37908,165693,2022-05-12 18:47:07.405417
30781,12,119,0,46,65,242,2022-05-12 18:47:12.09047
30782,4449,45779,1888,7259,19921,79296,2022-05-12 18:47:12.49772
30790,228,6110,130,159,2926,9553,2022-05-12 18:47:16.03704
30796,17,56,1,56,77,207,2022-05-12 18:47:18.455594
30803,20,147,13,84,191,455,2022-05-12 18:47:19.778481
30806,7258,49498,3953,9814,33471,103994,2022-05-12 18:47:23.240491
30813,1105,11557,332,337,6982,20313,2022-05-12 18:47:23.506112
30814,10,257,7,34,76,384,2022-05-12 18:47:25.191084
30825,191,10558,138,80,2138,13105,2022-05-12 18:47:29.406439
30826,470,1296,517,859,1770,4912,2022-05-12 18:47:32.126849
30829,233,5544,158,206,3107,9248,2022-05-12 18:47:35.047188
30831,73466,1364270,27444,29533,190943,1685656,2022-05-12 18:47:35.359673
30839,8,78,6,52,101,245,2022-05-12 18:47:36.506612
30850,114,970,68,104,1582,2838,2022-05-12 18:47:43.333588
30851,37,262,19,115,245,678,2022-05-12 18:47:45.187334
30859,11,659,5,29,115,819,2022-05-12 18:47:48.006493
30860,16,1071,9,33,109,1238,2022-05-12 18:47:49.520782
30863,13,459,5,40,80,597,2022-05-12 18:47:53.621014
30864,8,167,3,30,47,255,2022-05-12 18:47:55.395429
30865,20,490,8,43,160,721,2022-05-12 18:47:56.317821
30868,1124,23866,522,821,16195,42528,2022-05-12 18:47:59.731413
30869,618,9072,459,517,14272,24938,2022-05-12 18:48:02.764786
30873,17,92,6,46,150,311,2022-05-12 18:48:07.680043
30875,12,72,3,90,83,260,2022-05-12 18:48:08.924749
30885,6292,189792,2657,728,36753,236222,2022-05-12 18:48:09.367584
30886,17,491,8,37,180,733,2022-05-12 18:48:12.489784
30892,15,97,12,95,114,333,2022-05-12 18:48:14.474647
30893,19,106,7,86,138,356,2022-05-12 18:48:15.847705
30895,5956,34005,3983,12489,28848,85281,2022-05-12 18:48:19.051692
30896,140,3101,112,104,2203,5660,2022-05-12 18:48:21.720033
30901,9195,49197,5233,7249,29073,99947,2022-05-12 18:48:22.150766
30902,1030,37152,467,260,11429,50338,2022-05-12 18:48:22.592324
30905,16,91,0,44,83,234,2022-05-12 18:48:28.718616
30906,9,46,4,39,42,140,2022-05-12 18:48:29.717187
30907,28,1682,4,30,206,1950,2022-05-12 18:48:33.00887
30909,13,654,0,31,94,792,2022-05-12 18:48:34.426523
30913,296,6179,157,177,2642,9451,2022-05-12 18:48:44.06031
30916,37,484,7,29,342,899,2022-05-12 18:48:47.809069
30921,70,508,47,48,1259,1932,2022-05-12 18:48:53.793367
30922,98,1997,35,54,1235,3419,2022-05-12 18:48:56.697217
30923,46,515,29,53,645,1288,2022-05-12 18:48:58.580196
30924,159,1281,68,76,1414,2998,2022-05-12 18:49:00.635655
30925,474,17437,283,225,5699,24118,2022-05-12 18:49:01.527131
30926,7,65,5,73,53,203,2022-05-12 18:49:02.650246
30927,9,37,4,54,51,155,2022-05-12 18:49:03.669938
30928,8,29,3,56,43,139,2022-05-12 18:49:04.711978
30929,8,65,4,70,54,201,2022-05-12 18:49:05.901496
30930,8,34,3,49,44,138,2022-05-12 18:49:07.084647
30942,7,53,5,60,52,177,2022-05-12 18:49:23.598657
30943,18,187,8,76,324,613,2022-05-12 18:49:25.133795
30944,7,41,4,49,64,165,2022-05-12 18:49:26.290927
30947,156,1210,129,347,833,2675,2022-05-12 18:49:28.396441
30952,437,14950,191,194,6528,22300,2022-05-12 18:49:31.673031
30953,593,4425,658,401,4420,10497,2022-05-12 18:49:34.829152
30955,23,488,4,45,136,696,2022-05-12 18:49:38.256764
30957,18,115,23,124,99,379,2022-05-12 18:49:39.386842
30959,7,37,4,57,45,150,2022-05-12 18:49:41.641546
30960,16,84,4,49,129,282,2022-05-12 18:49:43.041072
30968,7,31,2,51,49,140,2022-05-12 18:49:47.268129
30971,13,85,3,41,71,213,2022-05-12 18:49:50.101784
30973,8,125,15,88,84,320,2022-05-12 18:49:51.271127
30975,9,37,5,47,75,173,2022-05-12 18:49:53.605238
30976,7,27,3,46,36,119,2022-05-12 18:49:54.649557
30977,7,32,1,54,40,134,2022-05-12 18:49:55.716294
30978,6,31,3,42,44,126,2022-05-12 18:49:56.962251
30980,9,29,3,48,62,151,2022-05-12 18:49:58.915156
30981,9,48,1,43,58,159,2022-05-12 18:50:00.055938
30982,9,26,2,47,53,137,2022-05-12 18:50:01.183013
30984,5,46,1,55,39,146,2022-05-12 18:50:04.123782
30985,10,132,5,54,110,311,2022-05-12 18:50:05.377444
30988,407,4634,281,114,2054,7490,2022-05-12 18:50:06.937206
30997,7,31,2,48,39,127,2022-05-12 18:50:12.834582
31000,7,31,3,44,53,138,2022-05-12 18:50:15.716003
31001,6,30,4,46,53,139,2022-05-12 18:50:16.904552
31002,6,26,4,49,53,138,2022-05-12 18:50:18.031998
31003,7,48,3,53,57,168,2022-05-12 18:50:19.238659
31005,10,39,2,46,60,157,2022-05-12 18:50:20.738082
31008,8,34,2,45,41,130,2022-05-12 18:50:23.315883
31009,6,28,4,46,35,119,2022-05-12 18:50:24.386691
31015,7,26,2,43,41,119,2022-05-12 18:50:26.074972
31035,120,2120,194,155,1844,4433,2022-05-12 18:50:29.613176
31043,63065,1442949,19281,14537,273419,1813251,2022-05-12 18:50:29.949881
31054,21,147,10,66,173,417,2022-05-12 18:50:33.037066
31055,64,531,29,100,766,1490,2022-05-12 18:50:35.526234
31056,1043,22180,591,404,9452,33670,2022-05-12 18:50:38.081363
31064,130,1433,86,103,1208,2960,2022-05-12 18:50:42.167712
31065,176,1338,83,102,1136,2835,2022-05-12 18:50:45.419747
31070,248,4951,126,102,2277,7704,2022-05-12 18:50:49.16811
31071,27,133,14,84,218,476,2022-05-12 18:50:51.328056
31072,74,817,40,83,1104,2118,2022-05-12 18:50:53.203335
31073,66,722,40,81,1035,1944,2022-05-12 18:50:55.716292
31078,14,40,5,85,88,232,2022-05-12 18:50:56.807239
31096,1113,19727,804,373,8003,30020,2022-05-12 18:51:04.685051
31098,6268,82788,2907,2607,26445,121015,2022-05-12 18:51:07.675948
31102,33,1159,16,51,554,1813,2022-05-12 18:51:10.210452
31108,104,2293,77,129,1172,3775,2022-05-12 18:51:16.423263
31109,7622,42855,3632,16259,31849,102217,2022-05-12 18:51:19.626192
31111,37,1053,14,48,598,1750,2022-05-12 18:51:21.626956
31113,111,1531,66,113,1112,2933,2022-05-12 18:51:23.801798
31121,2154,27180,1224,1307,12263,44128,2022-05-12 18:51:27.695299
31128,310,9128,184,231,3281,13134,2022-05-12 18:51:30.391285
31133,152,2718,121,131,1654,4776,2022-05-12 18:51:31.048082
31135,11,78,7,47,93,236,2022-05-12 18:51:32.456958
31139,399,6257,244,671,2508,10079,2022-05-12 18:51:38.59783
31143,1549,17497,788,2324,5861,28019,2022-05-12 18:51:41.569134
31145,257,5102,308,283,4166,10116,2022-05-12 18:51:47.455233
31149,1432,39620,577,330,20817,62776,2022-05-12 18:51:51.868854
31150,130,140,58,221,150,699,2022-05-12 18:51:53.811541
31157,1984,5393,1580,5504,10160,24621,2022-05-12 18:51:57.147169
31158,189,4145,122,101,2644,7201,2022-05-12 18:52:00.119479
31165,315,4006,218,176,4369,9084,2022-05-12 18:52:06.430017
31166,21,115,9,38,199,382,2022-05-12 18:52:08.98071
31170,13,215,0,45,64,337,2022-05-12 18:52:13.51916
31173,12918,234433,7368,4500,57592,316811,2022-05-12 18:52:17.134515
31174,14766,69119,11225,13168,51117,159395,2022-05-12 18:52:19.676829
31177,17,113,4,94,131,359,2022-05-12 18:52:22.10469
31178,2376,20669,1096,1279,12894,38314,2022-05-12 18:52:27.68664
31181,19696,266665,9017,4564,132151,432093,2022-05-12 18:52:27.936932
31196,567,6243,229,366,2125,9530,2022-05-12 18:52:32.191654
31201,66,3368,70,102,694,4300,2022-05-12 18:52:34.786578
31205,17,69,2,61,64,213,2022-05-12 18:52:38.830841
31211,28,195,9,78,152,462,2022-05-12 18:52:41.121446
31223,4993,34195,2034,6087,17268,64577,2022-05-12 18:52:44.572955
31227,601,5272,337,310,3547,10067,2022-05-12 18:52:47.487302
31233,438,1727,163,386,2725,5439,2022-05-12 18:52:57.811776
31234,2748,48980,1770,1416,16192,71106,2022-05-12 18:52:58.759373
31237,14,56,6,87,93,256,2022-05-12 18:53:03.33821
31238,23,256,8,57,186,530,2022-05-12 18:53:03.771958
31240,122424,1472972,41000,46228,227880,1910504,2022-05-12 18:53:06.824567
31244,65,1024,82,161,1404,2736,2022-05-12 18:53:09.186236
31245,6592,112018,2101,1020,73141,194872,2022-05-12 18:53:09.357348
31251,18647,122651,9921,8365,43364,202948,2022-05-12 18:53:17.105961
31252,23,913,12,23,195,1166,2022-05-12 18:53:19.182094
31255,17,98,10,36,102,263,2022-05-12 18:53:20.289153
31258,9,377,4,28,84,502,2022-05-12 18:53:23.65815
43667,0,15,2,9,10,36,2022-05-12 21:45:18.008841
31259,18,473,10,38,148,687,2022-05-12 18:53:25.097409
31261,8,316,7,25,76,432,2022-05-12 18:53:26.338906
31262,13,480,10,27,147,677,2022-05-12 18:53:27.765581
31263,13,447,6,33,176,675,2022-05-12 18:53:28.208031
31264,10,217,5,31,65,328,2022-05-12 18:53:29.979221
31265,11,208,4,29,63,315,2022-05-12 18:53:30.996148
31266,10,312,6,34,91,453,2022-05-12 18:53:32.704723
31268,13,279,7,25,116,440,2022-05-12 18:53:34.282184
31280,465,7817,255,214,8448,17199,2022-05-12 18:53:37.558784
31283,347,12134,133,195,3158,15967,2022-05-12 18:53:40.457314
31289,668,27901,323,255,5172,34319,2022-05-12 18:53:40.625542
31297,2125,157275,1055,785,27977,189217,2022-05-12 18:53:40.951581
31298,341,7996,261,220,3652,12470,2022-05-12 18:53:42.077204
31299,22,162,9,43,135,371,2022-05-12 18:53:43.996812
31300,127,2071,38,48,860,3144,2022-05-12 18:53:46.995046
31302,27,156,10,32,168,393,2022-05-12 18:53:48.538467
31309,20,702,4,28,106,860,2022-05-12 18:53:50.133152
31310,14,614,3,25,115,771,2022-05-12 18:53:52.471813
31317,16,72,4,48,102,242,2022-05-12 18:53:53.530728
31321,16,305,5,48,116,490,2022-05-12 18:53:58.765287
31324,1076,45221,441,256,8471,55465,2022-05-12 18:54:01.456198
31339,30620,298619,13904,18415,131005,492563,2022-05-12 18:54:08.088077
31344,190,3849,157,218,3426,7840,2022-05-12 18:54:08.278856
31348,13,190,2,56,87,348,2022-05-12 18:54:14.373489
31362,85,185,48,79,1715,2112,2022-05-12 18:54:17.375095
31370,806,6782,508,1132,3478,12706,2022-05-12 18:54:24.066695
31374,14122,152825,9736,14373,35792,226848,2022-05-12 18:54:27.583666
31376,18575,115900,11398,13660,82786,242319,2022-05-12 18:54:30.987413
31377,27,366,9,36,250,688,2022-05-12 18:54:33.421904
31378,1870,50497,783,347,21251,74748,2022-05-12 18:54:36.345839
31380,4059,56273,1409,602,14752,77095,2022-05-12 18:54:39.116882
31387,55,2064,24,55,694,2892,2022-05-12 18:54:39.547561
31389,1361,79636,646,255,15724,97622,2022-05-12 18:54:39.719427
31404,30730,311156,13264,23929,90899,469978,2022-05-12 18:54:45.227432
31405,15674,94035,9386,19944,59545,198584,2022-05-12 18:54:45.661427
31410,70,254,51,130,447,952,2022-05-12 18:54:47.68028
31417,1903,13332,1326,1828,8652,27041,2022-05-12 18:54:54.702245
31418,1011,19823,545,268,15539,37186,2022-05-12 18:54:55.67177
31422,1393,7834,766,2574,6915,19482,2022-05-12 18:55:00.774136
31427,120,607,65,125,484,1401,2022-05-12 18:55:06.150414
31430,4551,57159,1890,6949,14310,84859,2022-05-12 18:55:09.088057
31439,2059,16446,821,3050,9525,31901,2022-05-12 18:55:13.312639
31442,32773,272396,15916,32009,128316,481410,2022-05-12 18:55:17.347714
31448,284,7229,206,217,3285,11221,2022-05-12 18:55:22.335327
31450,8,222,5,23,54,312,2022-05-12 18:55:24.840321
43676,0,8,0,11,14,33,2022-05-12 21:45:20.388182
31452,6118,37450,3459,8630,26615,82272,2022-05-12 18:55:27.196271
31456,6490,28387,3330,8359,29316,75882,2022-05-12 18:55:30.852129
31464,7,61,3,44,49,164,2022-05-12 18:55:32.700252
31465,9,71,1,35,44,160,2022-05-12 18:55:33.737865
31467,27,454,18,56,258,813,2022-05-12 18:55:35.163526
31471,149,374,72,247,309,1151,2022-05-12 18:55:36.857213
31478,82050,716183,37989,34337,260966,1131525,2022-05-12 18:55:38.681498
43760,0,0,0,0,1348,1348,2022-05-12 21:45:39.794388
31485,152,2773,77,139,1728,4869,2022-05-12 18:55:45.779424
31486,103,1855,64,100,1835,3957,2022-05-12 18:55:47.88695
31490,3167,140697,801,502,22656,167823,2022-05-12 18:55:48.211811
31491,1995,10829,716,923,6429,20892,2022-05-12 18:55:52.008743
31493,76,418,36,60,632,1222,2022-05-12 18:55:55.122658
31494,30,486,23,66,458,1063,2022-05-12 18:55:56.800971
31498,1884,16922,864,3578,7265,30513,2022-05-12 18:55:59.1147
31500,5778,49141,3002,4743,34648,97312,2022-05-12 18:55:59.829546
31501,12,642,5,27,59,745,2022-05-12 18:56:02.251903
31506,9,140,0,26,37,212,2022-05-12 18:56:06.024046
31508,6,30,2,44,35,117,2022-05-12 18:56:09.833994
31509,6,43,2,38,40,129,2022-05-12 18:56:11.405338
31510,5,132,0,24,42,203,2022-05-12 18:56:12.409417
31512,12,362,2,39,92,507,2022-05-12 18:56:15.127004
31517,27,206,26,117,329,705,2022-05-12 18:56:18.986119
31519,1765,14884,995,2534,10655,30833,2022-05-12 18:56:21.861013
31521,233,5881,137,87,2362,8700,2022-05-12 18:56:22.270813
31534,62,1326,29,156,185,1758,2022-05-12 18:56:27.858155
31539,64,120,34,139,853,1210,2022-05-12 18:56:32.977186
31540,3088,23865,2056,6562,14378,49949,2022-05-12 18:56:35.902079
31547,22,53,5,53,114,247,2022-05-12 18:56:38.640748
31549,178,766,151,719,591,2405,2022-05-12 18:56:41.161492
31552,923,31276,595,266,15826,48886,2022-05-12 18:56:47.646093
31559,11766,92633,6989,15481,36516,163385,2022-05-12 18:56:51.589029
31560,600,9154,359,380,3569,14062,2022-05-12 18:56:54.669521
31561,285,16122,137,237,2973,19754,2022-05-12 18:56:57.737818
31563,17,131,5,55,169,377,2022-05-12 18:57:00.901056
31564,4031,24894,2151,3187,24577,58840,2022-05-12 18:57:04.183507
31568,16,631,12,47,188,894,2022-05-12 18:57:07.007951
31573,377,1736,283,752,1158,4306,2022-05-12 18:57:09.920202
31578,818,4089,417,2328,3225,10877,2022-05-12 18:57:13.571751
31580,26806,332454,15569,29009,128133,531971,2022-05-12 18:57:13.857086
31581,109,1111,72,77,1554,2923,2022-05-12 18:57:17.43417
31582,12,187,6,33,133,371,2022-05-12 18:57:18.891295
31583,10,215,9,31,110,375,2022-05-12 18:57:20.91253
31584,9,208,7,29,94,347,2022-05-12 18:57:22.068673
31586,35,3626,16,52,263,3992,2022-05-12 18:57:25.41065
31587,12,207,10,35,157,421,2022-05-12 18:57:27.283579
31592,4747,96880,2127,2976,10470,117200,2022-05-12 18:57:28.122664
31593,581,4202,358,289,5867,11297,2022-05-12 18:57:28.454545
31599,25,100,9,69,108,311,2022-05-12 18:57:30.114079
31603,15,124,3,49,89,280,2022-05-12 18:57:32.020755
31604,14,80,8,50,87,239,2022-05-12 18:57:32.954316
31608,90,3936,85,80,1112,5303,2022-05-12 18:57:35.509839
31617,145,937,92,83,3454,4711,2022-05-12 18:57:36.166624
31618,112,998,69,71,631,1881,2022-05-12 18:57:38.211398
31630,13727,47672,9765,23935,28433,123532,2022-05-12 18:57:46.045133
31631,2241,1749,1220,3231,6001,14442,2022-05-12 18:57:49.240175
31633,704,4719,368,3047,4070,12908,2022-05-12 18:57:51.558401
31634,41,5262,15,72,316,5706,2022-05-12 18:57:54.891158
31637,19566,397674,7464,7482,57797,489983,2022-05-12 18:57:58.456583
31638,8,104,1,31,47,191,2022-05-12 18:58:00.764157
31639,10,127,0,38,51,226,2022-05-12 18:58:02.969245
31641,14,388,4,21,78,505,2022-05-12 18:58:06.099918
31642,10,28,1,45,40,124,2022-05-12 18:58:08.136945
31643,9,105,5,29,53,201,2022-05-12 18:58:09.208892
31644,7,277,2,29,45,360,2022-05-12 18:58:10.715325
31646,54104,273115,33677,21049,218782,600727,2022-05-12 18:58:13.819498
31647,203,382,102,186,751,1624,2022-05-12 18:58:16.71461
31658,4221,199712,975,580,40774,246262,2022-05-12 18:58:16.97921
31662,6,129,2,47,49,233,2022-05-12 18:58:19.056624
31667,96,1,45,102,204,448,2022-05-12 18:58:22.898009
31668,95,2513,81,91,1371,4151,2022-05-12 18:58:25.901354
31670,236,2634,129,205,1410,4614,2022-05-12 18:58:32.156974
31673,35,879,15,90,108,1127,2022-05-12 18:58:34.100286
31674,13,508,9,48,72,650,2022-05-12 18:58:35.605863
31675,460,9975,365,368,8182,19350,2022-05-12 18:58:38.375501
31676,167,2259,100,104,3009,5639,2022-05-12 18:58:40.704424
31680,6909,94878,2586,7669,18996,131038,2022-05-12 18:58:43.595048
31686,23,1279,4,35,157,1498,2022-05-12 18:58:49.646116
31687,19,1839,10,46,251,2165,2022-05-12 18:58:52.052636
31690,15,44,5,46,112,222,2022-05-12 18:58:56.374285
31691,12,90,8,51,71,232,2022-05-12 18:58:57.633913
31694,11,66,5,45,41,168,2022-05-12 18:59:01.086611
31695,5,319,2,26,37,389,2022-05-12 18:59:02.710016
31696,12,61,4,59,69,205,2022-05-12 18:59:04.047357
31697,7,37,3,42,46,135,2022-05-12 18:59:05.033642
31700,11,82,4,63,66,226,2022-05-12 18:59:09.082956
31701,10,32,4,55,72,173,2022-05-12 18:59:10.468917
31704,4384,254208,1106,597,30724,291019,2022-05-12 18:59:10.802692
31710,12062,77344,6711,25865,35821,157803,2022-05-12 18:59:12.443437
31715,2007,73401,732,513,18255,94908,2022-05-12 18:59:16.430723
31722,14722,550779,3804,5521,62331,637157,2022-05-12 18:59:21.170505
31730,24,78,8,49,156,315,2022-05-12 18:59:24.945918
31733,2992,33933,1330,931,12756,51942,2022-05-12 18:59:28.103835
31736,904,11252,443,370,4705,17674,2022-05-12 18:59:32.421044
31737,15314,314104,5647,8009,44322,387396,2022-05-12 18:59:32.584474
31741,18105,316822,8468,7034,80214,430643,2022-05-12 18:59:38.380231
31746,15,81,7,73,98,274,2022-05-12 18:59:39.728674
31747,24,262,14,95,122,517,2022-05-12 18:59:40.137131
31749,60,306,16,62,485,929,2022-05-12 18:59:43.740469
31754,558,27186,281,226,6027,34278,2022-05-12 18:59:49.284608
31756,1508,40678,593,489,15090,58358,2022-05-12 18:59:49.741359
31757,7335,296136,2163,949,83260,389843,2022-05-12 18:59:50.053491
31758,8771,288164,2481,1208,97214,397838,2022-05-12 18:59:50.209895
31761,17,541,3,29,99,689,2022-05-12 18:59:52.818861
31763,1520,40601,839,680,23002,66642,2022-05-12 19:00:00.097309
31764,17062,188948,5864,8041,68172,288087,2022-05-12 19:00:00.476848
31765,10619,531537,2619,2417,92737,639929,2022-05-12 19:00:00.64406
31769,11,267,4,25,109,416,2022-05-12 19:00:01.615847
31771,6444,35700,4572,6774,34261,87751,2022-05-12 19:00:04.747003
31772,13262,229058,5378,2397,30116,280211,2022-05-12 19:00:05.063502
31777,69,694,23,92,780,1658,2022-05-12 19:00:07.8516
31783,6209,44209,2953,1978,15767,71116,2022-05-12 19:00:11.319745
31785,148,1448,88,94,1989,3767,2022-05-12 19:00:15.488493
31790,4349,21776,2967,11826,15814,56732,2022-05-12 19:00:18.430894
31793,1279,14152,612,1668,6915,24626,2022-05-12 19:00:21.067761
31798,39911,399913,19592,26652,174929,660997,2022-05-12 19:00:28.544559
31804,5433,32857,3347,8488,20588,70713,2022-05-12 19:00:33.285995
31807,14,235,3,50,120,422,2022-05-12 19:00:34.605895
31812,3674,108579,1360,763,55222,169598,2022-05-12 19:00:35.018035
31815,649,18240,271,667,6062,25889,2022-05-12 19:00:35.186772
31821,5534,95092,2609,2081,25241,130557,2022-05-12 19:00:39.796786
31827,366,1661,210,237,2741,5215,2022-05-12 19:00:42.076068
31830,18,681,6,23,94,822,2022-05-12 19:00:45.612267
31834,12,402,5,35,84,538,2022-05-12 19:00:51.453099
31845,18458,148686,6830,18299,63258,255531,2022-05-12 19:00:58.664338
31846,57,1325,28,51,538,1999,2022-05-12 19:01:01.150892
31848,2944,42177,1239,2623,12318,61301,2022-05-12 19:01:01.390482
31851,318,4085,156,145,3017,7721,2022-05-12 19:01:04.222873
31859,36661,419478,15871,24014,150655,646679,2022-05-12 19:01:10.884521
31861,487,2689,166,156,3269,6767,2022-05-12 19:01:14.283771
31866,189,887,98,112,2925,4211,2022-05-12 19:01:19.124816
31867,325,7450,150,124,4207,12256,2022-05-12 19:01:22.102709
31868,12,74,3,52,159,300,2022-05-12 19:01:23.274935
31872,8,130,2,36,39,215,2022-05-12 19:01:24.606901
31878,10,114,3,28,51,206,2022-05-12 19:01:27.821795
31880,26,1461,11,29,239,1766,2022-05-12 19:01:28.157984
31892,25,35,9,45,225,339,2022-05-12 19:01:40.391084
31898,16,221,13,84,80,414,2022-05-12 19:01:45.078151
31904,12961,120434,5496,22830,47406,209127,2022-05-12 19:01:50.372962
31909,120,6751,72,59,1463,8465,2022-05-12 19:01:55.178755
31911,62,2522,54,90,908,3636,2022-05-12 19:01:57.275305
31914,9311,49735,4769,11369,34617,109801,2022-05-12 19:01:57.965401
31918,2003,31405,1312,557,14058,49335,2022-05-12 19:02:00.914541
31923,90,1066,93,115,1383,2747,2022-05-12 19:02:05.707076
31924,12,60,3,57,60,192,2022-05-12 19:02:06.992909
31926,23,177,9,22,202,433,2022-05-12 19:02:08.701413
31927,492,4297,162,134,4835,9920,2022-05-12 19:02:11.257868
31933,55304,756053,14744,8458,89689,924248,2022-05-12 19:02:14.575302
31941,73,562,39,92,1218,1984,2022-05-12 19:02:16.620066
31948,14,80,11,97,89,291,2022-05-12 19:02:20.079592
31964,116140,2281324,25457,30658,157411,2610990,2022-05-12 19:02:27.950126
31972,13,333,4,30,100,480,2022-05-12 19:02:42.764603
31973,2856,29426,1194,652,13376,47504,2022-05-12 19:02:45.659988
31977,51,1501,21,39,662,2274,2022-05-12 19:02:48.704477
31978,62,1760,42,91,646,2601,2022-05-12 19:02:51.69239
31980,919,32950,373,184,7239,41665,2022-05-12 19:02:54.174887
32015,3188,23463,1842,866,13470,42829,2022-05-12 19:03:11.850203
31988,10030,125276,5598,3309,55682,199895,2022-05-12 19:02:55.219371
31989,656,12112,383,309,12246,25706,2022-05-12 19:02:58.567577
31997,164,4665,98,97,2664,7688,2022-05-12 19:03:02.391639
32005,797,28820,244,305,5429,35595,2022-05-12 19:03:02.842221
32010,17,138,7,50,113,325,2022-05-12 19:03:04.370095
32011,372,2803,225,307,2254,5961,2022-05-12 19:03:06.666104
32013,8839,92572,3787,5297,54356,164851,2022-05-12 19:03:10.417917
32014,14,69,7,56,89,235,2022-05-12 19:03:11.530606
32026,158,8741,87,128,2010,11124,2022-05-12 19:03:14.801171
32030,87,2175,17,78,713,3070,2022-05-12 19:03:17.57609
32031,60,1982,20,69,483,2614,2022-05-12 19:03:19.632888
32032,8761,45113,4336,8496,35233,101939,2022-05-12 19:03:23.518412
32034,79,735,37,70,861,1782,2022-05-12 19:03:25.065353
32038,1922,13236,1195,1147,10655,28155,2022-05-12 19:03:28.984049
32039,680,6861,329,512,4438,12820,2022-05-12 19:03:31.811954
32041,29,414,8,35,194,680,2022-05-12 19:03:33.380681
32051,632,26975,317,251,5828,34003,2022-05-12 19:03:33.687487
32058,61,656,26,54,619,1416,2022-05-12 19:03:35.546028
32059,33,309,17,43,213,615,2022-05-12 19:03:38.263989
32073,6,90,2,33,30,161,2022-05-12 19:03:43.067418
32074,9,97,2,37,34,179,2022-05-12 19:03:44.378378
32084,273,1373,130,218,2555,4549,2022-05-12 19:03:51.934144
32086,1984,67595,634,635,24670,95518,2022-05-12 19:03:53.125392
32088,20,221,15,75,363,694,2022-05-12 19:03:56.770967
32092,9,178,2,21,40,250,2022-05-12 19:03:59.131852
32093,26057,231378,13448,13546,121659,406088,2022-05-12 19:03:59.511361
32105,62608,197632,32138,50480,113510,456368,2022-05-12 19:04:04.292878
32107,13,139,8,48,178,386,2022-05-12 19:04:07.617241
32108,1261,61015,549,407,11874,75106,2022-05-12 19:04:11.335847
32133,84,591,51,88,2088,2902,2022-05-12 19:04:16.554093
32142,13,167,5,69,112,366,2022-05-12 19:04:25.51409
32627,8,31,5,58,61,163,2022-05-12 19:10:19.390808
32144,37,116,7,47,204,411,2022-05-12 19:04:28.915017
32145,17,104,8,66,128,323,2022-05-12 19:04:30.170993
32146,15,122,11,76,162,386,2022-05-12 19:04:31.369832
32147,12,117,9,70,109,317,2022-05-12 19:04:32.487158
32148,20,156,8,68,134,386,2022-05-12 19:04:33.623726
32149,13,122,9,66,130,340,2022-05-12 19:04:34.618151
32151,222,3645,111,107,1994,6079,2022-05-12 19:04:37.203455
32152,3343,295,1316,1125,11988,18067,2022-05-12 19:04:37.521465
32153,521,15915,293,212,8338,25279,2022-05-12 19:04:42.517963
32160,107,1874,51,94,1035,3161,2022-05-12 19:04:46.902553
32166,8,54,3,53,56,174,2022-05-12 19:04:48.063406
32171,3851,17704,1906,5788,22129,51378,2022-05-12 19:04:52.167704
32174,252,4669,131,103,2934,8089,2022-05-12 19:04:55.315303
32175,5229,42142,2799,4781,21470,76421,2022-05-12 19:04:58.39016
32182,89381,1289669,35815,25408,272123,1712396,2022-05-12 19:04:58.820505
32188,3826,176994,1403,522,43143,225888,2022-05-12 19:04:59.242101
32189,15822,216482,7717,7522,64827,312370,2022-05-12 19:04:59.411395
32197,12,73,8,67,79,239,2022-05-12 19:05:06.491571
32202,176,1790,68,110,2676,4820,2022-05-12 19:05:10.598586
32212,4435,8924,2380,3180,20735,39654,2022-05-12 19:05:13.770292
32214,3433,17278,2165,5403,14559,42838,2022-05-12 19:05:16.614566
32215,2230,98107,855,601,17560,119353,2022-05-12 19:05:19.914589
32219,27,368,7,39,168,609,2022-05-12 19:05:24.453928
32221,12,167,7,75,62,323,2022-05-12 19:05:26.077962
32222,28,721,24,80,603,1456,2022-05-12 19:05:28.248093
32224,8,89,3,41,52,193,2022-05-12 19:05:29.834062
32227,7,93,3,49,54,206,2022-05-12 19:05:32.983234
32230,37,397,26,87,236,783,2022-05-12 19:05:38.928019
32237,14,88,10,51,57,220,2022-05-12 19:05:42.834678
32240,235,4327,278,272,3711,8823,2022-05-12 19:05:45.351059
32248,381,346,142,174,2614,3657,2022-05-12 19:05:51.838895
32252,6,38,3,52,43,142,2022-05-12 19:05:53.475999
32254,13,92,3,38,72,218,2022-05-12 19:05:56.522401
32255,11,96,3,58,130,298,2022-05-12 19:05:57.907256
32256,21,397,10,37,195,660,2022-05-12 19:05:59.555146
32257,25,160,13,53,215,466,2022-05-12 19:06:01.02931
32259,26,205,11,44,226,512,2022-05-12 19:06:02.190233
32262,22639,203951,8960,22070,68207,325827,2022-05-12 19:06:03.291089
32264,41,1144,23,58,392,1658,2022-05-12 19:06:05.502308
32676,13,79,8,69,103,272,2022-05-12 19:10:58.197004
32268,9010,150447,4921,1917,55562,221857,2022-05-12 19:06:09.646168
32269,9,86,2,54,59,210,2022-05-12 19:06:11.792316
32271,10197,42145,4225,18872,51628,127067,2022-05-12 19:06:17.313674
32274,98,1878,66,119,919,3080,2022-05-12 19:06:19.71442
32276,15,48,4,56,102,225,2022-05-12 19:06:22.175099
32281,51216,2011532,6099,3293,267118,2339258,2022-05-12 19:06:22.460203
32282,41193,862605,11750,9826,90302,1015676,2022-05-12 19:06:24.920283
33319,7,27,3,40,60,137,2022-05-12 19:21:56.055449
32288,13,643,3,31,83,773,2022-05-12 19:06:28.523509
32289,19,742,5,48,97,911,2022-05-12 19:06:29.764735
32293,9,364,3,20,50,446,2022-05-12 19:06:33.422491
32294,36,3538,13,81,227,3895,2022-05-12 19:06:37.258984
32295,16,536,5,46,116,719,2022-05-12 19:06:38.620182
32296,17,553,3,31,76,680,2022-05-12 19:06:43.426872
32297,20,356,6,25,80,487,2022-05-12 19:06:44.941587
32298,12,511,4,25,70,622,2022-05-12 19:06:46.576266
32301,1081,10399,669,1244,6142,19535,2022-05-12 19:06:49.812155
32310,9,94,3,35,50,191,2022-05-12 19:06:51.554069
32311,80,5982,51,85,858,7056,2022-05-12 19:06:51.906101
32316,74,490,31,58,745,1398,2022-05-12 19:06:56.521995
32321,163,2480,97,90,2184,5014,2022-05-12 19:06:58.86658
32322,7,140,1,29,28,205,2022-05-12 19:06:59.934654
32323,5803,33945,2231,3570,27283,72832,2022-05-12 19:07:00.109015
32345,15,281,4,34,75,409,2022-05-12 19:07:12.2731
32346,15,428,14,42,149,648,2022-05-12 19:07:13.592919
32353,729,0,379,686,881,2675,2022-05-12 19:07:15.322005
32359,78,2817,76,115,1118,4204,2022-05-12 19:07:18.200774
32360,11947,86471,4945,11823,56247,171433,2022-05-12 19:07:18.658158
32365,1345,84269,429,477,11618,98138,2022-05-12 19:07:18.996987
32366,2816,52067,850,587,18108,74428,2022-05-12 19:07:22.043094
32369,12,49,5,54,88,208,2022-05-12 19:07:24.255518
33383,20,43,3,40,81,187,2022-05-12 19:22:44.023441
32370,11878,98356,5276,5488,54672,175670,2022-05-12 19:07:27.429255
32376,50,1103,36,52,526,1767,2022-05-12 19:07:30.462934
32377,68,1009,19,37,454,1587,2022-05-12 19:07:32.811505
32379,18695,179068,6419,29788,80632,314602,2022-05-12 19:07:33.133549
32380,3898,315157,933,567,28176,348731,2022-05-12 19:07:33.299398
32385,30,329,6,30,245,640,2022-05-12 19:07:42.741394
32397,103,604,56,69,1069,1901,2022-05-12 19:07:45.951047
32402,26,41,12,109,215,403,2022-05-12 19:07:48.360123
32407,10336,69596,4715,17865,43591,146103,2022-05-12 19:07:50.907358
32408,17,136,6,48,85,292,2022-05-12 19:07:52.354612
32409,1016,20545,496,357,7864,30278,2022-05-12 19:07:53.118425
32410,495,4322,226,295,5303,10641,2022-05-12 19:07:56.196319
32415,382,5729,140,159,4012,10422,2022-05-12 19:07:59.137834
32417,13,59,3,50,63,188,2022-05-12 19:08:00.320597
32418,9,62,4,54,54,183,2022-05-12 19:08:01.605707
32419,9,59,4,58,62,192,2022-05-12 19:08:02.873354
32420,7,56,2,48,29,142,2022-05-12 19:08:03.907951
32421,7,215,6,60,51,339,2022-05-12 19:08:05.389579
32430,8,142,1,27,26,204,2022-05-12 19:08:06.864986
32438,13209,119103,5761,23448,44041,205562,2022-05-12 19:08:14.00553
32446,67,1898,16,67,479,2527,2022-05-12 19:08:17.587776
32447,2944,17342,1083,4343,14444,40156,2022-05-12 19:08:20.571437
32454,583,6884,302,779,3131,11679,2022-05-12 19:08:24.881292
32455,1242,4019,485,1879,5771,13396,2022-05-12 19:08:28.138043
32467,117,2559,52,75,1403,4206,2022-05-12 19:08:33.5067
32468,167,5282,102,134,2077,7762,2022-05-12 19:08:36.375502
32472,9,53,3,51,31,147,2022-05-12 19:08:37.46589
32473,10,116,1,30,28,185,2022-05-12 19:08:38.585665
32475,8,59,4,47,37,155,2022-05-12 19:08:39.671523
32481,96,2869,87,105,1796,4953,2022-05-12 19:08:42.930579
32485,1868,113940,661,434,18087,134990,2022-05-12 19:08:47.088795
32494,12084,71522,5774,12823,28931,131134,2022-05-12 19:08:50.382569
32503,75,595,26,57,635,1388,2022-05-12 19:08:55.945439
32511,222,1793,146,143,2511,4815,2022-05-12 19:08:58.92726
32521,32,903,13,51,344,1343,2022-05-12 19:09:00.777345
32526,9976,102501,4886,6379,41544,165286,2022-05-12 19:09:01.044961
32534,133,1121,45,92,1142,2533,2022-05-12 19:09:04.291526
32542,50505,408071,32117,44657,144008,679358,2022-05-12 19:09:05.020772
33913,14,41,3,45,61,164,2022-05-12 19:30:37.767722
32548,167,2270,48,84,1869,4438,2022-05-12 19:09:12.591542
32553,1526,70321,883,431,14566,87727,2022-05-12 19:09:19.281161
32555,2504,15432,1436,2495,15316,37183,2022-05-12 19:09:22.484481
32557,17,171,4,48,93,333,2022-05-12 19:09:23.781646
32559,14,69,1,40,55,179,2022-05-12 19:09:25.306784
32561,900,40775,371,292,9436,51774,2022-05-12 19:09:27.952319
32563,47,456,22,66,465,1056,2022-05-12 19:09:30.166005
32566,1521,32417,416,387,14472,49213,2022-05-12 19:09:32.191262
32571,422,642,266,762,630,2722,2022-05-12 19:09:35.443388
32574,686,26753,397,180,9794,37810,2022-05-12 19:09:38.587912
32580,18,93,7,71,103,292,2022-05-12 19:09:39.846647
32582,95,279,35,193,642,1244,2022-05-12 19:09:43.359214
32583,8,163,0,29,38,238,2022-05-12 19:09:44.576262
32585,34,58,15,120,164,391,2022-05-12 19:09:45.974387
32590,20,61,4,70,82,237,2022-05-12 19:09:47.231208
32593,14,113,8,61,130,326,2022-05-12 19:09:49.085377
32595,9462,43737,3965,14885,21989,94038,2022-05-12 19:09:49.496289
32598,10,40,1,38,48,137,2022-05-12 19:09:52.374621
32600,33,899,10,35,279,1256,2022-05-12 19:09:54.515024
32601,2028,18627,1412,3098,6531,31696,2022-05-12 19:09:57.625098
32603,6888,111041,2437,2935,26643,149944,2022-05-12 19:09:57.955451
32607,6958,38917,4820,6728,39601,97024,2022-05-12 19:10:01.3882
32608,7758,20275,4226,17671,17728,67658,2022-05-12 19:10:03.996673
43804,0,9,1,8,17,35,2022-05-12 21:46:15.307456
32613,2723,5314,1292,1982,11109,22420,2022-05-12 19:10:06.409715
32615,46282,520412,21650,26267,161525,776136,2022-05-12 19:10:06.867079
32618,6,247,1,23,36,313,2022-05-12 19:10:09.112358
32621,12,69,3,43,69,196,2022-05-12 19:10:10.530865
32622,16,155,8,43,108,330,2022-05-12 19:10:11.764686
32623,8,105,3,42,59,217,2022-05-12 19:10:13.007688
32625,485,7186,302,179,4592,12744,2022-05-12 19:10:13.186309
32626,9,154,4,53,76,296,2022-05-12 19:10:17.702415
32628,14,70,5,47,104,240,2022-05-12 19:10:20.914368
32629,10,51,5,80,83,229,2022-05-12 19:10:22.160894
32630,15,82,8,71,82,258,2022-05-12 19:10:23.448875
32633,113,368,75,80,990,1626,2022-05-12 19:10:27.458501
32636,12,266,0,23,68,369,2022-05-12 19:10:29.851092
32637,14,325,6,34,72,451,2022-05-12 19:10:31.907013
32642,10,306,0,36,69,421,2022-05-12 19:10:36.217944
32646,20,71,10,50,83,234,2022-05-12 19:10:39.07001
32648,15540,144287,7907,12288,73082,253104,2022-05-12 19:10:39.520625
32660,22,97,11,62,189,381,2022-05-12 19:10:41.531803
32663,57,173,27,110,340,707,2022-05-12 19:10:43.060847
32664,4666,39313,2540,5618,12125,64262,2022-05-12 19:10:46.673213
32665,37,192,11,54,311,605,2022-05-12 19:10:48.890497
32666,11,125,4,48,81,269,2022-05-12 19:10:50.378174
32668,2987,81311,673,655,22614,108240,2022-05-12 19:10:50.705575
32673,7790,59074,3895,4719,43844,119322,2022-05-12 19:10:56.432349
32681,7570,83241,4425,4602,37470,137308,2022-05-12 19:11:01.171506
32684,101,2637,51,110,855,3754,2022-05-12 19:11:04.784235
32686,23607,208632,11609,26466,90457,360771,2022-05-12 19:11:05.700523
32691,336,2202,234,381,1285,4438,2022-05-12 19:11:08.843998
32693,10,124,5,60,79,278,2022-05-12 19:11:10.113786
32695,46,516,9,31,318,920,2022-05-12 19:11:11.838676
32697,1261,9065,603,2534,5905,19368,2022-05-12 19:11:18.904303
43861,0,2,0,6,8,16,2022-05-12 21:46:32.938682
32698,3573,75837,1394,638,17387,98829,2022-05-12 19:11:21.63054
32700,192,5215,104,130,1911,7552,2022-05-12 19:11:24.238937
32707,76,301,44,83,396,900,2022-05-12 19:11:25.6148
32728,25,650,5,43,182,905,2022-05-12 19:11:30.025598
32729,41380,426763,20601,26680,201623,717047,2022-05-12 19:11:30.219909
32732,7,94,0,36,45,182,2022-05-12 19:11:37.051803
32737,46,656,29,87,488,1306,2022-05-12 19:11:44.407762
32738,12,64,5,44,59,184,2022-05-12 19:11:47.389257
32739,80,1608,61,112,1137,2998,2022-05-12 19:11:49.460336
32747,11,369,2,24,47,453,2022-05-12 19:11:56.800538
32748,11,392,4,23,63,493,2022-05-12 19:11:58.22689
32750,9,370,4,29,72,484,2022-05-12 19:12:02.624572
32755,6,266,2,18,55,347,2022-05-12 19:12:07.69302
32756,8,191,2,15,43,259,2022-05-12 19:12:08.960302
32758,7,201,2,21,37,268,2022-05-12 19:12:11.623278
32760,7,293,3,18,64,385,2022-05-12 19:12:14.725588
32763,11,278,4,18,65,376,2022-05-12 19:12:18.37178
32764,11,301,5,17,67,401,2022-05-12 19:12:19.710697
32765,5,326,3,17,75,426,2022-05-12 19:12:20.988687
32767,7,269,5,23,41,345,2022-05-12 19:12:22.783508
32768,10,206,3,20,51,290,2022-05-12 19:12:23.799076
32772,1552,1164,793,1815,2586,7910,2022-05-12 19:12:24.774164
32773,79,0,21,83,134,317,2022-05-12 19:12:24.934604
32776,8,212,3,20,54,297,2022-05-12 19:12:26.508733
32777,5,181,2,20,30,238,2022-05-12 19:12:27.614461
32786,1,94,2,5,18,120,2022-05-12 19:12:30.115054
32796,13,39,4,57,64,177,2022-05-12 19:12:32.585452
32797,12,37,3,58,58,168,2022-05-12 19:12:33.692462
32799,50,0,19,61,64,194,2022-05-12 19:12:34.80771
32801,2439,124848,733,499,26953,155472,2022-05-12 19:12:36.305287
32802,454,5436,177,334,2045,8446,2022-05-12 19:12:41.455557
32803,9,307,4,25,103,448,2022-05-12 19:12:43.056892
32804,8,627,8,38,86,767,2022-05-12 19:12:44.517573
32805,631,2182,458,1220,1645,6136,2022-05-12 19:12:46.919404
32807,15,180,9,91,65,360,2022-05-12 19:12:51.411413
32808,12,127,5,79,69,292,2022-05-12 19:12:52.5195
32811,6,315,1,19,63,404,2022-05-12 19:12:54.751795
32812,10,290,5,20,63,388,2022-05-12 19:12:56.106705
32813,10,901,4,42,81,1038,2022-05-12 19:12:57.745486
32816,77,2245,63,82,1034,3501,2022-05-12 19:12:59.772778
32817,81,1978,63,78,1032,3232,2022-05-12 19:13:01.743759
32818,10,132,5,79,50,276,2022-05-12 19:13:02.949326
32819,11,116,8,87,62,284,2022-05-12 19:13:03.944584
32820,14,123,6,87,57,287,2022-05-12 19:13:04.92042
32821,8,106,5,76,51,246,2022-05-12 19:13:06.00775
32823,14,46,4,50,84,198,2022-05-12 19:13:06.938241
32826,76,1609,37,58,703,2483,2022-05-12 19:13:09.812014
32827,16250,192531,7854,11681,77460,305776,2022-05-12 19:13:10.221514
32828,22339,146807,13139,13444,85867,281596,2022-05-12 19:13:10.633607
32829,1955,10030,1055,1734,6053,20827,2022-05-12 19:13:13.562578
32830,194,364,257,573,1070,2458,2022-05-12 19:13:15.262621
32831,245,1,110,107,161,624,2022-05-12 19:13:15.687698
32832,61,160,35,51,1136,1443,2022-05-12 19:13:18.120434
32835,17,104,3,69,125,318,2022-05-12 19:13:22.136934
32836,2290,17508,792,720,10809,32119,2022-05-12 19:13:26.90783
32842,27,72,10,83,128,320,2022-05-12 19:13:28.294491
32843,2697,13705,605,745,16198,33950,2022-05-12 19:13:28.770259
32844,10,200,3,18,54,285,2022-05-12 19:13:30.508375
32847,11,201,1,19,64,296,2022-05-12 19:13:32.727194
32850,9,195,1,24,39,268,2022-05-12 19:13:34.266779
32851,10,174,2,20,37,243,2022-05-12 19:13:35.669077
32852,8,202,3,20,52,285,2022-05-12 19:13:36.722656
32854,10,460,3,21,75,569,2022-05-12 19:13:40.041588
32855,13,241,3,18,63,338,2022-05-12 19:13:41.671998
32856,8,246,2,24,46,326,2022-05-12 19:13:43.397516
32857,7,130,0,14,35,186,2022-05-12 19:13:44.57163
32859,4,227,3,23,40,297,2022-05-12 19:13:47.042464
32861,10,227,0,17,47,301,2022-05-12 19:13:49.392881
32863,1914,39801,1233,772,20266,63986,2022-05-12 19:13:52.207539
32867,35290,524625,14942,7941,114095,696893,2022-05-12 19:13:56.6948
32868,10,230,2,16,51,309,2022-05-12 19:13:57.653523
32869,636,22380,299,325,9970,33610,2022-05-12 19:14:00.260567
32870,575,19091,280,308,9370,29624,2022-05-12 19:14:04.551446
32871,760,22085,306,357,10332,33840,2022-05-12 19:14:04.953315
32875,12,413,4,40,95,564,2022-05-12 19:14:08.24623
32878,3256,19893,1683,7235,13253,45320,2022-05-12 19:14:11.256684
32879,149,3685,67,111,1747,5759,2022-05-12 19:14:15.135799
32881,2535,6853,1551,4064,5325,20328,2022-05-12 19:14:16.123272
32884,10,62,4,59,74,209,2022-05-12 19:14:17.535546
32885,14,79,4,36,93,226,2022-05-12 19:14:19.631653
32886,135,1480,89,117,1483,3304,2022-05-12 19:14:21.981584
32887,19603,260148,8775,16467,86707,391700,2022-05-12 19:14:22.147717
32888,46,528,25,65,737,1401,2022-05-12 19:14:27.160745
32890,23,109,3,54,116,305,2022-05-12 19:14:30.527264
32892,34,91,9,86,149,369,2022-05-12 19:14:32.648638
32897,18,96,10,48,135,307,2022-05-12 19:14:37.644698
32898,71,1275,48,80,800,2274,2022-05-12 19:14:39.702674
32900,4188,112834,1453,734,48542,167751,2022-05-12 19:14:44.239772
32901,34463,449488,14741,44041,98807,641540,2022-05-12 19:14:44.431471
32904,7,49,6,38,40,140,2022-05-12 19:14:52.664859
32906,400,3612,195,1470,1626,7303,2022-05-12 19:14:56.865836
32915,1012,32502,583,292,15894,50283,2022-05-12 19:15:00.12743
32927,64,795,37,51,780,1727,2022-05-12 19:15:11.265151
32932,93,1033,53,102,974,2255,2022-05-12 19:15:15.909474
32933,11,215,7,50,74,357,2022-05-12 19:15:17.838752
32934,46,1427,23,62,494,2052,2022-05-12 19:15:19.585209
32935,34639,890139,7359,4724,89192,1026053,2022-05-12 19:15:19.904094
32936,8101,53789,3150,8886,27685,101611,2022-05-12 19:15:24.186029
32937,48663,1099969,15334,11414,127611,1302991,2022-05-12 19:15:24.613446
32943,28,354,15,39,243,679,2022-05-12 19:15:26.81444
32947,3478,21521,2480,7139,15208,49826,2022-05-12 19:15:35.307487
32949,38584,348008,16586,30400,167856,601434,2022-05-12 19:15:36.055693
32950,211,2425,85,139,3139,5999,2022-05-12 19:15:39.457076
32951,35304,464412,10771,18864,93542,622893,2022-05-12 19:15:39.770594
32954,869,8754,623,658,4403,15307,2022-05-12 19:15:44.262214
32956,169,23,58,185,240,675,2022-05-12 19:15:45.277369
32959,575,2355,385,260,556,4131,2022-05-12 19:15:49.559435
32961,2910,7532,1631,4392,11422,27887,2022-05-12 19:15:52.160649
32977,10906,51132,6295,5303,22054,95690,2022-05-12 19:15:56.438865
32979,12990,75509,9270,9076,68198,175043,2022-05-12 19:16:01.181974
32983,9609,86381,3226,1818,61621,162655,2022-05-12 19:16:04.812479
32989,52,217,30,73,556,928,2022-05-12 19:16:07.710484
32995,40404,581735,16692,29825,107770,776426,2022-05-12 19:16:08.472905
32998,40069,333311,25184,24146,194322,617032,2022-05-12 19:16:14.994645
32999,32,159,11,104,251,557,2022-05-12 19:16:17.436054
33002,19,77,12,95,107,310,2022-05-12 19:16:19.143446
33003,9606,74347,4556,7947,49723,146179,2022-05-12 19:16:20.694082
33004,1766,21047,937,697,11026,35473,2022-05-12 19:16:20.861205
33010,4789,42341,2052,2545,68690,120417,2022-05-12 19:16:21.173873
33011,682,4601,306,853,2527,8969,2022-05-12 19:16:23.855906
33012,9724,53194,4748,16888,36202,120756,2022-05-12 19:16:28.082348
33013,1760,16214,736,478,9379,28567,2022-05-12 19:16:28.500226
33018,10089,30952,5051,14512,51944,112548,2022-05-12 19:16:28.892235
33021,786,5844,248,1270,3873,12021,2022-05-12 19:16:32.291502
43865,0,2,0,7,8,17,2022-05-12 21:46:34.04215
33023,6489,21828,3232,8549,36504,76602,2022-05-12 19:16:33.392576
33024,177,3774,77,81,1720,5829,2022-05-12 19:16:36.826668
33025,201,3080,87,87,2673,6128,2022-05-12 19:16:38.609134
33027,598,2109,337,1030,4186,8260,2022-05-12 19:16:43.817402
33028,12950,206170,6769,5976,52845,284710,2022-05-12 19:16:47.118916
33031,2762,20233,1397,2790,13692,40874,2022-05-12 19:16:50.145606
33033,202,3558,111,157,2846,6874,2022-05-12 19:16:57.053184
33034,640,12539,315,166,8949,22609,2022-05-12 19:17:00.42344
33035,234,7218,125,92,3692,11361,2022-05-12 19:17:03.133703
33041,1608,14773,869,1424,6220,24894,2022-05-12 19:17:07.861418
33044,65,104,30,203,294,696,2022-05-12 19:17:12.847522
33045,984,5872,583,1284,4452,13175,2022-05-12 19:17:15.742788
33046,3403,20081,1797,3862,13708,42851,2022-05-12 19:17:18.312546
33048,125,400,73,113,2306,3017,2022-05-12 19:17:23.807782
33049,6662,225779,1861,911,83443,318656,2022-05-12 19:17:24.238736
33050,6282,162736,1739,695,98439,269891,2022-05-12 19:17:24.686468
33051,9157,83523,3857,2295,21559,120391,2022-05-12 19:17:25.098369
33056,236,3302,76,112,2138,5864,2022-05-12 19:17:28.632946
33059,8,93,2,30,36,169,2022-05-12 19:17:29.79865
33062,6,98,2,35,42,183,2022-05-12 19:17:32.772291
33064,2788,6137,1058,553,9773,20309,2022-05-12 19:17:35.807372
33069,328,11510,169,132,5048,17187,2022-05-12 19:17:38.196273
33071,1753,107402,744,357,30635,140891,2022-05-12 19:17:41.1078
33075,1086,37497,491,291,14007,53372,2022-05-12 19:17:46.168015
33079,12,50,4,55,120,241,2022-05-12 19:17:50.417397
33080,4497,52348,1954,2075,15059,75933,2022-05-12 19:17:51.366608
33083,9,68,4,63,48,192,2022-05-12 19:17:53.210784
33084,7,63,2,56,35,163,2022-05-12 19:17:54.792779
33085,23,85,6,95,127,336,2022-05-12 19:17:56.053023
33086,17,105,3,62,77,264,2022-05-12 19:17:57.17268
33087,206,521,127,123,2969,3946,2022-05-12 19:18:00.951702
33089,4540,35065,2578,4527,28398,75108,2022-05-12 19:18:04.185415
33091,4338,46109,2034,1927,32788,87196,2022-05-12 19:18:07.122273
33095,10378,67145,5339,3405,82268,168535,2022-05-12 19:18:12.44801
33099,20,63,4,96,72,255,2022-05-12 19:18:14.093598
33102,276,3577,169,135,3167,7324,2022-05-12 19:18:17.848137
33103,143,2177,74,72,1135,3601,2022-05-12 19:18:20.028329
33105,49,575,27,69,483,1203,2022-05-12 19:18:23.265659
33106,210,3596,110,116,2756,6788,2022-05-12 19:18:25.828822
33108,9,71,8,78,59,225,2022-05-12 19:18:27.779777
33113,1782,4898,820,4443,7773,19716,2022-05-12 19:18:30.146459
33114,11,198,7,37,152,405,2022-05-12 19:18:31.725648
33115,8,77,2,48,60,195,2022-05-12 19:18:32.970373
33116,9,86,4,48,59,206,2022-05-12 19:18:34.120697
33118,497,3539,536,193,2200,6965,2022-05-12 19:18:36.501327
33119,174,2844,81,103,1797,4999,2022-05-12 19:18:39.162894
33122,20,206,5,57,128,416,2022-05-12 19:18:40.472621
33123,17,61,6,54,85,223,2022-05-12 19:18:41.477416
33124,11,228,1,35,42,317,2022-05-12 19:18:42.66222
33126,47,217,21,44,409,738,2022-05-12 19:18:44.30133
33129,286,7981,161,149,5926,14503,2022-05-12 19:18:47.239253
33132,8,33,9,71,39,160,2022-05-12 19:18:49.32286
33133,14,82,13,96,84,289,2022-05-12 19:18:50.615309
33134,8,40,7,63,38,156,2022-05-12 19:18:51.643747
33135,14,82,12,94,83,285,2022-05-12 19:18:52.751066
33136,7,39,5,64,37,152,2022-05-12 19:18:53.769868
33142,2279,50165,1159,1634,13260,68497,2022-05-12 19:18:54.499208
33145,83,1172,76,112,1322,2765,2022-05-12 19:18:59.127787
33146,73,679,70,107,1023,1952,2022-05-12 19:18:59.404849
33148,69,677,62,92,991,1891,2022-05-12 19:19:01.246893
33149,99,814,73,104,1225,2315,2022-05-12 19:19:01.68606
33150,70,679,62,108,1000,1919,2022-05-12 19:19:03.832817
33151,38,272,42,62,643,1057,2022-05-12 19:19:05.442824
33154,38,103,14,55,341,551,2022-05-12 19:19:08.351224
33155,193,4477,186,234,2900,7990,2022-05-12 19:19:11.474352
33157,1312,17765,760,347,10880,31064,2022-05-12 19:19:12.863401
33161,4163,180392,1092,663,27422,213732,2022-05-12 19:19:16.653546
33163,34,309,16,57,276,692,2022-05-12 19:19:18.042017
33164,1513,15433,902,796,10067,28711,2022-05-12 19:19:18.292867
33170,168,2742,103,105,1936,5054,2022-05-12 19:19:21.538208
33173,273,3865,186,82,2126,6532,2022-05-12 19:19:24.472626
33175,10,53,2,40,76,181,2022-05-12 19:19:28.262998
33176,16,122,1,41,96,276,2022-05-12 19:19:29.490549
33177,9,84,1,44,57,195,2022-05-12 19:19:30.662781
33181,423,9017,242,156,6973,16811,2022-05-12 19:19:33.606926
33183,80,1653,50,116,1142,3041,2022-05-12 19:19:34.043451
33185,167,1317,99,109,5202,6894,2022-05-12 19:19:39.163538
33187,29,6254,17,49,238,6587,2022-05-12 19:19:42.01167
33188,21,44,4,112,100,281,2022-05-12 19:19:43.648353
33190,1576,17532,681,303,22289,42381,2022-05-12 19:19:44.08737
33194,23,124,9,57,178,391,2022-05-12 19:19:52.888108
33197,3677,24921,1988,3697,19398,53681,2022-05-12 19:19:57.444241
33200,10,57,5,59,61,192,2022-05-12 19:19:59.054753
33201,133,11728,63,62,1050,13036,2022-05-12 19:20:01.692671
33203,7037,55661,3573,7734,35906,109911,2022-05-12 19:20:01.944974
33206,62540,789676,26208,24299,166717,1069440,2022-05-12 19:20:06.444769
33208,246,1253,140,92,2636,4367,2022-05-12 19:20:08.657884
33209,783,7255,298,270,4080,12686,2022-05-12 19:20:11.285154
33215,5,198,2,23,43,271,2022-05-12 19:20:15.434596
33217,6,261,2,23,47,339,2022-05-12 19:20:17.923547
33218,996,8184,525,291,23670,33666,2022-05-12 19:20:20.931978
33220,12,705,4,35,75,831,2022-05-12 19:20:27.381478
33221,504,13676,177,171,4718,19246,2022-05-12 19:20:28.29258
33225,51,541,34,84,559,1269,2022-05-12 19:20:30.707473
33228,46,354,29,71,569,1069,2022-05-12 19:20:34.485934
33236,8,356,5,17,83,469,2022-05-12 19:20:39.157622
33237,20,50,3,45,132,250,2022-05-12 19:20:40.581674
33238,33,392,7,43,286,761,2022-05-12 19:20:42.324407
33240,779,1535,529,806,3041,6690,2022-05-12 19:20:46.803995
33241,2437,38613,760,644,26001,68455,2022-05-12 19:20:47.26878
33242,998,18872,439,475,9144,29928,2022-05-12 19:20:47.601155
33244,2060,12473,789,2093,10845,28260,2022-05-12 19:20:50.887466
33245,308,2588,233,406,2755,6290,2022-05-12 19:20:53.046524
33247,168,1976,72,73,1882,4171,2022-05-12 19:20:55.711728
33253,9799,203733,4825,4794,43428,266579,2022-05-12 19:20:59.046666
33255,92546,573560,43684,29567,168074,907431,2022-05-12 19:21:00.056322
33262,21,51,10,98,102,282,2022-05-12 19:21:03.008397
33266,84,235,29,95,422,865,2022-05-12 19:21:05.763596
33267,78,10,15,62,344,509,2022-05-12 19:21:07.526335
33271,63,143,27,62,354,649,2022-05-12 19:21:09.411279
33273,11,189,2,37,96,335,2022-05-12 19:21:12.117306
33274,971,6523,626,2136,3143,13399,2022-05-12 19:21:14.895763
33276,21,728,23,63,324,1159,2022-05-12 19:21:17.166563
33278,37,174,18,71,262,562,2022-05-12 19:21:18.584806
33279,21,132,8,40,99,300,2022-05-12 19:21:19.701254
33280,1036,19457,394,247,15796,36930,2022-05-12 19:21:20.133342
33281,37,2255,9,46,328,2675,2022-05-12 19:21:22.051474
33282,12,667,5,41,82,807,2022-05-12 19:21:25.523044
33286,12317,109456,4853,3971,44864,175461,2022-05-12 19:21:29.814358
33290,25,74,11,97,139,346,2022-05-12 19:21:31.06751
33299,3382,26364,1272,2329,17068,50415,2022-05-12 19:21:35.135271
33300,15,100,6,74,88,283,2022-05-12 19:21:37.010493
33302,250,5646,143,139,4822,11000,2022-05-12 19:21:40.215269
33308,62,1002,36,62,973,2135,2022-05-12 19:21:44.930075
33309,639,1985,222,281,4509,7636,2022-05-12 19:21:47.978006
33312,15,659,8,29,96,807,2022-05-12 19:21:50.521574
33314,1435,5189,1004,1755,3724,13107,2022-05-12 19:21:53.306834
33318,9,139,0,21,47,216,2022-05-12 19:21:54.90819
33320,6,30,2,37,57,132,2022-05-12 19:21:57.735575
33323,1127,41578,399,231,11097,54432,2022-05-12 19:21:58.180329
33325,14,124,6,66,103,313,2022-05-12 19:21:59.586947
33335,16,362,12,56,217,663,2022-05-12 19:22:01.82421
33337,8243,73108,5583,7189,52106,146229,2022-05-12 19:22:04.874685
33338,1042,49955,387,245,10930,62559,2022-05-12 19:22:05.288587
33339,324,342,155,195,1401,2417,2022-05-12 19:22:07.270477
33341,1163,6006,741,2234,5446,15590,2022-05-12 19:22:10.886417
33342,8,89,6,55,62,220,2022-05-12 19:22:12.372537
33344,10,247,11,52,150,470,2022-05-12 19:22:14.902702
33348,21,98,5,39,154,317,2022-05-12 19:22:16.103496
33350,3120,7365,1056,1078,24581,37200,2022-05-12 19:22:17.652138
33352,114234,928550,50578,44960,352788,1491110,2022-05-12 19:22:18.211743
33354,16294,43129,6948,5388,36094,107853,2022-05-12 19:22:22.643148
33357,190,265,83,103,726,1367,2022-05-12 19:22:24.832894
33358,25,169,10,56,246,506,2022-05-12 19:22:26.015097
33360,239,3588,281,267,3664,8039,2022-05-12 19:22:28.860665
33362,958,8190,503,677,5419,15747,2022-05-12 19:22:31.924591
33363,149,2526,65,88,1639,4467,2022-05-12 19:22:32.335234
33369,7,465,3,14,50,539,2022-05-12 19:22:35.128659
33371,2097,12488,1465,3202,9858,29110,2022-05-12 19:22:37.812772
33372,1069,37607,477,624,14690,54467,2022-05-12 19:22:38.862531
33377,12763,32553,7322,19261,36750,108649,2022-05-12 19:22:42.464823
33378,816,8738,279,184,11774,21791,2022-05-12 19:22:42.86877
33387,18,69,5,57,84,233,2022-05-12 19:22:46.310264
33389,41,144,32,47,731,995,2022-05-12 19:22:48.510847
33390,98,391,35,64,926,1514,2022-05-12 19:22:50.367718
33391,65,874,36,46,1365,2386,2022-05-12 19:22:52.628205
33392,1989,22926,1058,3689,7633,37295,2022-05-12 19:22:52.799453
33394,422,2116,195,1445,3563,7741,2022-05-12 19:22:55.682544
33396,186,313,52,128,555,1234,2022-05-12 19:22:57.644939
33400,8,175,1,19,40,243,2022-05-12 19:23:01.705269
33414,36,67,10,91,146,350,2022-05-12 19:23:04.031679
33415,30,29,5,60,110,234,2022-05-12 19:23:04.979458
33417,3661,60393,1384,2238,13524,81200,2022-05-12 19:23:05.217204
33421,14019,71284,5250,12039,73093,175685,2022-05-12 19:23:08.925753
33422,15,95,1,45,70,226,2022-05-12 19:23:10.64659
33430,53,828,31,131,159,1202,2022-05-12 19:23:13.090517
33431,5,31,3,20,29,88,2022-05-12 19:23:14.705914
33433,14717,72007,8552,18421,50517,164214,2022-05-12 19:23:14.883822
33434,223,386,129,500,856,2094,2022-05-12 19:23:17.022238
33438,101,95,57,60,1426,1739,2022-05-12 19:23:19.806461
33443,765,768,221,205,2192,4151,2022-05-12 19:23:22.700347
33446,852,6455,270,269,4794,12640,2022-05-12 19:23:25.991713
33447,937,8534,426,1441,3912,15250,2022-05-12 19:23:29.164826
33454,40,281,17,57,443,838,2022-05-12 19:23:31.093779
33455,311,4397,115,106,3321,8250,2022-05-12 19:23:33.743621
33457,52,929,63,146,1162,2352,2022-05-12 19:23:36.553632
33462,1228,10700,697,2506,5834,20965,2022-05-12 19:23:38.856611
33473,25,128,8,97,225,483,2022-05-12 19:23:43.470494
33475,18032,237921,5937,12494,59039,333423,2022-05-12 19:23:47.804046
33478,12710,98424,4175,6140,54934,176383,2022-05-12 19:23:47.983759
33484,9,80,5,52,67,213,2022-05-12 19:23:54.254644
33486,120022,1936204,19409,16630,97924,2190189,2022-05-12 19:23:56.46994
33487,40193,543404,14553,29256,109875,737281,2022-05-12 19:23:56.795852
43871,0,1,0,6,10,17,2022-05-12 21:46:35.450605
43874,0,0,0,0,0,0,2022-05-12 21:46:37.012342
33490,189,2146,107,157,1294,3893,2022-05-12 19:24:04.931488
33493,40,342,16,45,298,741,2022-05-12 19:24:08.660871
33499,17,325,8,61,143,554,2022-05-12 19:24:13.563561
33502,23063,207927,9186,10407,96656,347239,2022-05-12 19:24:18.766909
33506,32671,488857,15877,17182,113457,668044,2022-05-12 19:24:18.964163
33513,1859,62192,1289,996,31320,97656,2022-05-12 19:24:27.688893
33519,1170,20663,543,564,19526,42466,2022-05-12 19:24:30.653391
43875,0,2,0,8,10,20,2022-05-12 21:46:37.974732
33520,1062,19789,510,565,19875,41801,2022-05-12 19:24:34.052998
33522,171,2581,73,119,1810,4754,2022-05-12 19:24:38.901369
33523,8,140,4,35,64,251,2022-05-12 19:24:40.167026
33524,771,62749,410,368,13233,77531,2022-05-12 19:24:40.429881
33526,4,157,3,32,43,239,2022-05-12 19:24:45.091336
33527,16,170,3,34,64,287,2022-05-12 19:24:46.94055
33528,12,81,6,39,105,243,2022-05-12 19:24:48.678043
33529,9,138,3,31,52,233,2022-05-12 19:24:51.131369
33531,3968,11618,1872,4648,14007,36113,2022-05-12 19:24:54.174314
33533,18,83,6,57,118,282,2022-05-12 19:24:58.486291
33535,19,129,2,37,118,305,2022-05-12 19:25:00.52348
33537,18,187,2,29,113,349,2022-05-12 19:25:02.322764
33538,37,57,10,83,312,499,2022-05-12 19:25:04.824668
33540,84,62,25,110,509,790,2022-05-12 19:25:07.174953
33541,153,1592,97,355,982,3179,2022-05-12 19:25:09.377585
33543,16,341,13,70,153,593,2022-05-12 19:25:12.312776
33544,15,456,16,72,216,775,2022-05-12 19:25:13.733559
33549,11,265,11,45,122,454,2022-05-12 19:25:21.810574
33550,13,230,15,65,142,465,2022-05-12 19:25:23.3376
33551,14,194,21,54,142,425,2022-05-12 19:25:24.580284
33552,13,238,16,47,139,453,2022-05-12 19:25:25.95512
33558,1426,44685,474,378,11736,58699,2022-05-12 19:25:29.782443
33564,306,3052,107,181,4030,7676,2022-05-12 19:25:35.473368
33566,482,9920,163,192,4286,15043,2022-05-12 19:25:35.912904
33569,1906,33303,859,1096,11049,48213,2022-05-12 19:25:38.636795
33571,14,123,3,58,74,272,2022-05-12 19:25:41.673447
33572,616,1717,305,941,4590,8169,2022-05-12 19:25:43.727104
33578,28,325,15,39,228,635,2022-05-12 19:25:44.47551
33581,3162,115537,1099,629,35432,155859,2022-05-12 19:25:49.010514
33583,19,51,6,42,140,258,2022-05-12 19:25:50.843605
33589,5663,26351,2266,3373,38368,76021,2022-05-12 19:25:51.161269
33600,13,49,1,54,79,196,2022-05-12 19:25:54.432511
33604,23,39,6,56,117,241,2022-05-12 19:25:59.250516
33605,6339,35657,2567,5920,29897,80380,2022-05-12 19:25:59.442831
33606,349,16147,207,166,3341,20210,2022-05-12 19:25:59.687594
33618,81,714,40,85,882,1802,2022-05-12 19:26:01.989045
33630,45,125,20,65,398,653,2022-05-12 19:26:03.486212
33654,8729,93605,3151,5659,34532,145676,2022-05-12 19:26:03.835575
33659,41,454,33,43,578,1149,2022-05-12 19:26:06.378265
33663,29,199,4,27,157,416,2022-05-12 19:26:08.976733
33669,31,691,19,77,269,1087,2022-05-12 19:26:13.603612
33671,20,60,7,43,89,219,2022-05-12 19:26:16.799324
33672,79,3139,81,114,764,4177,2022-05-12 19:26:19.229571
33674,18722,550921,5865,5591,183071,764170,2022-05-12 19:26:19.5815
33681,263,3583,156,133,3353,7488,2022-05-12 19:26:23.362413
33686,94,2119,69,94,1269,3645,2022-05-12 19:26:26.958999
33687,118,2217,74,106,1326,3841,2022-05-12 19:26:30.814525
33691,8,90,4,44,63,209,2022-05-12 19:26:37.746281
33692,15,594,4,37,118,768,2022-05-12 19:26:39.249491
33693,13,614,3,33,80,743,2022-05-12 19:26:40.648884
33694,13,405,2,32,95,547,2022-05-12 19:26:42.051503
33698,16,259,2,23,86,386,2022-05-12 19:26:48.952839
33703,22,68,4,50,139,283,2022-05-12 19:26:52.024909
33704,58,178,32,90,445,803,2022-05-12 19:26:54.222371
33705,16,174,20,66,170,446,2022-05-12 19:26:55.425039
33708,37,549,22,77,301,986,2022-05-12 19:26:58.035926
33710,10,287,5,33,64,399,2022-05-12 19:26:59.947018
33713,196,4141,84,69,1869,6359,2022-05-12 19:27:05.101219
33718,33,470,4,42,284,833,2022-05-12 19:27:08.046375
33720,188,2942,119,143,2559,5951,2022-05-12 19:27:10.35779
33724,220,1225,120,123,2549,4237,2022-05-12 19:27:12.931553
33726,3625,14113,1616,2824,15385,37563,2022-05-12 19:27:15.528551
33728,839,10349,360,440,10063,22051,2022-05-12 19:27:19.679101
33729,467,7352,212,254,6897,15182,2022-05-12 19:27:22.804666
33730,406,6734,187,233,6447,14007,2022-05-12 19:27:26.218372
33733,2635,21396,988,1693,7614,34326,2022-05-12 19:27:27.659398
33734,29,1066,12,49,266,1422,2022-05-12 19:27:30.875441
33737,1136,1570,288,1277,7516,11787,2022-05-12 19:27:34.845516
33739,22,131,7,55,133,348,2022-05-12 19:27:37.059012
33740,294,5022,115,128,3705,9264,2022-05-12 19:27:39.563091
33741,133,2572,68,65,2786,5624,2022-05-12 19:27:41.922544
33743,16804,163430,7043,21235,59724,268236,2022-05-12 19:27:42.181497
33746,803,7524,359,791,4779,14256,2022-05-12 19:27:42.598796
33753,12,101,6,51,89,259,2022-05-12 19:27:44.708132
33756,78,73,25,50,673,899,2022-05-12 19:27:47.425984
33757,85,87,18,76,352,618,2022-05-12 19:27:48.768903
33758,501,1972,131,241,1597,4442,2022-05-12 19:27:50.864293
33759,41,180,10,70,157,458,2022-05-12 19:27:52.404367
33760,84,168,25,56,438,771,2022-05-12 19:27:54.407723
33761,71,261,33,70,668,1103,2022-05-12 19:27:56.574637
33762,58,102,20,54,388,622,2022-05-12 19:27:57.921661
33763,37,76,10,54,175,352,2022-05-12 19:27:58.944216
33771,5184,25773,2743,10383,18619,62702,2022-05-12 19:28:04.535715
33772,14,57,5,42,66,184,2022-05-12 19:28:06.032661
33773,14,47,2,36,59,158,2022-05-12 19:28:07.131516
33775,1857,8000,764,2905,7047,20573,2022-05-12 19:28:09.941664
33776,121,435,73,93,1167,1889,2022-05-12 19:28:11.53164
33779,39,265,18,67,322,711,2022-05-12 19:28:14.331545
33783,889,41747,353,502,13018,56509,2022-05-12 19:28:18.257237
33788,1243,6142,681,1533,5837,15436,2022-05-12 19:28:22.745588
33791,10,478,4,40,68,600,2022-05-12 19:28:25.739753
33792,10,59,7,53,75,204,2022-05-12 19:28:26.860405
33795,559,8016,289,446,2737,12047,2022-05-12 19:28:29.45359
33803,492,2547,274,923,1712,5948,2022-05-12 19:28:39.258884
33806,130,631,83,72,945,1861,2022-05-12 19:28:41.462459
33808,145,877,81,139,2309,3551,2022-05-12 19:28:41.639215
33814,971,11499,404,2673,3593,19140,2022-05-12 19:28:48.715185
33818,293,10190,157,132,4320,15092,2022-05-12 19:28:52.087495
33820,121,3630,79,258,2683,6771,2022-05-12 19:28:54.401009
33822,7,21,2,44,39,113,2022-05-12 19:28:56.760818
33823,9,44,2,51,64,170,2022-05-12 19:28:57.977412
33824,7,23,2,45,47,124,2022-05-12 19:28:59.009285
33826,8,22,4,46,42,122,2022-05-12 19:29:00.082505
33827,7,34,2,42,37,122,2022-05-12 19:29:01.041623
33828,26,175,15,42,224,482,2022-05-12 19:29:02.584165
33831,6,32,4,45,68,155,2022-05-12 19:29:03.616551
33836,17400,91202,6971,19087,75482,210142,2022-05-12 19:29:08.848929
33839,563,4233,198,376,12686,18056,2022-05-12 19:29:11.893502
33840,1269,6014,796,2578,7950,18607,2022-05-12 19:29:15.007455
33843,12,89,0,33,55,189,2022-05-12 19:29:17.774123
33846,46,350,43,108,532,1079,2022-05-12 19:29:24.05032
33849,10,65,3,39,50,167,2022-05-12 19:29:25.1753
33850,3178,12460,1181,3539,15475,35833,2022-05-12 19:29:27.866066
33855,78,571,52,85,1168,1954,2022-05-12 19:29:34.79937
33856,11,42,4,37,68,162,2022-05-12 19:29:35.063055
33857,15,39,5,44,70,173,2022-05-12 19:29:36.106444
33858,12,115,1,25,51,204,2022-05-12 19:29:37.227346
33859,20,1672,7,39,180,1918,2022-05-12 19:29:39.477345
33860,10,132,1,28,54,225,2022-05-12 19:29:40.807766
33861,9,115,1,34,56,215,2022-05-12 19:29:42.030244
33864,9,94,3,37,56,199,2022-05-12 19:29:44.852295
33866,7,248,4,23,49,331,2022-05-12 19:29:46.17438
33867,30,88,7,51,107,283,2022-05-12 19:29:47.344177
33871,24,395,5,50,118,592,2022-05-12 19:29:49.315394
33872,15,224,3,28,90,360,2022-05-12 19:29:50.580388
33874,20,253,17,50,243,583,2022-05-12 19:29:51.899834
33875,16,181,14,48,208,467,2022-05-12 19:29:53.496218
33876,15,202,11,46,201,475,2022-05-12 19:29:54.577606
33877,16,216,14,48,232,526,2022-05-12 19:29:55.852204
33878,15,186,13,48,205,467,2022-05-12 19:29:56.771274
33879,17,181,13,49,209,469,2022-05-12 19:29:57.870862
33880,16,195,13,50,208,482,2022-05-12 19:29:59.049008
33882,17,186,11,48,262,524,2022-05-12 19:30:00.534477
33883,284,754,71,107,1501,2717,2022-05-12 19:30:03.027085
33885,4,322,5,18,61,410,2022-05-12 19:30:04.967514
33887,13,150,1,18,40,222,2022-05-12 19:30:06.483579
33889,5336,14351,2017,7649,21638,50991,2022-05-12 19:30:10.973173
33894,10,26,1,35,40,112,2022-05-12 19:30:12.071832
33895,6,22,4,31,43,106,2022-05-12 19:30:13.104458
33896,8,16,3,39,47,113,2022-05-12 19:30:14.110493
33899,4941,23166,2254,2623,23064,56048,2022-05-12 19:30:17.782819
33902,330,8763,155,196,4108,13552,2022-05-12 19:30:20.764757
33903,78,907,42,113,1004,2144,2022-05-12 19:30:22.802724
33904,329,38,160,129,445,1101,2022-05-12 19:30:23.235411
33905,43,2021,18,36,312,2430,2022-05-12 19:30:25.530936
33906,11,189,1,23,46,270,2022-05-12 19:30:26.614595
33907,11,267,3,21,41,343,2022-05-12 19:30:27.858782
33908,7,220,4,20,53,304,2022-05-12 19:30:29.26242
33909,11,490,6,18,95,620,2022-05-12 19:30:30.549699
33910,10,480,4,18,115,627,2022-05-12 19:30:31.686379
33911,30,865,21,69,380,1365,2022-05-12 19:30:34.101322
33912,22,668,25,70,346,1131,2022-05-12 19:30:36.018717
33914,46,321,10,43,128,548,2022-05-12 19:30:39.200514
33916,11,57,0,44,61,173,2022-05-12 19:30:40.751664
33922,71,0,27,75,123,296,2022-05-12 19:30:40.93418
33925,104,204,34,76,380,798,2022-05-12 19:30:42.86151
33926,24944,201312,8479,11405,85154,331294,2022-05-12 19:30:43.278159
33927,9,129,2,38,56,234,2022-05-12 19:30:44.458023
33929,2936,122580,1029,638,31694,158877,2022-05-12 19:30:44.705189
33934,219,7664,88,70,3406,11447,2022-05-12 19:30:48.70252
33936,25,241,2,32,84,384,2022-05-12 19:30:50.443526
33937,18,340,6,27,124,515,2022-05-12 19:30:52.538867
33938,8,103,0,17,30,158,2022-05-12 19:30:53.66479
33941,17,265,3,29,86,400,2022-05-12 19:30:58.063669
33945,14,102,3,41,71,231,2022-05-12 19:30:59.394787
33946,35,40,14,119,148,356,2022-05-12 19:31:00.642698
33947,188,3872,124,254,2553,6991,2022-05-12 19:31:00.971377
33948,7989,35843,4045,7208,41834,96919,2022-05-12 19:31:04.02468
33949,539,18998,224,137,7573,27471,2022-05-12 19:31:07.822866
33950,1148,26210,355,524,8843,37080,2022-05-12 19:31:08.238553
33957,32,407,23,66,258,786,2022-05-12 19:31:09.897344
33964,456,23833,236,328,5236,30089,2022-05-12 19:31:14.355866
33970,2338,22909,649,298,13514,39708,2022-05-12 19:31:18.191547
33972,294,408,50,62,1752,2566,2022-05-12 19:31:21.568169
33975,104,1063,58,384,620,2229,2022-05-12 19:31:23.414981
33978,13,144,11,68,109,345,2022-05-12 19:31:23.84156
33980,22,46,5,53,156,282,2022-05-12 19:31:25.26186
33982,13,54,2,31,89,189,2022-05-12 19:31:26.314353
33983,3110,15209,1796,3064,14331,37510,2022-05-12 19:31:29.032789
33985,8489,45652,3858,15480,25113,98592,2022-05-12 19:31:29.37636
33988,19767,251220,7951,9466,89615,378019,2022-05-12 19:31:31.23442
33994,617,5858,330,248,10229,17282,2022-05-12 19:31:32.203921
33997,134,1971,80,118,1739,4042,2022-05-12 19:31:32.543788
33999,12,61,5,45,131,254,2022-05-12 19:31:35.111258
34003,87,1118,32,33,661,1931,2022-05-12 19:31:42.287853
34005,21,105,10,56,98,290,2022-05-12 19:31:43.421491
34008,252,2581,140,182,4733,7888,2022-05-12 19:31:46.434426
34009,3328,31463,1559,4427,16531,57308,2022-05-12 19:31:49.840416
34013,284,1835,149,368,2199,4835,2022-05-12 19:31:56.066485
34014,14,96,5,41,114,270,2022-05-12 19:31:57.202724
34016,244,2271,172,250,4356,7293,2022-05-12 19:32:00.276527
34021,1315,17273,345,211,14726,33870,2022-05-12 19:32:01.403585
34028,1015,4319,581,2684,4708,13307,2022-05-12 19:32:05.226742
34032,126,1306,60,113,2479,4084,2022-05-12 19:32:06.37973
34034,15071,42938,9479,13669,11717,92874,2022-05-12 19:32:06.784377
34036,1102,18981,401,491,5736,26711,2022-05-12 19:32:06.951384
34050,48,618,14,51,424,1155,2022-05-12 19:32:09.781387
34051,10584,65413,5909,15332,37441,134679,2022-05-12 19:32:13.001396
34052,268,854,155,690,605,2572,2022-05-12 19:32:15.833528
34100,2254,49839,887,535,29523,83038,2022-05-12 19:32:41.411489
34055,6852,105458,2162,6131,32598,153201,2022-05-12 19:32:16.017759
34060,74,1291,30,77,446,1918,2022-05-12 19:32:18.12145
34076,3435,29311,1654,1035,23077,58512,2022-05-12 19:32:22.035771
34077,819,5051,280,549,2427,9126,2022-05-12 19:32:24.918554
34085,74,4707,51,80,912,5824,2022-05-12 19:32:32.177716
34086,9729,94270,4609,4750,34623,147981,2022-05-12 19:32:35.02844
34092,43,0,10,58,83,194,2022-05-12 19:32:40.577741
34096,13863,152749,4247,2882,92538,266279,2022-05-12 19:32:41.003498
34102,13388,38414,8765,16916,57100,134583,2022-05-12 19:32:44.479462
34103,2738,132150,1139,768,26067,162862,2022-05-12 19:32:44.792321
34104,15972,147822,5114,12878,41191,222977,2022-05-12 19:32:45.425738
34106,1684,9231,896,780,8564,21155,2022-05-12 19:32:49.232725
34113,12,35,3,41,59,150,2022-05-12 19:32:51.699555
34114,10,30,1,25,43,109,2022-05-12 19:32:52.952579
34115,6,137,2,25,43,213,2022-05-12 19:32:55.659449
34116,10,107,0,24,35,176,2022-05-12 19:32:57.484956
34117,14,396,3,30,91,534,2022-05-12 19:33:00.378151
34118,10,292,1,26,69,398,2022-05-12 19:33:01.472834
34119,6,83,2,27,34,152,2022-05-12 19:33:02.697277
34122,8,167,2,17,48,242,2022-05-12 19:33:06.64438
34124,9,111,1,31,67,219,2022-05-12 19:33:08.347238
34126,5740,63477,2872,3864,29010,104963,2022-05-12 19:33:14.533903
34134,66008,1043052,17300,25657,251915,1403932,2022-05-12 19:33:16.718963
34136,2469,60409,1307,764,53712,118661,2022-05-12 19:33:16.898039
34140,55,269,13,64,430,831,2022-05-12 19:33:22.520398
34152,1669,69218,675,359,19571,91492,2022-05-12 19:33:29.73624
34156,34,122,8,107,234,505,2022-05-12 19:33:33.16923
34161,1905,37253,770,993,30706,71627,2022-05-12 19:33:36.201222
34163,18,44,9,38,66,175,2022-05-12 19:33:38.143402
34167,301,1961,108,90,4327,6787,2022-05-12 19:33:47.334441
34176,16491,144454,6494,11531,57589,236559,2022-05-12 19:33:50.485509
34177,4635,25567,1880,3983,21959,58024,2022-05-12 19:33:53.566842
34178,466,4194,195,215,1556,6626,2022-05-12 19:33:55.923246
34179,50,317,10,35,347,759,2022-05-12 19:33:57.730231
34183,9,31,2,45,39,126,2022-05-12 19:33:59.394585
34186,7,16,3,35,55,116,2022-05-12 19:34:03.366933
34187,8,24,1,39,42,114,2022-05-12 19:34:04.464417
34189,6,24,4,35,41,110,2022-05-12 19:34:06.107844
34190,8,82,9,70,66,235,2022-05-12 19:34:06.526799
34193,7,17,3,40,41,108,2022-05-12 19:34:08.760585
34194,9,62,6,55,89,221,2022-05-12 19:34:09.834803
34198,24,172,23,65,242,526,2022-05-12 19:34:10.969409
34204,910,10377,590,280,6819,18976,2022-05-12 19:34:13.90973
34207,22,39,8,71,83,223,2022-05-12 19:34:15.553745
34208,358,2414,126,170,4212,7280,2022-05-12 19:34:17.581528
34209,3287,22167,1226,2779,15916,45375,2022-05-12 19:34:17.762342
34213,9407,61913,2748,3589,49645,127302,2022-05-12 19:34:20.415324
34223,170,835,103,1006,1081,3195,2022-05-12 19:34:25.322175
34224,4,73,3,34,44,158,2022-05-12 19:34:27.144984
34225,9,25,2,47,45,128,2022-05-12 19:34:29.128593
34226,6,26,4,29,39,104,2022-05-12 19:34:30.342452
34234,25,38,3,93,78,237,2022-05-12 19:34:32.841147
34235,25,41,7,98,100,271,2022-05-12 19:34:34.682389
34236,30,107,13,70,246,466,2022-05-12 19:34:36.127859
34237,43,0,9,46,82,180,2022-05-12 19:34:37.541262
34238,102,6090,54,102,1809,8157,2022-05-12 19:34:38.589511
34239,98,763,41,117,1249,2268,2022-05-12 19:34:40.823133
34240,4215,270146,642,522,30218,305743,2022-05-12 19:34:44.019998
34243,63,692,38,49,559,1401,2022-05-12 19:34:46.549153
34244,53,1642,43,88,656,2482,2022-05-12 19:34:47.43299
34248,11,34,4,33,68,150,2022-05-12 19:34:48.693596
34252,82,1934,23,62,676,2777,2022-05-12 19:34:51.834458
34257,1041,7105,460,748,7763,17117,2022-05-12 19:34:54.893416
34259,11,41,4,38,74,168,2022-05-12 19:34:56.410494
34261,32,110,20,41,346,549,2022-05-12 19:34:57.826012
34262,9010,73029,4013,7287,33578,126917,2022-05-12 19:35:00.791478
34264,10,0,7,9,376,402,2022-05-12 19:35:02.145044
34279,29831,133854,11360,22149,71892,269086,2022-05-12 19:35:06.46998
34280,31348,403423,12422,25630,103960,576783,2022-05-12 19:35:06.66199
34284,2118,18235,959,991,17564,39867,2022-05-12 19:35:15.933447
34286,10,130,1,31,82,254,2022-05-12 19:35:17.52162
34290,1438,3728,786,736,3633,10321,2022-05-12 19:35:21.143442
34292,74,215,37,136,430,892,2022-05-12 19:35:23.744232
34295,576,5413,253,557,2653,9452,2022-05-12 19:35:26.674521
34299,778,41694,347,287,9909,53015,2022-05-12 19:35:29.47603
34300,6177,70588,1538,2700,28891,109894,2022-05-12 19:35:29.914508
34304,69,699,28,80,731,1607,2022-05-12 19:35:32.519531
34309,45,102,13,107,377,644,2022-05-12 19:35:36.091136
34310,22,133,14,73,199,441,2022-05-12 19:35:37.832786
34315,12,58,10,60,104,244,2022-05-12 19:35:40.723763
34318,162,3074,97,100,2032,5465,2022-05-12 19:35:43.771629
34321,4057,142579,1203,932,35840,184611,2022-05-12 19:35:46.796929
34324,71,1550,28,49,475,2173,2022-05-12 19:35:52.193384
34325,173,8059,157,148,1595,10132,2022-05-12 19:35:54.958154
34328,21,121,5,29,95,271,2022-05-12 19:35:56.197458
34336,17,109,12,51,147,336,2022-05-12 19:35:57.96024
34340,7,71,3,33,43,157,2022-05-12 19:36:05.137039
34342,7,17,4,30,43,101,2022-05-12 19:36:06.26311
34346,25,260,16,48,438,787,2022-05-12 19:36:07.455645
34348,0,0,0,0,1875,1875,2022-05-12 19:36:10.184541
34353,15,84,9,63,88,259,2022-05-12 19:36:17.663673
34354,14,124,8,49,86,281,2022-05-12 19:36:18.843252
34355,7,54,9,52,57,179,2022-05-12 19:36:20.244367
34356,7,58,8,53,57,183,2022-05-12 19:36:21.3191
34358,14,92,4,55,115,280,2022-05-12 19:36:23.253713
34367,65,731,36,77,565,1474,2022-05-12 19:36:28.284052
34368,3480,17014,1908,7063,14768,44233,2022-05-12 19:36:30.929279
34369,16,68,8,67,84,243,2022-05-12 19:36:32.658919
34371,14,95,5,54,90,258,2022-05-12 19:36:34.79393
34372,8,91,6,36,66,207,2022-05-12 19:36:36.088358
34373,18,94,8,53,95,268,2022-05-12 19:36:37.122419
34375,470,6647,226,190,5632,13165,2022-05-12 19:36:40.752294
34376,444,6573,218,204,5846,13285,2022-05-12 19:36:41.174428
34382,32722,272584,13365,37895,95449,452015,2022-05-12 19:36:41.595021
34383,8548,74787,3244,13768,42187,142534,2022-05-12 19:36:41.834936
34406,11,237,3,32,82,365,2022-05-12 19:36:46.144736
34409,24,313,8,49,170,564,2022-05-12 19:36:47.688481
34410,53,193,34,110,445,835,2022-05-12 19:36:49.341378
34411,945,4388,352,1693,4373,11751,2022-05-12 19:36:52.927728
34414,6481,80287,3283,2991,23710,116752,2022-05-12 19:37:00.157076
34416,13,84,8,53,125,283,2022-05-12 19:37:02.057381
34417,4,78,0,13,46,141,2022-05-12 19:37:03.102395
34418,6,217,2,14,39,278,2022-05-12 19:37:04.489899
34420,3825,15336,1342,1852,10620,32975,2022-05-12 19:37:07.2233
34422,10,232,3,18,55,318,2022-05-12 19:37:08.563448
34423,9,144,0,20,52,225,2022-05-12 19:37:10.896689
34426,7,90,3,26,37,163,2022-05-12 19:37:14.427497
34427,2855,11541,1325,4092,11253,31066,2022-05-12 19:37:17.169761
34430,466,20590,206,221,5026,26509,2022-05-12 19:37:20.198654
34432,7,292,4,23,35,361,2022-05-12 19:37:21.824267
34436,11,155,7,55,107,335,2022-05-12 19:37:22.984807
34437,4742,150153,1669,1111,117708,275383,2022-05-12 19:37:23.386747
34438,2294,49325,969,729,34004,87321,2022-05-12 19:37:23.838283
34439,1310,34735,726,531,27185,64487,2022-05-12 19:37:28.016375
34443,27751,204286,11326,15869,52398,311630,2022-05-12 19:37:28.768307
34445,1447,17988,614,467,16475,36991,2022-05-12 19:37:32.554871
34447,1767,19901,764,480,9259,32171,2022-05-12 19:37:35.393435
35105,9,25,3,35,59,131,2022-05-12 19:48:12.033011
34449,1700,5650,1084,8090,11922,28446,2022-05-12 19:37:35.815169
34450,75,650,55,95,977,1852,2022-05-12 19:37:38.149571
34451,26016,223249,12046,8970,108363,378644,2022-05-12 19:37:38.329387
34453,421,4272,103,190,3409,8395,2022-05-12 19:37:44.40943
34454,1389,0,351,458,4730,6928,2022-05-12 19:37:44.584521
34455,601,1547,185,212,5026,7571,2022-05-12 19:37:48.244423
34456,43,69,10,127,283,532,2022-05-12 19:37:50.256385
34458,11,66,1,37,57,172,2022-05-12 19:37:51.374548
34464,45,436,9,36,291,817,2022-05-12 19:37:52.71094
34465,3755,35013,1872,735,22960,64335,2022-05-12 19:37:53.136545
34471,46,800,33,69,807,1755,2022-05-12 19:37:58.533934
34472,17,171,4,35,65,292,2022-05-12 19:38:02.027512
34474,1256,4684,597,1577,8191,16305,2022-05-12 19:38:04.720768
34475,130,1074,60,95,1254,2613,2022-05-12 19:38:08.574555
34476,36,89,8,38,202,373,2022-05-12 19:38:10.308207
34480,4485,110862,1548,778,29463,147136,2022-05-12 19:38:11.181528
34481,1016,27841,335,223,8288,37703,2022-05-12 19:38:14.577428
34486,162,0,47,60,464,733,2022-05-12 19:38:16.197838
34489,70,815,37,84,841,1847,2022-05-12 19:38:18.475154
34490,19,63,6,61,123,272,2022-05-12 19:38:19.969414
34494,14391,43343,9854,13952,54904,136444,2022-05-12 19:38:22.677101
34497,24861,312682,5750,20332,59585,423210,2022-05-12 19:38:22.840161
34498,4904,114383,1539,1379,62821,185026,2022-05-12 19:38:23.263773
34501,4313,44929,1536,3361,18677,72816,2022-05-12 19:38:25.857608
34503,90,703,30,123,390,1336,2022-05-12 19:38:32.296098
34504,1727,29343,714,323,20333,52440,2022-05-12 19:38:32.731761
34510,23,284,7,67,149,530,2022-05-12 19:38:34.270857
34513,560,8406,212,214,12328,21720,2022-05-12 19:38:37.344132
34514,1345,42050,803,573,5144,49915,2022-05-12 19:38:37.685952
34525,6178,41643,3061,9713,23127,83722,2022-05-12 19:38:42.483064
34527,20,82,12,56,192,362,2022-05-12 19:38:44.216269
34528,7,77,2,34,76,196,2022-05-12 19:38:46.831267
34532,268,2556,196,168,6545,9733,2022-05-12 19:38:50.323902
34534,1170,25950,513,246,11789,39668,2022-05-12 19:38:53.646163
34537,3202,50536,1110,572,48861,104281,2022-05-12 19:38:57.087917
34539,902,4926,465,1363,5013,12669,2022-05-12 19:39:00.223564
34540,400,42079,237,217,5654,48587,2022-05-12 19:39:03.44062
34541,1369,59905,603,370,22892,85139,2022-05-12 19:39:06.367516
34542,32452,325435,13454,18725,164038,554104,2022-05-12 19:39:06.5564
34544,2742,68904,927,426,34401,107400,2022-05-12 19:39:07.31189
34547,7005,22146,3705,7330,28294,68480,2022-05-12 19:39:11.548077
34548,74,539,70,78,1746,2507,2022-05-12 19:39:14.971289
34550,1454,6652,951,3963,4339,17359,2022-05-12 19:39:18.637025
34552,287,2429,174,220,1668,4778,2022-05-12 19:39:22.076451
34561,46016,187166,25695,32980,140982,432839,2022-05-12 19:39:25.420202
34565,5813,23394,2591,8053,24656,64507,2022-05-12 19:39:29.172908
35147,5,29,1,46,43,124,2022-05-12 19:49:01.393567
34566,395179,16,98950,165038,85554,744737,2022-05-12 19:39:29.343733
34572,474366,388914,117618,118047,232674,1331619,2022-05-12 19:39:29.892013
34577,61715,806043,12005,16128,90074,985965,2022-05-12 19:39:30.049982
34591,9079,77695,3036,1843,71825,163478,2022-05-12 19:39:30.840452
34618,33246,399405,16615,20525,118174,587965,2022-05-12 19:39:36.456411
34620,15653,46374,6004,13845,51201,133077,2022-05-12 19:39:36.904983
34622,43,363,14,37,428,885,2022-05-12 19:39:40.567125
34623,112,1507,68,75,1363,3125,2022-05-12 19:39:43.114298
34625,28,308,14,46,146,542,2022-05-12 19:39:46.212689
34626,4134,270382,1092,512,39708,315828,2022-05-12 19:39:46.383249
34628,9,137,4,38,70,258,2022-05-12 19:39:48.64147
34630,19,82,5,46,76,228,2022-05-12 19:39:50.838829
34631,14,224,9,54,125,426,2022-05-12 19:39:51.105769
34633,13,321,2,23,73,432,2022-05-12 19:39:54.141494
34636,24115,151022,12067,13069,87501,287774,2022-05-12 19:39:56.008689
34643,10,55,5,51,56,177,2022-05-12 19:39:59.389738
34644,313,4796,141,129,4155,9534,2022-05-12 19:40:03.177128
34649,294,1084,115,123,4936,6552,2022-05-12 19:40:07.333685
34651,15,127,2,35,65,244,2022-05-12 19:40:08.563717
34655,13,743,5,23,95,879,2022-05-12 19:40:12.443451
34656,12,412,4,30,76,534,2022-05-12 19:40:13.921425
34657,10,205,3,15,78,311,2022-05-12 19:40:15.724262
34658,1977,48449,683,660,22707,74476,2022-05-12 19:40:16.137741
34662,38052,254904,16923,24086,90903,424868,2022-05-12 19:40:21.929446
34664,13,57,5,56,59,190,2022-05-12 19:40:23.896304
34665,13,59,3,52,44,171,2022-05-12 19:40:25.16754
34666,10,52,5,49,51,167,2022-05-12 19:40:26.33318
34670,626,1868,251,362,3477,6584,2022-05-12 19:40:32.166041
34673,8,31,3,25,58,125,2022-05-12 19:40:33.484441
34674,21,51,14,29,301,416,2022-05-12 19:40:34.938516
34675,2153,3948,869,1213,8116,16299,2022-05-12 19:40:37.849553
34676,9,97,7,62,43,218,2022-05-12 19:40:40.424298
34677,8,96,4,62,42,212,2022-05-12 19:40:41.556424
34678,46,1080,19,53,576,1774,2022-05-12 19:40:43.647412
34683,0,0,0,0,4977,4977,2022-05-12 19:40:46.069182
34688,14,64,3,23,107,211,2022-05-12 19:40:48.202845
34689,14,69,2,28,79,192,2022-05-12 19:40:49.270462
34691,10,96,1,19,60,186,2022-05-12 19:40:51.747469
34692,9,63,2,30,74,178,2022-05-12 19:40:52.836537
34695,12,69,2,32,69,184,2022-05-12 19:40:56.406996
34696,6,74,2,38,65,185,2022-05-12 19:40:57.521458
34697,13,58,1,29,61,162,2022-05-12 19:40:58.694534
34698,11,51,5,29,59,155,2022-05-12 19:41:00.309745
34699,12,129,0,19,83,243,2022-05-12 19:41:02.242665
34700,8,76,1,36,57,178,2022-05-12 19:41:03.41788
34701,10,42,3,48,61,164,2022-05-12 19:41:04.55265
34706,8,27,3,40,53,131,2022-05-12 19:41:07.952046
34708,10,106,2,33,47,198,2022-05-12 19:41:09.576656
34710,26,560,24,59,272,941,2022-05-12 19:41:11.742221
34711,7,59,2,39,43,150,2022-05-12 19:41:13.538363
34712,14091,112274,7178,10417,60683,204643,2022-05-12 19:41:17.816639
34716,14,330,6,30,78,458,2022-05-12 19:41:19.670428
34717,7,50,1,33,37,128,2022-05-12 19:41:21.220409
34718,9,32,3,39,45,128,2022-05-12 19:41:22.825813
34720,12,380,3,26,54,475,2022-05-12 19:41:25.658444
34722,10,99,5,22,39,175,2022-05-12 19:41:28.732448
34724,46,81,30,45,349,551,2022-05-12 19:41:31.354966
34725,229,384,105,204,2928,3850,2022-05-12 19:41:33.307803
34726,28,34,4,49,70,185,2022-05-12 19:41:34.377278
34733,396,12323,178,165,5140,18202,2022-05-12 19:41:34.631301
34738,151,1735,55,204,663,2808,2022-05-12 19:41:37.285803
34741,92,168,49,177,465,951,2022-05-12 19:41:39.280567
34742,886,15398,463,545,5621,22913,2022-05-12 19:41:42.439628
34743,10,96,3,35,57,201,2022-05-12 19:41:44.568329
34744,14,37,6,35,87,179,2022-05-12 19:41:46.22708
34745,3225,9529,2236,2281,13252,30523,2022-05-12 19:41:46.649684
34751,702,9671,311,278,8200,19162,2022-05-12 19:41:49.378186
34754,254,341,218,223,1306,2342,2022-05-12 19:41:57.045825
34755,8,80,10,49,96,243,2022-05-12 19:41:58.915837
34756,10,52,10,57,100,229,2022-05-12 19:42:00.503187
34757,33,219,10,27,326,615,2022-05-12 19:42:02.712276
34762,33,197,25,70,432,757,2022-05-12 19:42:04.4031
34763,35,151,19,60,321,586,2022-05-12 19:42:06.16568
34764,41,158,21,70,394,684,2022-05-12 19:42:07.401702
34765,40,221,24,65,482,832,2022-05-12 19:42:08.838377
34771,606,1640,328,1538,5054,9166,2022-05-12 19:42:13.945727
34776,313,3054,155,133,3933,7588,2022-05-12 19:42:16.349914
34777,676,36295,402,240,9842,47455,2022-05-12 19:42:17.958407
34779,6,39,5,18,962,1030,2022-05-12 19:42:20.186547
34782,44,146,16,70,345,621,2022-05-12 19:42:21.789505
34784,371,8263,219,175,5378,14406,2022-05-12 19:42:24.515865
34787,577,1807,258,433,2560,5635,2022-05-12 19:42:27.515234
34790,16,63,3,39,66,187,2022-05-12 19:42:28.699237
34792,1301,20256,530,248,22846,45181,2022-05-12 19:42:31.61705
34798,33901,205004,15168,10151,147888,412112,2022-05-12 19:42:33.851819
34799,412,697,180,574,1173,3036,2022-05-12 19:42:37.753848
34800,945,4481,529,1622,5627,13204,2022-05-12 19:42:38.09171
34802,81,1956,19,41,722,2819,2022-05-12 19:42:41.715394
34812,443,4435,225,134,3375,8612,2022-05-12 19:42:41.874421
34813,21,145,15,41,165,387,2022-05-12 19:42:46.491518
34815,6,82,2,47,86,223,2022-05-12 19:42:47.734419
34817,19,190,3,57,133,402,2022-05-12 19:42:49.371551
34818,479,1789,240,227,2032,4767,2022-05-12 19:42:51.656337
34820,239,4090,101,112,2807,7349,2022-05-12 19:42:52.66938
34823,3322,18712,1199,6558,10781,40572,2022-05-12 19:43:00.450353
34825,13027,88220,6005,10466,49811,167529,2022-05-12 19:43:00.890782
34826,18,106,8,44,163,339,2022-05-12 19:43:02.67152
34830,577,4149,306,281,12332,17645,2022-05-12 19:43:06.652288
34834,1944,10413,914,2279,11004,26554,2022-05-12 19:43:13.383242
34835,58,933,28,93,536,1648,2022-05-12 19:43:15.897598
34836,299,2048,106,300,865,3618,2022-05-12 19:43:18.583808
34839,5765,20624,2780,4921,18426,52516,2022-05-12 19:43:21.744067
34841,18,56,7,59,128,268,2022-05-12 19:43:24.638844
34843,20,93,10,54,110,287,2022-05-12 19:43:26.215575
34844,20,158,13,61,215,467,2022-05-12 19:43:27.425365
34845,59,1,31,61,136,288,2022-05-12 19:43:27.589414
34847,51,1,27,61,137,277,2022-05-12 19:43:27.836872
34849,13,333,6,25,224,601,2022-05-12 19:43:29.281464
34850,8,26,4,37,118,193,2022-05-12 19:43:30.818111
34852,36,139,14,69,232,490,2022-05-12 19:43:33.267031
34855,1587,51080,768,342,10884,64661,2022-05-12 19:43:37.389679
34857,5,194,1,18,33,251,2022-05-12 19:43:40.928233
34858,13,150,1,14,37,215,2022-05-12 19:43:42.287177
34859,8,132,2,11,32,185,2022-05-12 19:43:43.637522
34860,7,175,2,12,58,254,2022-05-12 19:43:44.855386
34861,9,107,4,16,42,178,2022-05-12 19:43:45.929732
34862,37,334,18,44,393,826,2022-05-12 19:43:47.437984
34863,1663,9938,750,884,13126,26361,2022-05-12 19:43:50.40509
34864,33,396,24,55,344,852,2022-05-12 19:43:52.110515
34870,236,7775,104,117,2437,10669,2022-05-12 19:43:58.534786
34871,12,74,8,49,123,266,2022-05-12 19:44:00.384703
34872,13,132,4,61,94,304,2022-05-12 19:44:02.177688
34878,18,253,14,38,256,579,2022-05-12 19:44:04.479112
34887,9,322,2,42,99,474,2022-05-12 19:44:14.867278
34888,121,873,53,378,378,1803,2022-05-12 19:44:16.703023
34892,18,106,9,35,130,298,2022-05-12 19:44:22.816428
34893,121,1052,72,83,1715,3043,2022-05-12 19:44:24.852307
34901,848,9299,341,598,2282,13368,2022-05-12 19:44:26.459404
34902,34245,433482,12964,13726,140345,634762,2022-05-12 19:44:27.014271
34904,601,25649,261,440,4758,31709,2022-05-12 19:44:33.8045
34905,142,259,52,227,893,1573,2022-05-12 19:44:35.307058
34907,16,451,3,27,125,622,2022-05-12 19:44:37.809353
34908,5,271,5,23,63,367,2022-05-12 19:44:39.881338
34911,17,85,8,53,62,225,2022-05-12 19:44:42.854522
35161,6,23,3,35,34,101,2022-05-12 19:49:17.402233
34914,13595,152233,6589,5193,57471,235081,2022-05-12 19:44:45.642765
34915,1719,7079,912,1237,8853,19800,2022-05-12 19:44:49.068358
34918,12,85,2,39,53,191,2022-05-12 19:44:50.681461
34919,11,80,1,30,59,181,2022-05-12 19:44:51.856306
34924,9,41,1,40,62,153,2022-05-12 19:44:52.90942
34927,141,222,62,163,1074,1662,2022-05-12 19:44:57.035507
34929,8,326,3,21,64,422,2022-05-12 19:44:58.871403
34930,17,659,7,31,99,813,2022-05-12 19:45:00.947153
34931,20,72,4,37,60,193,2022-05-12 19:45:02.245906
34933,66046,944280,27032,51539,158968,1247865,2022-05-12 19:45:02.421501
34934,23930,208093,9828,20797,98223,360871,2022-05-12 19:45:06.286468
34935,8,123,2,34,59,226,2022-05-12 19:45:08.030242
34936,22,204,1,24,133,384,2022-05-12 19:45:10.392324
34939,253,1452,83,109,2559,4456,2022-05-12 19:45:14.894573
34940,293,637,105,160,1347,2542,2022-05-12 19:45:16.875918
35162,5,21,1,44,36,107,2022-05-12 19:49:18.44693
34941,1832,1,629,435,7248,10145,2022-05-12 19:45:17.050509
34943,49,416,14,34,540,1053,2022-05-12 19:45:18.872782
34944,3590,163500,1405,556,45694,214745,2022-05-12 19:45:19.30133
34948,65,857,38,61,732,1753,2022-05-12 19:45:22.338277
34949,18,24,3,35,70,150,2022-05-12 19:45:23.518413
34952,2,276,2,10,34,324,2022-05-12 19:45:25.23953
34955,7,255,2,30,48,342,2022-05-12 19:45:28.044561
34958,8,297,5,28,56,394,2022-05-12 19:45:30.713554
34960,35,101,16,30,285,467,2022-05-12 19:45:32.316675
34961,253,620,102,138,2784,3897,2022-05-12 19:45:35.547762
34962,680,34120,333,259,10295,45687,2022-05-12 19:45:38.788758
34964,12977,89756,4478,12543,46545,166299,2022-05-12 19:45:42.42261
34966,3610,22163,1497,2171,24114,53555,2022-05-12 19:45:45.269359
34969,11,484,6,30,91,622,2022-05-12 19:45:47.076179
34972,648,9191,291,187,14007,24324,2022-05-12 19:45:47.499772
34975,246,818,130,337,2448,3979,2022-05-12 19:45:57.006373
34980,19,160,4,54,106,343,2022-05-12 19:45:59.9625
34984,20392,123264,8495,9610,96469,258230,2022-05-12 19:46:03.043968
34985,67,107,27,79,396,676,2022-05-12 19:46:05.502259
34990,44,0,15,78,84,221,2022-05-12 19:46:07.29068
34993,7,217,7,30,57,318,2022-05-12 19:46:09.990733
34999,207,1360,78,75,1872,3592,2022-05-12 19:46:14.168676
35000,1241,27227,516,262,12045,41291,2022-05-12 19:46:17.177672
35002,13,110,8,68,63,262,2022-05-12 19:46:18.684433
35003,10,140,4,46,45,245,2022-05-12 19:46:20.079307
35006,102,6543,55,83,1721,8504,2022-05-12 19:46:22.923274
35007,15,129,3,39,81,267,2022-05-12 19:46:24.373437
35009,332,8575,159,315,3086,12467,2022-05-12 19:46:25.279144
35018,56,281,45,58,939,1379,2022-05-12 19:46:28.652315
35020,7,24,2,33,36,102,2022-05-12 19:46:31.038447
35021,6,20,3,36,43,108,2022-05-12 19:46:32.208857
35023,7,22,2,36,38,105,2022-05-12 19:46:33.791403
35025,48,113,18,113,344,636,2022-05-12 19:46:36.783543
35027,7,18,1,38,38,102,2022-05-12 19:46:38.345818
35030,8,19,1,36,45,109,2022-05-12 19:46:39.567329
35031,7,44,2,44,68,165,2022-05-12 19:46:40.782661
35032,7,62,5,49,68,191,2022-05-12 19:46:42.584562
35034,12,46,2,42,55,157,2022-05-12 19:46:44.131165
35035,12,55,2,36,53,158,2022-05-12 19:46:45.265392
35036,13,122,4,39,67,245,2022-05-12 19:46:47.208273
35037,12,54,2,35,47,150,2022-05-12 19:46:49.157236
35038,10,63,7,51,52,183,2022-05-12 19:46:51.148703
35039,9,86,5,49,77,226,2022-05-12 19:46:52.354321
35041,10,36,2,43,46,137,2022-05-12 19:46:56.217468
35044,2987,7532,1185,2088,15995,29787,2022-05-12 19:47:00.313673
35047,26,65,6,39,149,285,2022-05-12 19:47:01.84924
35048,8,57,5,40,43,153,2022-05-12 19:47:03.079136
35049,7,36,3,51,56,153,2022-05-12 19:47:04.149253
35050,6,48,3,51,37,145,2022-05-12 19:47:05.330631
35052,8,21,1,40,41,111,2022-05-12 19:47:08.964793
35053,7,22,2,41,39,111,2022-05-12 19:47:10.01837
35055,10,19,1,41,40,111,2022-05-12 19:47:11.774689
35056,11,21,1,39,50,122,2022-05-12 19:47:13.068517
35057,9,25,2,41,43,120,2022-05-12 19:47:14.198952
35058,11,20,0,43,41,115,2022-05-12 19:47:15.138455
35059,9,24,3,40,59,135,2022-05-12 19:47:16.825002
35062,108196,350739,51157,39993,226634,776719,2022-05-12 19:47:20.098297
35063,129,1390,80,88,1387,3074,2022-05-12 19:47:23.796208
35067,6134,23183,3374,2980,14588,50259,2022-05-12 19:47:27.433457
35072,385,9037,186,254,3796,13658,2022-05-12 19:47:33.667717
35073,40816,683154,10699,11073,98503,844245,2022-05-12 19:47:34.116122
35074,16,89,11,36,175,327,2022-05-12 19:47:36.436087
35076,17709,158693,5934,15381,65224,262941,2022-05-12 19:47:40.935375
35077,43,623,17,45,526,1254,2022-05-12 19:47:43.41137
35078,8245,34348,4143,5671,37757,90164,2022-05-12 19:47:43.818116
35079,14005,83520,7601,9550,63208,177884,2022-05-12 19:47:46.583146
35081,96,923,39,74,1035,2167,2022-05-12 19:47:49.057185
35082,633,8844,366,293,15191,25327,2022-05-12 19:47:49.468212
35084,6,29,2,39,47,123,2022-05-12 19:47:50.873704
35085,6,17,1,40,33,97,2022-05-12 19:47:52.037862
35086,479,2895,273,130,10337,14114,2022-05-12 19:47:56.140306
35090,8,60,1,30,43,142,2022-05-12 19:47:57.391639
35092,5,20,3,34,30,92,2022-05-12 19:48:00.110431
35093,9,29,2,28,66,134,2022-05-12 19:48:01.232392
35098,6,28,2,42,42,120,2022-05-12 19:48:02.982378
35100,7,59,1,43,42,152,2022-05-12 19:48:05.448356
35101,6,19,1,39,35,100,2022-05-12 19:48:06.798412
35102,66,552,26,109,975,1728,2022-05-12 19:48:08.938073
35104,7,34,2,43,74,160,2022-05-12 19:48:10.834327
35106,11,43,2,51,52,159,2022-05-12 19:48:13.022635
35107,12,37,3,49,46,147,2022-05-12 19:48:13.954859
35108,11,41,5,48,53,158,2022-05-12 19:48:15.017203
35109,7,25,2,37,38,109,2022-05-12 19:48:16.386763
35110,1566,43994,590,515,20001,66666,2022-05-12 19:48:16.790511
35111,1556,41090,562,496,19621,63325,2022-05-12 19:48:16.956302
35116,38,175,36,65,251,565,2022-05-12 19:48:21.344106
35118,417,9263,253,223,5383,15539,2022-05-12 19:48:24.444296
35120,41237,697894,20124,28353,164162,951770,2022-05-12 19:48:26.363759
35121,34,88,13,38,235,408,2022-05-12 19:48:28.96061
35122,934,9526,516,617,11665,23258,2022-05-12 19:48:29.27251
35123,7,32,4,43,43,129,2022-05-12 19:48:30.624509
35124,6,20,2,37,36,101,2022-05-12 19:48:31.726168
35126,6,68,9,52,83,218,2022-05-12 19:48:33.779448
35127,6,17,0,41,34,98,2022-05-12 19:48:34.96392
35131,16,63,4,55,144,282,2022-05-12 19:48:42.092861
35133,17,68,5,47,63,200,2022-05-12 19:48:43.456345
35134,476,3720,247,220,11729,16392,2022-05-12 19:48:46.264848
35136,115,173,99,54,10458,10899,2022-05-12 19:48:47.119013
35138,26,62,8,56,187,339,2022-05-12 19:48:50.14925
35139,19,308,14,60,163,564,2022-05-12 19:48:51.778608
35142,33,79,13,79,142,346,2022-05-12 19:48:55.554374
35143,17,168,8,69,96,358,2022-05-12 19:48:56.994243
35145,4370,64823,1890,1096,20185,92364,2022-05-12 19:48:59.937764
35149,9,54,1,45,41,150,2022-05-12 19:49:04.289351
35151,6,46,0,43,37,132,2022-05-12 19:49:06.841047
35152,4,19,3,42,37,105,2022-05-12 19:49:08.49304
35154,5,18,1,37,32,93,2022-05-12 19:49:09.89777
35156,33,308,9,68,302,720,2022-05-12 19:49:13.3277
35158,32,283,18,70,331,734,2022-05-12 19:49:14.637376
35159,1173,20935,387,190,13742,36427,2022-05-12 19:49:14.937968
35160,5,47,4,40,45,141,2022-05-12 19:49:16.084638
35163,7,27,3,41,37,115,2022-05-12 19:49:19.627326
35164,6,48,3,60,40,157,2022-05-12 19:49:20.844432
35166,7,50,2,44,37,140,2022-05-12 19:49:23.176571
35167,4,19,4,40,34,101,2022-05-12 19:49:24.757108
35168,7,21,1,41,36,106,2022-05-12 19:49:25.824767
35169,6,17,1,42,37,103,2022-05-12 19:49:27.428861
35170,7,62,0,44,40,153,2022-05-12 19:49:28.45113
35171,7,38,1,50,51,147,2022-05-12 19:49:29.613748
35180,23236,199308,9201,4403,113036,349184,2022-05-12 19:49:36.67351
35182,206,4144,88,175,3605,8218,2022-05-12 19:49:39.774554
35183,987,4535,466,2422,2701,11111,2022-05-12 19:49:43.062615
35191,704,16565,475,365,16344,34453,2022-05-12 19:49:46.074965
35198,1480,38772,799,500,28426,69977,2022-05-12 19:49:46.486466
35202,291,3143,137,154,2890,6615,2022-05-12 19:49:49.873246
35203,21011,349523,5314,28896,53813,458557,2022-05-12 19:49:50.120553
43920,0,3,0,7,10,20,2022-05-12 21:47:02.908999
35204,438,1786,160,268,1568,4220,2022-05-12 19:49:53.439269
35205,16,44,6,45,72,183,2022-05-12 19:49:54.762935
35215,44,126,14,42,171,397,2022-05-12 19:50:02.245894
35219,36,174,32,113,775,1130,2022-05-12 19:50:03.923077
35220,8089,26557,3682,7082,17610,63020,2022-05-12 19:50:07.513966
35222,18342,175201,7512,6682,65761,273498,2022-05-12 19:50:07.682889
35224,506,4680,203,401,4246,10036,2022-05-12 19:50:11.308904
35226,52,28,21,159,138,398,2022-05-12 19:50:14.29566
35227,22,41,8,70,70,211,2022-05-12 19:50:16.047371
35228,339,5025,154,105,5467,11090,2022-05-12 19:50:16.464799
35231,115,1566,58,85,2739,4563,2022-05-12 19:50:22.522887
35234,15,48,7,49,117,236,2022-05-12 19:50:24.984649
35235,221,1452,93,163,1779,3708,2022-05-12 19:50:26.940694
35237,1229,45463,451,467,14723,62333,2022-05-12 19:50:30.257382
35239,27,97,15,62,389,590,2022-05-12 19:50:31.770051
35240,13589,83361,7027,7931,72565,184473,2022-05-12 19:50:32.095534
35241,11553,52548,5525,8054,58344,136024,2022-05-12 19:50:32.359493
35242,8,61,5,59,61,194,2022-05-12 19:50:33.513472
35243,9,28,2,38,79,156,2022-05-12 19:50:35.672366
35247,13735,207606,4696,2173,118150,346360,2022-05-12 19:50:36.101669
35248,4104,20711,2540,8019,17410,52784,2022-05-12 19:50:39.267558
35249,11369,50085,4232,6859,41012,113557,2022-05-12 19:50:42.948318
35250,2758,6885,1788,7135,14859,33425,2022-05-12 19:50:46.109615
35251,4158,13141,1559,5520,15815,40193,2022-05-12 19:50:49.789838
35252,3630,13682,1451,7032,12307,38102,2022-05-12 19:50:52.933925
35255,631,2719,303,309,3781,7743,2022-05-12 19:50:57.501329
35262,3937,138528,1091,1625,24156,169337,2022-05-12 19:50:57.771547
35264,17,376,6,20,131,550,2022-05-12 19:51:01.452766
35265,108,1004,43,79,923,2157,2022-05-12 19:51:03.704329
35266,19,83,10,49,165,326,2022-05-12 19:51:04.976993
35267,767,5914,639,619,10139,18078,2022-05-12 19:51:05.137201
35270,13,36,1,41,82,173,2022-05-12 19:51:09.244788
35274,5,32,2,42,29,110,2022-05-12 19:51:12.904055
35278,5,41,1,51,35,133,2022-05-12 19:51:17.379625
35279,8,52,3,43,46,152,2022-05-12 19:51:18.510768
35280,6,28,1,39,35,109,2022-05-12 19:51:19.59051
35281,9,24,1,40,36,110,2022-05-12 19:51:20.492566
35283,29,30,10,60,87,216,2022-05-12 19:51:21.507934
35284,77,90,23,51,710,951,2022-05-12 19:51:23.062305
35286,1460,12691,566,676,9184,24577,2022-05-12 19:51:23.853735
35300,1626,1,614,473,8863,11577,2022-05-12 19:51:24.739404
35306,13,58,8,54,87,220,2022-05-12 19:51:27.022548
35307,11,70,9,42,90,222,2022-05-12 19:51:28.437197
35308,12,66,8,60,80,226,2022-05-12 19:51:29.582673
35309,26,52,10,59,91,238,2022-05-12 19:51:30.48697
35310,13,123,11,46,86,279,2022-05-12 19:51:31.570241
35312,46,0,19,74,105,244,2022-05-12 19:51:31.908471
35324,7,142,3,10,32,194,2022-05-12 19:51:34.254148
35326,52,587,38,48,696,1421,2022-05-12 19:51:36.754453
35328,85,651,53,113,1206,2108,2022-05-12 19:51:39.544275
35329,68,931,36,59,855,1949,2022-05-12 19:51:41.881511
35330,21033,101820,11701,21794,40798,197146,2022-05-12 19:51:42.844622
35331,15,37,2,36,58,148,2022-05-12 19:51:44.661477
35332,95,465,34,219,218,1031,2022-05-12 19:51:46.664367
35333,5459,35159,1546,1421,19224,62809,2022-05-12 19:51:46.84102
35334,467,2142,325,502,3251,6687,2022-05-12 19:51:50.227204
35338,2568,85096,819,524,20330,109337,2022-05-12 19:51:56.331588
35339,13,154,3,16,39,225,2022-05-12 19:51:57.892636
35345,16,117,11,45,144,333,2022-05-12 19:51:59.167325
35347,158,3189,56,83,1724,5210,2022-05-12 19:52:02.178355
35350,12,66,2,24,32,136,2022-05-12 19:52:03.761236
35353,31,168,5,34,129,367,2022-05-12 19:52:05.109799
35363,3105,157695,897,477,26401,188575,2022-05-12 19:52:08.71326
35364,10,57,5,43,51,166,2022-05-12 19:52:10.013592
35366,8,249,2,39,65,363,2022-05-12 19:52:13.49637
35368,7,32,2,33,63,137,2022-05-12 19:52:14.945957
35370,501,8182,216,248,3562,12709,2022-05-12 19:52:20.020417
35372,57,0,13,88,93,251,2022-05-12 19:52:21.711721
35376,13327,148072,6721,7012,53428,228560,2022-05-12 19:52:22.622693
35379,22,156,7,61,106,352,2022-05-12 19:52:24.413526
35382,1276,49014,514,540,21613,72957,2022-05-12 19:52:24.590948
35383,53,342,22,112,247,776,2022-05-12 19:52:26.273711
35387,10,237,3,29,56,335,2022-05-12 19:52:31.515633
35388,9,293,3,40,54,399,2022-05-12 19:52:32.864744
35389,9,257,2,29,50,347,2022-05-12 19:52:34.669664
35390,15,327,5,40,58,445,2022-05-12 19:52:35.832412
35391,21,660,5,45,89,820,2022-05-12 19:52:37.24342
35395,13,274,2,30,47,366,2022-05-12 19:52:39.674794
35398,15,196,11,49,58,329,2022-05-12 19:52:41.295011
35401,8,253,2,34,71,368,2022-05-12 19:52:45.209934
35402,11,594,4,42,91,742,2022-05-12 19:52:46.958255
35403,13,274,4,34,59,384,2022-05-12 19:52:48.205218
35404,8,342,6,39,82,477,2022-05-12 19:52:49.370334
35405,10,492,4,29,73,608,2022-05-12 19:52:50.703326
35407,10,332,6,34,59,441,2022-05-12 19:52:52.432464
35408,10,371,2,31,63,477,2022-05-12 19:52:53.74491
35409,8,232,3,36,55,334,2022-05-12 19:52:55.462914
35411,210,313,41,110,1026,1700,2022-05-12 19:52:59.613351
35413,20236,164128,8326,13635,87845,294170,2022-05-12 19:52:59.985848
35417,851,5104,321,442,5512,12230,2022-05-12 19:53:03.639923
35418,431,2869,171,166,3267,6904,2022-05-12 19:53:06.940507
35424,373,2406,219,127,7905,11030,2022-05-12 19:53:13.664558
35425,253,2027,184,110,6570,9144,2022-05-12 19:53:16.368264
35432,38,324,14,62,385,823,2022-05-12 19:53:21.030483
35442,12,104,1,36,52,205,2022-05-12 19:53:25.539898
35443,33,117,14,58,310,532,2022-05-12 19:53:27.705841
35447,28,286,16,90,168,588,2022-05-12 19:53:28.7429
35448,345,4900,160,520,1205,7130,2022-05-12 19:53:31.752336
35450,14,360,2,28,94,498,2022-05-12 19:53:33.075224
35452,10,50,4,37,54,155,2022-05-12 19:53:34.711521
35453,18,94,6,38,118,274,2022-05-12 19:53:36.208696
35454,9,91,4,28,65,197,2022-05-12 19:53:37.842903
35455,30,45,6,58,70,209,2022-05-12 19:53:39.001484
35456,4,128,1,13,32,178,2022-05-12 19:53:40.011408
35459,2836,139539,1003,575,32374,176327,2022-05-12 19:53:42.570687
35472,123,1759,76,86,1410,3454,2022-05-12 19:53:51.690311
35475,11,165,5,45,97,323,2022-05-12 19:53:57.347242
35476,7,44,5,44,68,168,2022-05-12 19:53:58.532461
35478,147,4,35,222,796,1204,2022-05-12 19:54:01.158531
35480,202,223,87,144,3905,4561,2022-05-12 19:54:03.65897
35484,10747,115173,3674,6969,49434,185997,2022-05-12 19:54:04.011114
35488,7,43,3,46,47,146,2022-05-12 19:54:05.520576
35489,8,35,4,35,50,132,2022-05-12 19:54:06.555706
35493,5,35,7,61,44,152,2022-05-12 19:54:11.478601
35495,9,47,1,27,63,147,2022-05-12 19:54:13.812595
35497,18,147,12,52,195,424,2022-05-12 19:54:16.740783
35500,3,2,0,0,81650,81655,2022-05-12 19:54:16.998132
35501,62,361,32,50,606,1111,2022-05-12 19:54:19.077247
35502,19,150,3,24,105,301,2022-05-12 19:54:20.589689
35504,23,114,10,29,286,462,2022-05-12 19:54:22.9641
35505,16,202,8,16,134,376,2022-05-12 19:54:25.051279
35507,40005,689312,10990,13348,136276,889931,2022-05-12 19:54:25.218763
35511,6,132,1,16,35,190,2022-05-12 19:54:35.069692
35513,13,96,2,43,62,216,2022-05-12 19:54:36.697392
35514,10,148,1,11,36,206,2022-05-12 19:54:38.043128
35516,106,166,33,186,521,1012,2022-05-12 19:54:39.974421
35519,17,96,14,57,182,366,2022-05-12 19:54:43.688408
35520,15,58,5,45,98,221,2022-05-12 19:54:44.715198
35522,149,2817,56,47,1283,4352,2022-05-12 19:54:48.588136
35525,9,133,3,28,31,204,2022-05-12 19:54:50.281765
35526,16,108,4,17,83,228,2022-05-12 19:54:51.383431
35527,12,112,2,30,66,222,2022-05-12 19:54:53.022988
35528,15,66,5,44,70,200,2022-05-12 19:54:54.063489
35529,12,63,5,40,57,177,2022-05-12 19:54:55.02228
35530,7,108,3,18,29,165,2022-05-12 19:54:56.230028
35531,7,93,2,18,29,149,2022-05-12 19:54:57.175391
35532,8,91,0,15,31,145,2022-05-12 19:54:59.7114
35533,12,103,1,16,43,175,2022-05-12 19:55:00.034547
35534,8,88,2,17,30,145,2022-05-12 19:55:00.997894
35535,7,102,1,17,29,156,2022-05-12 19:55:02.161866
35536,7,93,2,19,26,147,2022-05-12 19:55:04.077134
35537,7,154,1,28,49,239,2022-05-12 19:55:05.351387
35538,16,92,4,49,117,278,2022-05-12 19:55:06.69226
35541,85,328,49,116,267,845,2022-05-12 19:55:12.460522
35542,37,149,9,68,141,404,2022-05-12 19:55:13.705345
35545,21,89,7,59,102,278,2022-05-12 19:55:15.576771
35551,42,1852,32,75,553,2554,2022-05-12 19:55:17.969058
35552,438,0,315,178,564,1495,2022-05-12 19:55:19.899539
35553,6,228,3,24,36,297,2022-05-12 19:55:21.040263
35554,10,426,3,14,53,506,2022-05-12 19:55:23.081522
35557,21658,195451,9336,8523,151774,386742,2022-05-12 19:55:23.502631
35559,491,5320,164,291,3240,9506,2022-05-12 19:55:25.970359
35560,9,123,1,14,31,178,2022-05-12 19:55:28.324572
35563,19,39,8,41,152,259,2022-05-12 19:55:30.050483
35566,820,8334,386,252,11515,21307,2022-05-12 19:55:33.097539
35567,670,4609,253,227,1269,7028,2022-05-12 19:55:36.7285
35574,13,58,4,46,62,183,2022-05-12 19:55:38.032715
35575,14,72,13,60,111,270,2022-05-12 19:55:39.764741
35576,13,63,4,57,67,204,2022-05-12 19:55:41.960401
35579,11,25,3,45,47,131,2022-05-12 19:55:44.262313
35586,58,89,21,48,392,608,2022-05-12 19:55:46.337356
35587,3,201,1,13,54,272,2022-05-12 19:55:47.949399
35588,4,109,1,16,25,155,2022-05-12 19:55:49.49394
35589,9420,22625,3882,9069,27944,72940,2022-05-12 19:55:52.271667
35593,12,120,6,42,100,280,2022-05-12 19:55:54.618752
35594,46,81,20,51,514,712,2022-05-12 19:55:56.386609
35605,24,60,11,63,112,270,2022-05-12 19:56:00.986348
35608,5043,154753,1925,1008,64719,227448,2022-05-12 19:56:01.261874
35611,8,47,5,38,51,149,2022-05-12 19:56:06.448182
35612,15,160,7,45,132,359,2022-05-12 19:56:07.536267
35617,10,71,3,30,61,175,2022-05-12 19:56:09.498516
35618,8,44,1,37,43,133,2022-05-12 19:56:10.747688
35623,29,129,6,33,115,312,2022-05-12 19:56:13.749775
35625,32,314,8,41,234,629,2022-05-12 19:56:17.642178
35626,1116,7978,260,702,3445,13501,2022-05-12 19:56:20.317677
35628,21,201,10,53,158,443,2022-05-12 19:56:23.435749
35629,3556,25152,1133,4922,12978,47741,2022-05-12 19:56:23.868218
35632,10,222,14,51,132,429,2022-05-12 19:56:27.01709
35635,178,772,66,119,1092,2227,2022-05-12 19:56:29.929104
35639,18061,130854,7814,12012,99621,268362,2022-05-12 19:56:30.556417
35641,8,42,2,46,72,170,2022-05-12 19:56:32.191734
35642,17,188,10,53,80,348,2022-05-12 19:56:33.660401
35643,26,140,12,54,96,328,2022-05-12 19:56:35.000462
35645,300,2908,173,147,7578,11106,2022-05-12 19:56:35.251345
35650,129,201,49,93,420,892,2022-05-12 19:56:37.413559
35651,28,271,8,39,156,502,2022-05-12 19:56:39.419639
35652,49,454,19,75,393,990,2022-05-12 19:56:41.676479
35654,60,1996,20,60,474,2610,2022-05-12 19:56:43.753557
35656,45,76,17,85,485,708,2022-05-12 19:56:45.953286
35663,7,125,1,12,34,179,2022-05-12 19:56:48.394368
35666,7,107,2,25,57,198,2022-05-12 19:56:49.483417
35668,9,114,1,22,33,179,2022-05-12 19:56:51.259357
35669,7,91,1,21,34,154,2022-05-12 19:56:52.927478
35670,6,102,2,27,35,172,2022-05-12 19:56:54.53861
35671,6,100,2,25,32,165,2022-05-12 19:56:55.823812
35673,311,6683,139,112,4114,11359,2022-05-12 19:57:00.470617
35676,367,10325,151,326,3359,14528,2022-05-12 19:57:02.180355
35677,3467,51396,1228,546,56455,113092,2022-05-12 19:57:05.238377
35678,1100,26445,498,220,24969,53232,2022-05-12 19:57:05.658463
35680,14,139,19,42,878,1092,2022-05-12 19:57:07.948023
35683,94,225,76,72,4941,5408,2022-05-12 19:57:12.720484
35684,18,161,5,24,146,354,2022-05-12 19:57:14.072331
35686,398,0,93,142,314,947,2022-05-12 19:57:14.242372
35694,125,0,45,162,143,475,2022-05-12 19:57:16.719676
35695,48,0,18,76,74,216,2022-05-12 19:57:16.909934
35696,48,0,21,77,116,262,2022-05-12 19:57:18.677115
35697,50,0,15,90,97,252,2022-05-12 19:57:20.192642
35698,51,0,11,80,82,224,2022-05-12 19:57:21.371645
35700,25,35,7,41,52,160,2022-05-12 19:57:22.775805
35708,13,142,2,41,80,278,2022-05-12 19:57:26.244867
35710,11,73,4,72,79,239,2022-05-12 19:57:29.484079
35712,17958,132802,7635,20699,60835,239929,2022-05-12 19:57:30.465356
35714,1018,15122,392,491,6518,23541,2022-05-12 19:57:33.304236
35721,10,46,3,55,52,166,2022-05-12 19:57:36.63718
35723,15,69,7,55,129,275,2022-05-12 19:57:39.531801
35730,351,1930,164,1191,1918,5554,2022-05-12 19:57:41.859817
35732,7,147,1,12,36,203,2022-05-12 19:57:43.041295
35734,10,216,5,17,39,287,2022-05-12 19:57:44.752833
35735,1,141,0,11,30,183,2022-05-12 19:57:46.381371
35737,0,0,0,0,9647,9647,2022-05-12 19:57:50.045712
35740,77,3619,73,95,865,4729,2022-05-12 19:57:56.3266
35746,535,4438,146,206,11741,17066,2022-05-12 19:57:58.344493
35752,117,2975,39,64,1077,4272,2022-05-12 19:58:03.817624
35756,10942,64344,3991,5946,46048,131271,2022-05-12 19:58:04.880104
35760,70800,1695224,12142,7945,151785,1937896,2022-05-12 19:58:09.26608
35770,1016,912,636,431,3566,6561,2022-05-12 19:58:13.068233
35773,395,5731,205,213,5997,12541,2022-05-12 19:58:15.796715
35774,89,726,47,73,1457,2392,2022-05-12 19:58:17.919523
35776,90,3150,48,36,982,4306,2022-05-12 19:58:18.358555
35777,789,8594,517,521,2728,13149,2022-05-12 19:58:22.612851
35778,82,1260,46,66,663,2117,2022-05-12 19:58:24.332301
35782,8,118,2,21,29,178,2022-05-12 19:58:25.909412
35786,6,183,3,30,34,256,2022-05-12 19:58:31.740279
35788,39799,696559,10818,9176,99347,855699,2022-05-12 19:58:31.938365
35789,4405,31598,1362,1052,13240,51657,2022-05-12 19:58:38.525315
35790,112969,977273,21124,35224,173180,1319770,2022-05-12 19:58:38.849407
35798,488,19083,176,189,5078,25014,2022-05-12 19:58:39.261494
35799,9,55,4,30,34,132,2022-05-12 19:58:41.286115
35800,12,564,9,25,136,746,2022-05-12 19:58:42.59889
35805,109,824,65,95,1321,2414,2022-05-12 19:58:45.39121
35814,430,8720,198,181,6573,16102,2022-05-12 19:58:53.935572
35815,830,19742,468,539,9452,31031,2022-05-12 19:58:57.31149
35817,17,62,7,55,93,234,2022-05-12 19:58:59.725118
35821,7651,54444,3564,6384,34283,106326,2022-05-12 19:59:03.002521
35823,1254,63784,399,179,11373,76989,2022-05-12 19:59:06.231786
35828,10839,56885,4891,6245,39122,117982,2022-05-12 19:59:06.557988
35834,3599,27936,1778,3725,17206,54244,2022-05-12 19:59:09.654247
35838,23700,120027,12743,9983,121137,287590,2022-05-12 19:59:13.780118
35839,31498,210789,14208,8988,168916,434399,2022-05-12 19:59:14.047937
35840,1024,11338,373,512,6509,19756,2022-05-12 19:59:17.869744
35843,8933,107941,2681,1517,50605,171677,2022-05-12 19:59:19.436636
35847,19310,132626,8451,13464,87683,261534,2022-05-12 19:59:24.371703
35848,5680,139681,1615,1085,88580,236641,2022-05-12 19:59:24.788776
35849,114271,987701,34729,76922,194584,1408207,2022-05-12 19:59:25.201529
35851,11879,184990,3457,1224,152532,354082,2022-05-12 19:59:25.609252
35855,0,0,0,0,1243,1243,2022-05-12 19:59:33.289339
35857,4207,16393,1817,1137,14633,38187,2022-05-12 19:59:33.747115
35860,37543,296344,17805,21213,133928,506833,2022-05-12 19:59:36.333134
35868,2774,19921,1158,1024,44594,69471,2022-05-12 19:59:37.965851
35889,11147,67536,4698,8438,48609,140428,2022-05-12 19:59:42.25432
35890,15,65,5,51,100,236,2022-05-12 19:59:43.61023
35905,12848,90922,4932,9001,54847,172550,2022-05-12 19:59:44.555862
35910,9,46,4,42,45,146,2022-05-12 19:59:48.883092
43926,0,3,0,8,9,20,2022-05-12 21:47:05.695018
35912,10,53,3,44,65,175,2022-05-12 19:59:50.10243
35920,40,122,20,73,105,360,2022-05-12 19:59:54.545925
35928,17341,119242,6175,16479,73076,232313,2022-05-12 19:59:59.701458
35933,32,322,8,41,172,575,2022-05-12 20:00:01.402352
35946,3120,213572,1024,933,44758,263407,2022-05-12 20:00:02.845355
35952,69,493,48,80,1008,1698,2022-05-12 20:00:05.208435
35956,11,49,3,42,55,160,2022-05-12 20:00:07.754363
35957,28,77,12,97,230,444,2022-05-12 20:00:09.622593
35958,13,163,1,32,49,258,2022-05-12 20:00:12.173721
35965,102,2640,49,73,1829,4693,2022-05-12 20:00:21.165376
35968,57528,535553,20411,16817,179135,809444,2022-05-12 20:00:21.437959
35971,95,688,50,338,337,1508,2022-05-12 20:00:23.193179
35972,50997,251640,15479,14867,98923,431906,2022-05-12 20:00:23.609156
35974,12,222,2,13,46,295,2022-05-12 20:00:25.584586
35976,13,144,2,21,65,245,2022-05-12 20:00:29.448062
35978,9,146,1,11,35,202,2022-05-12 20:00:30.50493
35979,13,188,4,18,42,265,2022-05-12 20:00:31.800138
35980,12,129,1,24,54,220,2022-05-12 20:00:32.757858
35981,23,171,8,29,125,356,2022-05-12 20:00:34.002433
35983,8298,41782,4375,9624,35033,99112,2022-05-12 20:00:38.468678
35985,7,69,3,41,65,185,2022-05-12 20:00:42.360632
35992,18,369,5,24,174,590,2022-05-12 20:00:48.308741
35994,47076,304785,22251,44484,139445,558041,2022-05-12 20:00:48.510712
35996,10,85,3,32,98,228,2022-05-12 20:00:53.370466
35997,3641,13775,1616,6692,12647,38371,2022-05-12 20:00:57.232946
35999,78,288,67,791,3757,4981,2022-05-12 20:01:00.16086
36000,1452,5509,676,4303,7751,19691,2022-05-12 20:01:02.742975
36001,2941,15725,900,3497,10823,33886,2022-05-12 20:01:06.474779
36002,19,58,4,63,77,221,2022-05-12 20:01:07.484555
36003,15,61,5,51,61,193,2022-05-12 20:01:08.541476
36005,0,0,0,0,2655,2655,2022-05-12 20:01:10.960441
36006,0,0,0,0,6661,6661,2022-05-12 20:01:13.020266
36009,1637,7546,892,4373,7171,21619,2022-05-12 20:01:15.791262
36016,12,82,11,43,79,227,2022-05-12 20:01:18.410856
36018,32,135,12,76,265,520,2022-05-12 20:01:19.736886
36021,111,236,49,55,822,1273,2022-05-12 20:01:21.902324
36022,475,4009,160,325,1898,6867,2022-05-12 20:01:24.559771
36023,28181,82922,12729,29171,71886,224889,2022-05-12 20:01:27.624978
36027,13451,124884,4569,28192,45341,216437,2022-05-12 20:01:27.873049
36028,25428,150659,10856,9509,107166,303618,2022-05-12 20:01:28.282433
36029,2199,3817,872,4578,7883,19349,2022-05-12 20:01:31.737781
36030,11,400,10,31,178,630,2022-05-12 20:01:33.974949
36032,157,4039,98,121,1879,6294,2022-05-12 20:01:36.313406
36036,23,46,6,37,49,161,2022-05-12 20:01:37.539935
36037,2987,11020,1238,1896,20751,37892,2022-05-12 20:01:40.428224
36038,23479,272550,8266,9845,94271,408411,2022-05-12 20:01:40.855417
36039,4654,58192,2443,5826,28056,99171,2022-05-12 20:01:44.484722
43927,0,3,0,8,9,20,2022-05-12 21:47:06.620455
36040,994,6376,505,1561,6446,15882,2022-05-12 20:01:47.915209
36043,1167,82487,393,240,10454,94741,2022-05-12 20:01:48.890709
36050,8,507,3,14,82,614,2022-05-12 20:01:54.720472
36056,6,163,3,32,51,255,2022-05-12 20:01:56.559274
36057,6,93,1,21,26,147,2022-05-12 20:01:58.387484
36061,12,216,2,14,43,287,2022-05-12 20:01:59.7642
36063,9,161,2,15,39,226,2022-05-12 20:02:02.399148
36064,8595,5,1732,1071,18987,30390,2022-05-12 20:02:02.587706
36065,7,123,1,12,29,172,2022-05-12 20:02:04.877519
36066,9,150,2,11,52,224,2022-05-12 20:02:06.00332
36069,7,195,1,18,39,260,2022-05-12 20:02:08.191046
36070,8,160,1,12,39,220,2022-05-12 20:02:09.897508
36071,9,133,2,14,35,193,2022-05-12 20:02:10.957059
36072,5,144,1,10,31,191,2022-05-12 20:02:12.070471
36073,22,98,12,147,155,434,2022-05-12 20:02:13.264591
36077,307,2798,111,118,4933,8267,2022-05-12 20:02:16.286633
36078,4,223,1,14,35,277,2022-05-12 20:02:17.572012
36079,8,118,3,8,28,165,2022-05-12 20:02:18.883464
36080,21,162,2,13,141,339,2022-05-12 20:02:20.405524
36081,8,129,2,11,33,183,2022-05-12 20:02:21.389726
36082,10,133,2,11,27,183,2022-05-12 20:02:22.394126
36083,204,2050,109,117,2629,5109,2022-05-12 20:02:24.719611
36085,8,137,4,8,34,191,2022-05-12 20:02:28.758511
36086,9,133,2,9,33,186,2022-05-12 20:02:29.930372
36087,7,144,0,10,28,189,2022-05-12 20:02:31.365603
36088,12,217,2,17,51,299,2022-05-12 20:02:33.732588
36090,10,184,4,15,55,268,2022-05-12 20:02:36.319277
36091,5,172,1,14,29,221,2022-05-12 20:02:37.463625
36093,6,178,0,13,39,236,2022-05-12 20:02:39.817845
36094,4670,17892,2542,4046,27655,56805,2022-05-12 20:02:42.535604
36095,9,216,3,15,41,284,2022-05-12 20:02:43.825041
36096,8,287,6,16,42,359,2022-05-12 20:02:45.254564
36098,17075,545940,3942,1571,182834,751362,2022-05-12 20:02:46.809797
36101,15,217,2,20,50,304,2022-05-12 20:02:51.456439
36102,7,218,6,15,51,297,2022-05-12 20:02:52.810997
36103,10,151,1,11,34,207,2022-05-12 20:02:54.276685
36106,12698,178539,4530,1635,64900,262302,2022-05-12 20:02:55.093466
36107,32,91,25,53,138,339,2022-05-12 20:02:59.7523
36108,3560,16519,1505,3715,17373,42672,2022-05-12 20:03:02.478415
36112,39,120,15,42,279,495,2022-05-12 20:03:05.246076
36114,11,170,1,11,34,227,2022-05-12 20:03:09.491866
36115,10,222,3,15,48,298,2022-05-12 20:03:11.309969
36117,8,230,3,13,42,296,2022-05-12 20:03:13.75046
36118,20,67,11,45,199,342,2022-05-12 20:03:15.257511
36119,150,2298,51,85,1307,3891,2022-05-12 20:03:17.261418
36124,13223,67126,5056,13427,38165,136997,2022-05-12 20:03:17.585597
36125,324,14972,97,130,2630,18153,2022-05-12 20:03:20.649123
36129,8,81,2,18,26,135,2022-05-12 20:03:23.473438
36130,30,61,8,49,164,312,2022-05-12 20:03:25.13711
36132,10,144,9,56,95,314,2022-05-12 20:03:26.25863
36136,20,1018,8,15,167,1228,2022-05-12 20:03:28.419507
36144,7818,23493,3582,6358,27455,68706,2022-05-12 20:03:31.59
36145,36,392,13,47,348,836,2022-05-12 20:03:33.365114
36148,463,1740,149,219,2143,4714,2022-05-12 20:03:36.441888
36155,35,1081,10,36,260,1422,2022-05-12 20:03:40.204472
36156,65,2052,19,43,540,2719,2022-05-12 20:03:42.012172
36157,19,1153,5,41,117,1335,2022-05-12 20:03:43.746443
36158,9,318,3,16,51,397,2022-05-12 20:03:44.887216
36159,8,432,2,18,41,501,2022-05-12 20:03:46.801151
36160,719,2797,225,211,4230,8182,2022-05-12 20:03:49.44534
36161,9,47,6,54,62,178,2022-05-12 20:03:50.643754
36162,158,1633,79,70,1448,3388,2022-05-12 20:03:52.841293
36163,10,131,3,41,83,268,2022-05-12 20:03:53.957469
36164,96,159,29,62,501,847,2022-05-12 20:03:56.135573
36167,5,60,3,30,52,150,2022-05-12 20:03:57.764214
36173,28,2532,8,20,193,2781,2022-05-12 20:04:03.842371
36175,6,237,1,16,39,299,2022-05-12 20:04:05.059659
36180,6,243,1,12,44,306,2022-05-12 20:04:06.450713
36181,9,455,5,18,71,558,2022-05-12 20:04:07.745148
36182,14,421,12,49,151,647,2022-05-12 20:04:09.181244
36185,331,2106,111,169,2127,4844,2022-05-12 20:04:15.952678
36191,88,1449,61,52,673,2323,2022-05-12 20:04:18.795724
36194,76,1539,29,52,630,2326,2022-05-12 20:04:21.08327
36196,319,2603,135,232,1379,4668,2022-05-12 20:04:23.345979
36198,4267,26214,1227,4897,18987,55592,2022-05-12 20:04:25.434422
36204,73,127,32,73,1442,1747,2022-05-12 20:04:27.50519
36214,2657,47671,806,406,38268,89808,2022-05-12 20:04:27.750812
36215,814,25263,277,272,4837,31463,2022-05-12 20:04:27.915155
36220,9967,102820,3778,3215,75347,195127,2022-05-12 20:04:34.213429
36221,25,24,8,44,61,162,2022-05-12 20:04:35.98003
36223,119,1179,53,70,1191,2612,2022-05-12 20:04:38.601831
36226,74,181,38,68,409,770,2022-05-12 20:04:40.544838
36228,57,1262,32,84,647,2082,2022-05-12 20:04:42.705352
36229,13,248,5,27,90,383,2022-05-12 20:04:44.762545
36231,55,58,16,122,297,548,2022-05-12 20:04:46.449316
36233,8,66,1,26,46,147,2022-05-12 20:04:47.552417
36234,7,45,12,47,77,188,2022-05-12 20:04:48.71088
36239,175,2505,90,134,1860,4764,2022-05-12 20:04:51.542487
36240,180,4261,97,125,2219,6882,2022-05-12 20:04:51.967345
36242,96,2281,72,107,1421,3977,2022-05-12 20:04:55.248753
36246,359,1470,136,180,2310,4455,2022-05-12 20:05:02.639838
36249,10,134,1,14,25,184,2022-05-12 20:05:05.458956
36250,338,7008,185,228,6629,14388,2022-05-12 20:05:08.31624
36258,11,550,2,10,61,634,2022-05-12 20:05:11.148458
36259,6030,15970,2150,5148,11503,40801,2022-05-12 20:05:14.015382
36264,7,211,3,16,32,269,2022-05-12 20:05:15.649598
36265,16,89,8,63,111,287,2022-05-12 20:05:17.133641
36266,17597,96237,6511,15336,67741,203422,2022-05-12 20:05:20.720589
36267,2697,10617,974,3223,8534,26045,2022-05-12 20:05:23.954096
36269,85,736,82,117,1102,2122,2022-05-12 20:05:24.360019
36271,8,57,2,39,33,139,2022-05-12 20:05:26.087269
36272,8,23,3,32,38,104,2022-05-12 20:05:27.85467
36274,5,41,3,38,45,132,2022-05-12 20:05:30.801588
36275,1609,24937,605,284,12555,39990,2022-05-12 20:05:32.22175
36281,8,234,1,26,53,322,2022-05-12 20:05:38.144046
36286,4846,171203,1663,843,76527,255082,2022-05-12 20:05:38.562603
36288,410,680,143,372,3006,4611,2022-05-12 20:05:42.675795
36290,204,749,70,101,979,2103,2022-05-12 20:05:45.598637
36291,383,1646,118,155,1697,3999,2022-05-12 20:05:48.55388
36292,8,112,1,29,33,183,2022-05-12 20:05:49.635216
36293,7,170,3,19,40,239,2022-05-12 20:05:50.969964
36296,31476,263062,11790,9786,126277,442391,2022-05-12 20:05:51.986335
36297,87,883,31,49,645,1695,2022-05-12 20:05:53.753835
36298,54,245,22,40,546,907,2022-05-12 20:05:55.260546
36299,6,78,2,22,28,136,2022-05-12 20:05:57.415066
36301,9,100,1,20,39,169,2022-05-12 20:06:00.10981
36302,6,127,2,26,38,199,2022-05-12 20:06:01.168322
36305,670,11084,283,172,7435,19644,2022-05-12 20:06:03.908262
36308,800,21345,206,133,9074,31558,2022-05-12 20:06:06.594642
36310,4,18,1,39,31,93,2022-05-12 20:06:08.599021
36312,6,19,1,38,31,95,2022-05-12 20:06:10.839827
36313,7,17,2,38,57,121,2022-05-12 20:06:12.463943
36315,7,20,3,43,40,113,2022-05-12 20:06:15.517897
36316,10948,57028,4065,12155,36078,120274,2022-05-12 20:06:18.340604
36318,4463,42701,1458,2010,7865,58497,2022-05-12 20:06:21.71194
36321,6,18,2,38,30,94,2022-05-12 20:06:23.348488
36322,7,19,3,36,40,105,2022-05-12 20:06:25.638849
36323,6,14,3,37,31,91,2022-05-12 20:06:26.720664
36326,8,26,3,30,40,107,2022-05-12 20:06:30.498455
36339,130,1597,58,76,941,2802,2022-05-12 20:06:33.152299
36344,274,1364,169,144,3950,5901,2022-05-12 20:06:37.397144
36345,37,135,16,65,226,479,2022-05-12 20:06:37.748423
36347,6,110,5,20,31,172,2022-05-12 20:06:38.860694
36348,8,107,3,23,43,184,2022-05-12 20:06:39.892266
36353,7,75,2,27,27,138,2022-05-12 20:06:45.949852
36354,7,94,3,24,35,163,2022-05-12 20:06:47.102512
36355,8,69,3,20,31,131,2022-05-12 20:06:48.146779
36356,7,106,2,28,46,189,2022-05-12 20:06:49.769919
36357,8,128,3,35,57,231,2022-05-12 20:06:51.207382
36359,7,95,2,13,27,144,2022-05-12 20:06:54.197505
36362,6,94,5,17,29,151,2022-05-12 20:06:57.609894
36368,22,456,9,21,165,673,2022-05-12 20:06:59.003635
36369,808,13202,268,173,8407,22858,2022-05-12 20:06:59.405638
36370,541,12203,196,167,6421,19528,2022-05-12 20:07:02.593683
36371,638,11943,189,172,7152,20094,2022-05-12 20:07:03.02967
36372,7,134,0,19,24,184,2022-05-12 20:07:04.243454
36373,7,97,1,15,59,179,2022-05-12 20:07:05.398555
36374,6,104,2,20,29,161,2022-05-12 20:07:07.039651
36376,6,95,2,17,25,145,2022-05-12 20:07:08.834974
36378,10,114,2,24,39,189,2022-05-12 20:07:10.348528
36380,7,38,4,41,37,127,2022-05-12 20:07:11.438367
36381,6,83,1,24,32,146,2022-05-12 20:07:12.531523
36382,7,140,3,28,27,205,2022-05-12 20:07:13.831531
36383,6,99,0,19,29,153,2022-05-12 20:07:14.810371
36384,6,87,0,17,24,134,2022-05-12 20:07:16.45429
36385,8,67,3,20,31,129,2022-05-12 20:07:17.644171
36388,9,117,3,27,32,188,2022-05-12 20:07:21.400124
36389,8,109,2,30,28,177,2022-05-12 20:07:22.980547
36390,32,82,3,27,65,209,2022-05-12 20:07:24.776193
36391,8,86,3,22,30,149,2022-05-12 20:07:25.97179
36392,11,148,3,31,41,234,2022-05-12 20:07:27.209506
36393,7,84,0,15,28,134,2022-05-12 20:07:28.238368
36394,8,82,3,21,27,141,2022-05-12 20:07:29.351285
36395,9,165,0,17,35,226,2022-05-12 20:07:30.384266
36397,4690,12977,2271,4772,18490,43200,2022-05-12 20:07:34.028568
36398,10,110,0,16,27,163,2022-05-12 20:07:35.398223
36399,9,123,2,27,29,190,2022-05-12 20:07:36.626242
36400,7,111,0,22,28,168,2022-05-12 20:07:38.019569
36401,7,92,1,21,35,156,2022-05-12 20:07:39.734708
36403,8,155,0,15,29,207,2022-05-12 20:07:42.097416
36404,34,1217,16,42,290,1599,2022-05-12 20:07:44.474515
36407,29484,350824,6410,25545,65808,478071,2022-05-12 20:07:44.899162
36411,43,8,10,54,82,197,2022-05-12 20:07:50.334063
36419,0,0,0,0,8453,8453,2022-05-12 20:07:55.284811
36423,58,379,24,79,237,777,2022-05-12 20:07:57.002499
36424,291,1859,150,155,3679,6134,2022-05-12 20:08:00.430477
36428,83,121,33,61,692,990,2022-05-12 20:08:03.838309
36429,44,112,18,69,277,520,2022-05-12 20:08:06.488436
36432,20214,104146,8168,9161,78463,220152,2022-05-12 20:08:12.910954
36436,114,1421,56,98,1779,3468,2022-05-12 20:08:16.010347
36439,513,16152,377,409,6115,23566,2022-05-12 20:08:16.421543
36440,426,455,192,405,1997,3475,2022-05-12 20:08:18.523299
36444,154,788,80,135,3936,5093,2022-05-12 20:08:21.343716
36447,158,240,51,132,816,1397,2022-05-12 20:08:23.899605
36451,26,810,7,14,176,1033,2022-05-12 20:08:26.754452
36455,2954,10102,951,1315,14180,29502,2022-05-12 20:08:27.167662
36456,130140,1595438,20060,17234,118159,1881031,2022-05-12 20:08:27.406145
36458,1500,3419,448,1885,5609,12861,2022-05-12 20:08:31.414334
36466,664,29679,311,256,9979,40889,2022-05-12 20:08:36.419256
36468,475,6531,245,253,2574,10078,2022-05-12 20:08:36.767732
36470,20378,134235,7255,9604,81710,253182,2022-05-12 20:08:37.162105
36474,72002,641051,19604,27507,123988,884152,2022-05-12 20:08:41.423103
36480,1603,33803,769,499,33457,70131,2022-05-12 20:08:46.634617
36485,398,3458,227,205,3057,7345,2022-05-12 20:08:52.889382
36486,19,62,12,67,77,237,2022-05-12 20:08:54.874266
36491,734,5539,150,276,2211,8910,2022-05-12 20:09:00.773281
36492,1649,2624,488,257,5687,10705,2022-05-12 20:09:03.444238
36493,42,726,22,40,441,1271,2022-05-12 20:09:05.467438
36494,242,4928,110,142,2241,7663,2022-05-12 20:09:08.121449
36497,548,11611,263,296,5478,18196,2022-05-12 20:09:09.047801
36498,189,1585,141,154,2335,4404,2022-05-12 20:09:11.48747
36500,195,2300,77,112,1118,3802,2022-05-12 20:09:13.668628
36501,264,5488,96,166,2590,8604,2022-05-12 20:09:15.835565
36506,45,0,18,84,102,249,2022-05-12 20:09:17.415474
36511,64646,732451,19458,53394,123711,993660,2022-05-12 20:09:20.247803
36513,2553,12499,908,1517,10587,28064,2022-05-12 20:09:24.420374
36515,796,9701,354,539,8494,19884,2022-05-12 20:09:28.172504
36516,20581,45665,9672,26564,56472,158954,2022-05-12 20:09:28.505706
36517,783,34630,272,653,13600,49938,2022-05-12 20:09:32.429556
36520,54,1409,19,89,263,1834,2022-05-12 20:09:36.048721
36522,3069,22668,1092,1070,12884,40783,2022-05-12 20:09:39.91967
36524,546,18089,177,356,3922,23090,2022-05-12 20:09:43.367831
36525,4906,24828,2048,6883,18978,57643,2022-05-12 20:09:47.760521
36528,54,335,30,32,325,776,2022-05-12 20:09:49.388367
36529,55,486,47,86,2056,2730,2022-05-12 20:09:51.585406
36530,11,122,8,54,61,256,2022-05-12 20:09:52.964458
36531,457,466,214,407,1857,3401,2022-05-12 20:09:55.565596
36536,557,3582,243,378,4296,9056,2022-05-12 20:09:58.749243
36537,81,1069,41,77,2048,3316,2022-05-12 20:10:00.957661
36538,1766,27285,651,310,29848,59860,2022-05-12 20:10:01.371165
36539,678,21077,299,167,7781,30002,2022-05-12 20:10:04.661121
36542,217,1442,70,71,2468,4268,2022-05-12 20:10:04.982265
36543,46,0,17,65,71,199,2022-05-12 20:10:06.087257
36544,230,831,79,100,1502,2742,2022-05-12 20:10:08.591587
36548,13757,74588,6275,11546,61086,167252,2022-05-12 20:10:12.162238
36549,11,66,7,45,68,197,2022-05-12 20:10:13.796332
36550,11,65,7,45,55,183,2022-05-12 20:10:14.807328
36551,12,68,10,59,63,212,2022-05-12 20:10:15.846612
36556,129,577,62,57,2349,3174,2022-05-12 20:10:22.947715
36563,35496,284305,12132,11367,109029,452329,2022-05-12 20:10:31.175979
36564,223,3410,166,251,3052,7102,2022-05-12 20:10:31.77374
36565,2978,16815,1018,1261,8142,30214,2022-05-12 20:10:34.562584
36566,53,976,30,79,766,1904,2022-05-12 20:10:36.264518
36571,42,98,17,41,231,429,2022-05-12 20:10:40.233665
36572,9,74,1,27,45,156,2022-05-12 20:10:41.270478
36575,14,140,3,22,84,263,2022-05-12 20:10:44.123887
36579,9,93,1,24,42,169,2022-05-12 20:10:47.719056
36580,10,154,4,36,57,261,2022-05-12 20:10:48.860751
36582,8,137,0,27,50,222,2022-05-12 20:10:51.164481
36583,10,99,0,26,40,175,2022-05-12 20:10:52.84523
36585,15,94,0,21,52,182,2022-05-12 20:10:55.458351
36586,12,154,2,24,64,256,2022-05-12 20:10:56.492339
36587,4739,23787,1919,2312,25520,58277,2022-05-12 20:10:57.404207
36591,8,50,4,21,61,144,2022-05-12 20:11:00.265621
36592,9,83,9,35,131,267,2022-05-12 20:11:02.092184
36593,1825,4360,866,833,5952,13836,2022-05-12 20:11:05.336041
36594,36,955,6,19,222,1238,2022-05-12 20:11:05.83284
36596,26,767,10,19,196,1018,2022-05-12 20:11:08.261845
36597,29,883,3,16,146,1077,2022-05-12 20:11:09.361367
36598,23,770,3,17,132,945,2022-05-12 20:11:10.589657
36599,121,899,30,28,445,1523,2022-05-12 20:11:11.004016
36600,24,806,5,16,167,1018,2022-05-12 20:11:13.164156
36601,16,749,5,14,121,905,2022-05-12 20:11:14.955121
36602,23,796,4,16,161,1000,2022-05-12 20:11:16.249063
36604,910,2930,155,162,2672,6829,2022-05-12 20:11:20.870364
36605,41,837,13,15,200,1106,2022-05-12 20:11:22.588434
36606,65,870,23,27,489,1474,2022-05-12 20:11:24.119884
36608,28,783,4,18,195,1028,2022-05-12 20:11:26.000449
36611,16,50,7,61,78,212,2022-05-12 20:11:27.033878
36616,1149,53811,538,608,21661,77767,2022-05-12 20:11:29.13115
36618,158,415,40,91,806,1510,2022-05-12 20:11:33.408776
36620,12,91,9,48,118,278,2022-05-12 20:11:35.478679
36621,14,177,1,23,73,288,2022-05-12 20:11:36.584027
36625,370,7577,235,166,5679,14027,2022-05-12 20:11:42.523097
36630,11,860,4,11,83,969,2022-05-12 20:11:46.171715
36632,8915,53335,2955,15426,35953,116584,2022-05-12 20:11:49.914043
36633,16599,214519,6144,7543,76898,321703,2022-05-12 20:11:50.118478
36636,13,171,10,36,130,360,2022-05-12 20:11:51.674025
36637,170,1746,47,127,1071,3161,2022-05-12 20:11:53.832739
36639,221,0,62,161,603,1047,2022-05-12 20:11:55.380769
36640,16,176,3,17,116,328,2022-05-12 20:11:56.557991
36641,8,131,2,20,70,231,2022-05-12 20:11:57.575356
36642,51,387,14,48,342,842,2022-05-12 20:11:59.145418
36644,128,241,46,68,394,877,2022-05-12 20:12:02.253074
36649,64716,336614,31940,28253,237256,698779,2022-05-12 20:12:03.987679
36652,7153,57477,4039,6443,35347,110459,2022-05-12 20:12:08.329722
36653,8335,58693,3927,4463,47432,122850,2022-05-12 20:12:11.16891
36654,1318,5230,662,1836,7275,16321,2022-05-12 20:12:14.201823
36661,39,241,18,42,426,766,2022-05-12 20:12:21.063218
36664,100,371,36,82,1034,1623,2022-05-12 20:12:23.518567
36667,7,121,2,12,25,167,2022-05-12 20:12:25.746253
36669,13,175,2,29,62,281,2022-05-12 20:12:27.201114
36670,9,193,0,23,47,272,2022-05-12 20:12:28.369057
36672,9,206,4,19,54,292,2022-05-12 20:12:31.890909
36674,12,138,1,22,36,209,2022-05-12 20:12:35.088963
36676,4,106,1,15,28,154,2022-05-12 20:12:36.502281
36677,11,112,3,26,58,210,2022-05-12 20:12:37.497393
36684,49,1074,19,56,450,1648,2022-05-12 20:12:44.500602
36685,54,1159,25,56,937,2231,2022-05-12 20:12:47.431372
36686,1267,0,653,171,4522,6613,2022-05-12 20:12:47.606296
36688,2460,54909,800,524,21943,80636,2022-05-12 20:12:50.915972
36692,189,2305,87,90,1686,4357,2022-05-12 20:12:53.345255
36699,1,0,0,0,3418,3419,2022-05-12 20:12:56.026717
36701,9,67,8,90,62,236,2022-05-12 20:12:59.163914
36702,1400,27839,728,726,26064,56757,2022-05-12 20:12:59.609343
36704,9160,97180,5341,4065,43705,159451,2022-05-12 20:13:03.057353
36705,68,99,28,63,797,1055,2022-05-12 20:13:05.024469
36714,56,480,27,59,756,1378,2022-05-12 20:13:07.93027
36718,12,176,1,26,64,279,2022-05-12 20:13:12.93627
36722,374,164,118,158,2624,3438,2022-05-12 20:13:16.602495
36724,67,0,36,70,134,307,2022-05-12 20:13:16.826335
36725,145,3153,80,107,1648,5133,2022-05-12 20:13:18.86872
36726,17340,139167,7047,10823,81770,256147,2022-05-12 20:13:19.11731
36728,94,402,64,164,668,1392,2022-05-12 20:13:22.144444
36729,602,7315,288,415,7484,16104,2022-05-12 20:13:25.290308
36730,20,523,22,58,234,857,2022-05-12 20:13:27.240621
36731,16,202,2,30,103,353,2022-05-12 20:13:28.763484
36732,217,369,67,124,731,1508,2022-05-12 20:13:30.595797
36734,7,79,6,39,51,182,2022-05-12 20:13:31.632657
36735,6,55,9,40,47,157,2022-05-12 20:13:33.064395
36740,29,44,12,69,141,295,2022-05-12 20:13:34.672899
36743,6,220,0,26,51,303,2022-05-12 20:13:37.732013
36744,8,194,0,24,49,275,2022-05-12 20:13:39.281505
36745,9,661,3,52,106,831,2022-05-12 20:13:39.701469
36746,10,631,5,43,94,783,2022-05-12 20:13:41.226508
36747,8,644,6,48,99,805,2022-05-12 20:13:41.632045
36750,15,562,5,19,85,686,2022-05-12 20:13:46.04871
36752,17,273,5,15,102,412,2022-05-12 20:13:47.208869
36753,39,763,14,59,566,1441,2022-05-12 20:13:49.028735
36754,17023,58917,6558,8334,46071,136903,2022-05-12 20:13:51.941069
36756,98,2566,87,156,1427,4334,2022-05-12 20:13:54.520671
36757,19,225,6,32,156,438,2022-05-12 20:13:55.714402
36759,10,43,6,39,48,146,2022-05-12 20:13:57.033084
36760,121,811,82,109,1435,2558,2022-05-12 20:13:59.176642
36762,407,438,140,197,1073,2255,2022-05-12 20:14:03.448053
36765,9,170,1,9,44,233,2022-05-12 20:14:06.585023
36767,7,152,1,7,30,197,2022-05-12 20:14:09.994966
36771,35,82,14,61,244,436,2022-05-12 20:14:12.13719
36774,14,483,7,43,185,732,2022-05-12 20:14:13.506078
36775,598,1692,234,324,4304,7152,2022-05-12 20:14:15.90509
36778,7,220,1,9,39,276,2022-05-12 20:14:19.606272
36781,10,191,3,9,60,273,2022-05-12 20:14:21.097261
36783,222,1623,126,155,2826,4952,2022-05-12 20:14:24.489481
36784,587,3442,256,984,2255,7524,2022-05-12 20:14:27.713975
36789,236,2562,125,130,4422,7475,2022-05-12 20:14:27.875727
36793,21000,173754,8656,20162,67209,290781,2022-05-12 20:14:35.778243
36796,834,13325,387,381,8187,23114,2022-05-12 20:14:39.198628
36797,200,998,99,461,980,2738,2022-05-12 20:14:40.154421
36798,264,5445,132,118,2679,8638,2022-05-12 20:14:42.501487
36799,18,644,5,23,129,819,2022-05-12 20:14:43.920463
36800,2755,13441,1279,1450,11021,29946,2022-05-12 20:14:46.809408
36804,9,115,2,28,37,191,2022-05-12 20:14:51.185602
36805,297,118,98,117,2441,3071,2022-05-12 20:14:53.66823
36806,7,94,3,25,48,177,2022-05-12 20:14:54.976219
36807,7,79,1,13,23,123,2022-05-12 20:14:56.666776
36810,8,79,1,19,25,132,2022-05-12 20:15:00.75354
36811,7,114,1,24,40,186,2022-05-12 20:15:02.063159
36812,7,82,1,13,22,125,2022-05-12 20:15:03.176705
36815,35,173,20,44,459,731,2022-05-12 20:15:05.03899
36816,470,27874,207,224,7248,36023,2022-05-12 20:15:08.42622
36817,10295,61377,3684,6980,47025,129361,2022-05-12 20:15:09.319159
36819,7,110,1,16,29,163,2022-05-12 20:15:12.598926
36820,7,108,0,24,42,181,2022-05-12 20:15:13.744019
36821,7,80,4,20,32,143,2022-05-12 20:15:14.832355
36822,7,143,0,11,40,201,2022-05-12 20:15:15.994618
36823,373,4657,118,150,2475,7773,2022-05-12 20:15:20.11535
36824,799,2327,251,199,3125,6701,2022-05-12 20:15:23.261824
36825,98,2008,73,125,1113,3417,2022-05-12 20:15:25.401361
36827,74,941,39,59,890,2003,2022-05-12 20:15:27.438773
36828,7312,26105,3098,11922,23826,72263,2022-05-12 20:15:30.389444
36834,119,587,53,66,1196,2021,2022-05-12 20:15:32.955978
36835,13,306,9,41,121,490,2022-05-12 20:15:34.617784
36838,9199,106836,2698,1603,55456,175792,2022-05-12 20:15:35.51847
36840,2494,18403,807,2639,12166,36509,2022-05-12 20:15:35.827143
36841,22,687,6,14,133,862,2022-05-12 20:15:37.289392
36843,13,68,3,47,82,213,2022-05-12 20:15:38.608315
36846,6,114,3,18,37,178,2022-05-12 20:15:40.228673
36848,2381,15590,904,924,9421,29220,2022-05-12 20:15:43.593409
36851,7,83,2,26,48,166,2022-05-12 20:15:44.812324
36855,535,8392,404,394,7233,16958,2022-05-12 20:15:47.453589
36856,30,90,13,59,187,379,2022-05-12 20:15:49.369334
36861,187,2214,64,98,1710,4273,2022-05-12 20:15:54.223853
36862,6024,178626,1736,542,133584,320512,2022-05-12 20:15:54.67045
36864,11849,83376,4402,7258,46306,153191,2022-05-12 20:15:58.283511
36865,39,205,16,52,371,683,2022-05-12 20:15:59.754176
36866,61,63,25,56,339,544,2022-05-12 20:16:02.215016
36871,1243,13353,727,1603,6482,23408,2022-05-12 20:16:06.822512
36874,20,96,12,63,64,255,2022-05-12 20:16:08.90444
36875,116,2295,37,75,942,3465,2022-05-12 20:16:11.176075
36881,12,56,3,50,62,183,2022-05-12 20:16:12.81982
36882,32422,388341,6668,33446,92031,552908,2022-05-12 20:16:13.091735
36883,17,154,2,38,126,337,2022-05-12 20:16:15.131593
36884,5408,38530,3322,4350,23359,74969,2022-05-12 20:16:15.369503
36885,5134,76358,1638,726,63614,147470,2022-05-12 20:16:15.532561
36894,49,274,16,109,203,651,2022-05-12 20:16:23.826166
36896,8259,536527,1837,1345,85473,633441,2022-05-12 20:16:24.059888
36902,8794,24982,3620,9646,29931,76973,2022-05-12 20:16:27.158935
36903,5671,79130,1736,2702,30125,119364,2022-05-12 20:16:27.32958
36905,16,41,4,49,112,222,2022-05-12 20:16:33.050624
36906,6938,39143,3133,8214,34162,91590,2022-05-12 20:16:35.726206
36907,21,78,11,36,195,341,2022-05-12 20:16:37.012497
36910,254,1556,53,125,776,2764,2022-05-12 20:16:39.26446
36913,62,1264,30,68,681,2105,2022-05-12 20:16:42.059218
36914,530,8804,307,224,7726,17591,2022-05-12 20:16:44.615498
36915,1187,33812,619,321,13809,49748,2022-05-12 20:16:47.527645
36919,29,1416,21,49,388,1903,2022-05-12 20:16:50.347646
36920,57,2039,13,51,490,2650,2022-05-12 20:16:52.961556
36921,32,1363,16,50,289,1750,2022-05-12 20:16:54.833068
36922,52,1424,23,48,397,1944,2022-05-12 20:16:56.110076
36923,1659,40850,521,680,17425,61135,2022-05-12 20:16:58.801652
36934,12204,26116,5652,8029,12931,64932,2022-05-12 20:17:06.302895
36942,85,574,46,83,930,1718,2022-05-12 20:17:13.250414
36943,4930,29069,1399,4681,19981,60060,2022-05-12 20:17:15.84824
36945,1016,4015,419,2886,7809,16145,2022-05-12 20:17:18.606722
36946,4605,279201,605,508,27986,312905,2022-05-12 20:17:18.861808
36949,32535,510304,7000,5214,75507,630560,2022-05-12 20:17:20.805147
43933,0,2,0,7,9,18,2022-05-12 21:47:08.878752
36950,11469,23010,3131,1661,12637,51908,2022-05-12 20:17:24.403777
36951,374,9135,207,138,8459,18313,2022-05-12 20:17:25.358453
36952,322,1,109,102,2389,2923,2022-05-12 20:17:25.529462
36954,16,144,2,35,74,271,2022-05-12 20:17:26.811429
36955,41,371,24,71,848,1355,2022-05-12 20:17:28.545142
36962,1247,45744,617,352,24418,72378,2022-05-12 20:17:28.86336
36967,79,2382,61,64,1730,4316,2022-05-12 20:17:37.955106
36969,10,121,7,37,76,251,2022-05-12 20:17:40.423366
36970,6,44,4,34,28,116,2022-05-12 20:17:41.845037
36973,18,115,8,42,127,310,2022-05-12 20:17:42.892464
36978,9,69,10,65,67,220,2022-05-12 20:17:47.075761
36979,31,112,22,67,451,683,2022-05-12 20:17:48.480891
36981,18,62,11,51,74,216,2022-05-12 20:17:49.484
36983,15,248,5,30,71,369,2022-05-12 20:17:51.240613
36990,1623,37711,680,276,26134,66424,2022-05-12 20:17:51.688092
36991,59,991,31,41,763,1885,2022-05-12 20:17:53.914433
36992,641,16131,239,213,11724,28948,2022-05-12 20:17:56.64592
36996,426,440,170,207,1363,2606,2022-05-12 20:18:03.253393
36999,6146,112043,2288,734,74711,195922,2022-05-12 20:18:03.735459
37000,49,904,29,39,409,1430,2022-05-12 20:18:07.000471
37007,11141,55642,4581,7538,26605,105507,2022-05-12 20:18:11.462565
37008,463,699,146,235,4875,6418,2022-05-12 20:18:13.984786
37009,8,78,5,21,33,145,2022-05-12 20:18:15.765442
37010,7,99,1,22,31,160,2022-05-12 20:18:17.318097
37011,7,119,1,17,33,177,2022-05-12 20:18:19.111698
37018,11,97,1,25,54,188,2022-05-12 20:18:23.325768
37020,34,0,10,53,84,181,2022-05-12 20:18:24.648041
37021,5195,36198,1534,3441,33992,80360,2022-05-12 20:18:28.618219
37023,2352,2489,1441,1722,7438,15442,2022-05-12 20:18:31.485483
37024,27,74,10,55,100,266,2022-05-12 20:18:32.804555
37026,115,473,45,44,979,1656,2022-05-12 20:18:34.799189
37027,739,21297,362,254,15295,37947,2022-05-12 20:18:35.230551
37029,1946,14155,574,365,8581,25621,2022-05-12 20:18:41.173486
37031,625,7207,274,330,5029,13465,2022-05-12 20:18:43.185489
37033,13399,55385,5273,3590,35126,112773,2022-05-12 20:18:46.074092
37036,922,4055,464,982,4832,11255,2022-05-12 20:18:50.524441
37044,343,2348,135,152,2412,5390,2022-05-12 20:18:54.658028
37045,578,6408,231,217,5115,12549,2022-05-12 20:19:00.088935
37054,19,52,9,92,120,292,2022-05-12 20:19:11.100769
37055,5161,151910,1671,755,66207,225704,2022-05-12 20:19:11.633036
37059,7,104,0,16,28,155,2022-05-12 20:19:15.077137
37060,6,42,2,33,35,118,2022-05-12 20:19:16.772988
37065,9,281,1,42,50,383,2022-05-12 20:19:19.100327
37066,8,76,1,15,27,127,2022-05-12 20:19:20.063809
37067,8,130,1,21,53,213,2022-05-12 20:19:21.643985
37069,6,97,3,21,31,158,2022-05-12 20:19:23.345433
37070,8,81,3,21,30,143,2022-05-12 20:19:24.287246
37071,9,101,2,18,30,160,2022-05-12 20:19:25.391673
37073,8,94,2,16,34,154,2022-05-12 20:19:27.652731
37074,8,129,3,30,37,207,2022-05-12 20:19:28.820628
37075,7,162,0,22,32,223,2022-05-12 20:19:30.419055
37078,3427,68303,695,607,21259,94291,2022-05-12 20:19:31.406053
37082,36,433,24,50,485,1028,2022-05-12 20:19:33.447508
37086,32545,500500,13758,16245,94137,657185,2022-05-12 20:19:33.699978
37090,251,2979,92,130,2281,5733,2022-05-12 20:19:34.250247
37095,3749,216827,1228,508,49441,271753,2022-05-12 20:19:38.047713
37096,203,0,51,167,795,1216,2022-05-12 20:19:38.223013
37098,8,99,4,50,46,207,2022-05-12 20:19:42.475459
37099,8,95,6,54,48,211,2022-05-12 20:19:43.431358
37101,8,94,7,67,56,232,2022-05-12 20:19:46.569696
37102,7,94,7,65,56,229,2022-05-12 20:19:48.022311
37103,771,13024,402,274,10792,25263,2022-05-12 20:19:48.427521
37104,165,756,87,99,1739,2846,2022-05-12 20:19:51.025356
37105,38707,398499,16079,18094,160374,631753,2022-05-12 20:19:51.567549
37106,1270,10142,454,1314,7025,20205,2022-05-12 20:19:55.639544
37112,13,577,15,46,194,845,2022-05-12 20:20:00.723132
37115,13,79,10,59,113,274,2022-05-12 20:20:01.991568
37117,32,70,24,92,219,437,2022-05-12 20:20:03.778032
37124,47,388,19,55,493,1002,2022-05-12 20:20:06.501599
37135,3,114,0,8,23,148,2022-05-12 20:20:12.150655
37138,1,107,0,11,26,145,2022-05-12 20:20:13.879642
37139,497,9458,216,110,6661,16942,2022-05-12 20:20:16.68135
37140,9176,4235,4607,8326,19128,45472,2022-05-12 20:20:16.839969
37141,58075,317488,37763,34748,128155,576229,2022-05-12 20:20:20.855636
37143,11,226,13,84,122,456,2022-05-12 20:20:24.947631
37144,11,82,6,48,74,221,2022-05-12 20:20:25.958477
37145,7,141,4,31,61,244,2022-05-12 20:20:28.487252
37146,16,57,7,32,156,268,2022-05-12 20:20:30.434051
37147,7,373,4,17,52,453,2022-05-12 20:20:32.613024
37148,252,1636,91,133,2256,4368,2022-05-12 20:20:34.779372
37149,38,58,10,45,285,436,2022-05-12 20:20:36.877256
37150,2483,11075,509,830,7161,22058,2022-05-12 20:20:39.863946
37151,61,487,34,74,799,1455,2022-05-12 20:20:41.619061
37154,3675,11861,1586,6895,16007,40024,2022-05-12 20:20:46.799342
37155,7,101,0,31,33,172,2022-05-12 20:20:48.038696
37164,427,5666,85,196,1185,7559,2022-05-12 20:20:48.969537
37165,9,51,4,39,85,188,2022-05-12 20:20:50.133851
37167,33,58,12,31,231,365,2022-05-12 20:20:51.452466
37171,30601,216464,14655,14302,118592,394614,2022-05-12 20:20:53.681794
37174,77,904,25,36,686,1728,2022-05-12 20:20:59.397421
37176,411,4728,88,157,1034,6418,2022-05-12 20:21:05.621195
37179,38,116,10,48,590,802,2022-05-12 20:21:13.799823
37180,10,108,7,60,108,293,2022-05-12 20:21:15.734594
37181,526,1257,200,187,2181,4351,2022-05-12 20:21:18.805546
37184,205,1885,62,94,759,3005,2022-05-12 20:21:21.046609
37185,242,1296,79,103,837,2557,2022-05-12 20:21:22.473978
37186,183,421,46,146,527,1323,2022-05-12 20:21:27.146365
37187,30,56,6,36,211,339,2022-05-12 20:21:29.241328
37188,2909,21907,855,2028,10781,38480,2022-05-12 20:21:32.010505
37190,7,67,3,23,31,131,2022-05-12 20:21:33.488309
37191,9,127,1,26,36,199,2022-05-12 20:21:35.311413
37193,6,85,1,21,25,138,2022-05-12 20:21:36.990342
37195,5,118,2,28,34,187,2022-05-12 20:21:39.471724
37197,8,172,0,16,66,262,2022-05-12 20:21:41.210948
37202,20454,78432,9296,21384,52892,182458,2022-05-12 20:21:42.505798
37207,287,2687,144,138,6636,9892,2022-05-12 20:21:43.790118
37208,16113,75706,5731,5476,87541,190567,2022-05-12 20:21:44.512657
37221,5093,25389,2493,5732,25784,64491,2022-05-12 20:21:49.230102
37225,18,97,7,53,186,361,2022-05-12 20:21:50.9453
37228,6,45,5,22,49,127,2022-05-12 20:21:52.057734
37232,2790,9082,1278,4184,10469,27803,2022-05-12 20:21:56.074992
37245,3058,13484,983,2592,6206,26323,2022-05-12 20:22:02.8872
37246,18,41,8,42,376,485,2022-05-12 20:22:04.986143
37247,137,4953,47,88,951,6176,2022-05-12 20:22:05.15298
37249,16,290,14,68,225,613,2022-05-12 20:22:07.030374
37254,3378,10897,1346,4175,15642,35438,2022-05-12 20:22:09.307696
37255,7,41,3,34,47,132,2022-05-12 20:22:10.918389
37256,22,596,6,48,177,849,2022-05-12 20:22:12.669265
37258,1183,5867,399,1821,4014,13284,2022-05-12 20:22:16.076008
37259,11436,79385,5254,11526,37827,145428,2022-05-12 20:22:17.065327
37262,457,2886,158,160,6239,9900,2022-05-12 20:22:17.381002
37263,22,53,14,76,174,339,2022-05-12 20:22:18.486595
37265,264,1091,123,225,2844,4547,2022-05-12 20:22:25.395443
37266,32,2746,4,28,163,2973,2022-05-12 20:22:27.687163
37267,6,47,9,35,75,172,2022-05-12 20:22:28.846507
37268,1053,3320,384,1499,6216,12472,2022-05-12 20:22:29.262659
37272,611,2325,250,173,5916,9275,2022-05-12 20:22:32.263708
37273,7,191,3,12,49,262,2022-05-12 20:22:34.001044
37277,676,6300,293,434,3407,11110,2022-05-12 20:22:37.127347
37278,418,6655,317,327,5585,13302,2022-05-12 20:22:39.713976
37279,17,164,7,50,98,336,2022-05-12 20:22:40.826427
37281,4656,25176,1304,2520,15361,49017,2022-05-12 20:22:44.331655
37283,826,7200,325,710,1967,11028,2022-05-12 20:22:44.527317
37284,5,57,6,47,183,298,2022-05-12 20:22:48.578443
37285,35,413,23,85,405,961,2022-05-12 20:22:50.336883
37286,148,2769,50,100,4564,7631,2022-05-12 20:22:53.286868
37290,213,121,92,112,339,877,2022-05-12 20:22:54.417876
37293,510,851,173,238,1687,3459,2022-05-12 20:22:58.363559
37294,368,809,100,118,937,2332,2022-05-12 20:22:59.263216
37300,11,167,5,48,67,298,2022-05-12 20:23:00.41329
37302,1946,9388,983,3116,12366,27799,2022-05-12 20:23:00.815437
37308,236,2632,145,149,2713,5875,2022-05-12 20:23:06.851507
37311,90,825,34,77,794,1820,2022-05-12 20:23:09.397651
37324,267,586,178,180,916,2127,2022-05-12 20:23:19.188335
37325,28,47,15,90,366,546,2022-05-12 20:23:21.235729
37326,6,94,4,21,59,184,2022-05-12 20:23:22.477493
37334,13,598,6,32,161,810,2022-05-12 20:23:24.699968
37335,15,52,5,42,53,167,2022-05-12 20:23:25.901686
37336,7,141,1,19,50,218,2022-05-12 20:23:27.212079
37338,3187,11821,1866,4342,15252,36468,2022-05-12 20:23:28.011239
37341,2186,30125,996,265,13667,47239,2022-05-12 20:23:33.734291
37343,39,0,10,51,86,186,2022-05-12 20:23:35.129681
37344,8,225,0,10,55,298,2022-05-12 20:23:36.491285
37345,43555,152396,13816,38547,86106,334420,2022-05-12 20:23:36.903364
37346,140,1030,71,63,7187,8491,2022-05-12 20:23:40.023739
37347,38706,503036,10226,12166,115257,679391,2022-05-12 20:23:40.194574
37348,3847,124771,1335,759,51662,182374,2022-05-12 20:23:44.063803
37349,63464,677418,21851,49062,124332,936127,2022-05-12 20:23:44.332413
37350,8,120,0,16,37,181,2022-05-12 20:23:47.441404
37352,25,472,9,25,170,701,2022-05-12 20:23:49.399552
37355,17,655,5,16,124,817,2022-05-12 20:23:53.614127
37356,17,690,6,14,155,882,2022-05-12 20:23:54.843435
37357,19,651,4,16,119,809,2022-05-12 20:23:56.500164
37359,32,33,15,108,193,381,2022-05-12 20:23:59.667328
37362,424,8477,354,345,5875,15475,2022-05-12 20:24:03.902538
37364,492,13939,320,140,9262,24153,2022-05-12 20:24:08.421847
37365,68,79,52,51,2115,2365,2022-05-12 20:24:11.177409
37369,31,152,13,63,258,517,2022-05-12 20:24:14.245673
37370,298,6842,80,154,2208,9582,2022-05-12 20:24:17.294331
37374,1468,4218,700,4027,7999,18412,2022-05-12 20:24:19.758535
37377,1392,73359,563,429,19575,95318,2022-05-12 20:24:19.947213
37379,10015,59824,3364,1673,43602,118478,2022-05-12 20:24:22.648951
37384,7,360,5,20,76,468,2022-05-12 20:24:25.190121
37385,6,191,1,16,38,252,2022-05-12 20:24:26.434601
37386,4,107,0,23,37,171,2022-05-12 20:24:28.031462
37387,16,297,7,29,159,508,2022-05-12 20:24:29.302359
37390,7,128,3,45,60,243,2022-05-12 20:24:33.157313
37391,11,129,3,45,55,243,2022-05-12 20:24:35.097223
37392,8,134,3,44,53,242,2022-05-12 20:24:36.70849
37395,655,774,315,910,3072,5726,2022-05-12 20:24:40.44122
37396,3659,102582,1449,1324,41623,150637,2022-05-12 20:24:40.875736
37398,64,485,25,75,731,1380,2022-05-12 20:24:42.809508
37401,7,136,0,12,36,191,2022-05-12 20:24:44.245586
37403,37370,64731,13550,18570,37735,171956,2022-05-12 20:24:45.262584
37404,11,216,1,15,48,291,2022-05-12 20:24:47.04188
37406,40,1093,11,31,339,1514,2022-05-12 20:24:50.099355
37408,134,1532,51,114,1200,3031,2022-05-12 20:24:53.651137
37409,38,87,28,39,120,312,2022-05-12 20:24:55.95926
37413,18,638,5,14,118,793,2022-05-12 20:24:57.274263
37418,157,1804,79,91,2054,4185,2022-05-12 20:25:02.016684
37419,4,91,3,13,48,159,2022-05-12 20:25:03.925048
37420,5,98,1,10,47,161,2022-05-12 20:25:04.982505
37421,6,147,1,16,54,224,2022-05-12 20:25:06.08325
37422,299,3013,122,197,2351,5982,2022-05-12 20:25:08.335392
37423,36,209,16,50,380,691,2022-05-12 20:25:10.360159
37424,158,1785,57,131,1234,3365,2022-05-12 20:25:12.435299
37426,8684,47632,4684,10259,47574,118833,2022-05-12 20:25:15.299416
37430,102576,850656,23716,26319,150052,1153319,2022-05-12 20:25:16.898194
37433,646,1508,275,714,3176,6319,2022-05-12 20:25:19.925229
37435,29771,132698,16731,15481,95496,290177,2022-05-12 20:25:23.141297
37437,0,0,0,0,3098,3098,2022-05-12 20:25:28.753033
37440,1867,46627,874,365,40480,90213,2022-05-12 20:25:32.506363
37442,1765,42096,807,316,32699,77683,2022-05-12 20:25:35.58994
37447,14656,30845,7219,11193,46108,110021,2022-05-12 20:25:38.999162
37449,8872,53094,3013,2262,37012,104253,2022-05-12 20:25:48.413713
37450,88262,1096854,27959,28906,204426,1446407,2022-05-12 20:25:48.692464
37452,12,454,3,26,62,557,2022-05-12 20:25:53.157553
37453,4,229,2,14,40,289,2022-05-12 20:25:55.709652
37454,10,28,4,31,87,160,2022-05-12 20:25:57.510035
37455,6,85,1,40,50,182,2022-05-12 20:25:58.591569
37458,4310,25605,2085,5049,19912,56961,2022-05-12 20:26:01.267449
37462,6,69,2,22,30,129,2022-05-12 20:26:05.2656
37464,7,106,1,21,65,200,2022-05-12 20:26:07.776733
37465,4,116,2,22,35,179,2022-05-12 20:26:09.268443
37468,9,231,4,49,68,361,2022-05-12 20:26:12.06054
37472,9,51,8,57,129,254,2022-05-12 20:26:13.118453
37475,20761,186289,7785,10454,84521,309810,2022-05-12 20:26:13.441266
37476,1327,5088,664,957,2453,10489,2022-05-12 20:26:16.240566
37482,12,34,8,33,96,183,2022-05-12 20:26:21.476205
37483,60,332,41,51,3452,3936,2022-05-12 20:26:24.073923
37484,103,245,33,195,597,1173,2022-05-12 20:26:26.199435
37487,3685,15067,1763,4084,23227,47826,2022-05-12 20:26:31.291525
37490,2732,16660,1493,1478,11872,34235,2022-05-12 20:26:34.079951
37491,7416,98006,2277,1395,53243,162337,2022-05-12 20:26:34.527401
37492,1089,59821,584,321,26667,88482,2022-05-12 20:26:37.315374
37493,9,30,9,47,120,215,2022-05-12 20:26:38.721158
37494,7,25,9,48,72,161,2022-05-12 20:26:40.384406
37496,3071,13625,1460,3553,12426,34135,2022-05-12 20:26:41.408454
37497,26120,129712,11414,14919,106902,289067,2022-05-12 20:26:42.288542
37498,1951,38934,707,763,31034,73389,2022-05-12 20:26:42.451409
37501,80,1693,51,99,1393,3316,2022-05-12 20:26:45.754503
37505,463,6714,150,199,3410,10936,2022-05-12 20:26:50.590342
37506,21,337,3,25,198,584,2022-05-12 20:26:52.394972
37507,86,2092,34,69,913,3194,2022-05-12 20:26:54.280483
37509,2041,6650,945,4229,9873,23738,2022-05-12 20:26:54.692424
37510,69303,936841,16114,6260,192618,1221136,2022-05-12 20:26:55.099947
37514,2248,43144,813,914,43056,90175,2022-05-12 20:26:57.431729
37515,2106,45001,779,866,43927,92679,2022-05-12 20:26:58.172435
37516,255,3857,142,108,5667,10029,2022-05-12 20:27:00.886295
37517,16991,133230,8203,15298,80014,253736,2022-05-12 20:27:01.293212
37520,111589,561531,44738,32297,236869,987024,2022-05-12 20:27:01.776249
37521,106889,659851,32356,17389,266201,1082686,2022-05-12 20:27:02.168186
37529,6,127,1,21,55,210,2022-05-12 20:27:05.069658
37530,14,252,1,21,132,420,2022-05-12 20:27:08.494769
37531,11,376,1,13,92,493,2022-05-12 20:27:08.905343
43936,0,3,0,6,8,17,2022-05-12 21:47:10.114855
37534,10,427,3,12,70,522,2022-05-12 20:27:12.281327
37535,10,182,2,23,75,292,2022-05-12 20:27:13.84433
37536,5,99,2,14,30,150,2022-05-12 20:27:14.916385
37537,46,1149,25,46,541,1807,2022-05-12 20:27:16.849436
37539,13,123,1,21,71,229,2022-05-12 20:27:18.580613
37540,4,149,1,11,28,193,2022-05-12 20:27:19.951197
37541,14,353,4,14,101,486,2022-05-12 20:27:22.01565
37542,11,193,2,9,50,265,2022-05-12 20:27:23.069102
37544,5,182,1,17,81,286,2022-05-12 20:27:25.79839
37545,13,306,2,31,89,441,2022-05-12 20:27:27.381843
37546,6,192,0,21,56,275,2022-05-12 20:27:28.573199
37549,9,213,2,24,72,320,2022-05-12 20:27:31.461617
37550,10,278,0,17,80,385,2022-05-12 20:27:32.671435
37552,11,179,4,21,85,300,2022-05-12 20:27:35.260173
37553,8,288,2,20,43,361,2022-05-12 20:27:36.522868
37555,2849,7833,1122,2471,18782,33057,2022-05-12 20:27:40.377262
37559,33,122,18,114,254,541,2022-05-12 20:27:41.654313
37560,25,32,7,108,222,394,2022-05-12 20:27:43.997777
37562,68,200,27,59,1113,1467,2022-05-12 20:27:49.269401
37563,1075,1761,457,489,5223,9005,2022-05-12 20:27:49.509338
37564,1375,3274,391,671,5979,11690,2022-05-12 20:27:52.053742
37566,28,103,10,45,191,377,2022-05-12 20:27:53.361263
37569,15819,124248,7089,9813,63719,220688,2022-05-12 20:27:56.0175
37571,971,2402,424,2793,6128,12718,2022-05-12 20:27:58.667546
37576,6591,22919,2156,9213,19448,60327,2022-05-12 20:28:01.778879
37578,3945,25777,2063,4006,18002,53793,2022-05-12 20:28:08.31669
37579,8217,44718,3619,6432,30434,93420,2022-05-12 20:28:08.777578
37584,1805,5011,809,3211,11273,22109,2022-05-12 20:28:12.502498
37585,5308,69463,994,1689,13570,91024,2022-05-12 20:28:12.850169
37586,112,668,49,122,2507,3458,2022-05-12 20:28:15.271452
37587,4007,14678,1380,3936,14998,38999,2022-05-12 20:28:15.743629
37589,482,1905,222,192,2710,5511,2022-05-12 20:28:18.979846
37590,218,3528,112,221,4030,8109,2022-05-12 20:28:19.259301
37591,7,45,7,34,104,197,2022-05-12 20:28:21.20822
37594,6,199,2,14,36,257,2022-05-12 20:28:22.702167
37595,246,2831,97,128,2294,5596,2022-05-12 20:28:25.374381
37596,321,10995,156,172,10646,22290,2022-05-12 20:28:28.186303
37597,10038,84585,3482,6266,27063,131434,2022-05-12 20:28:28.464121
37598,3763,16278,1570,4340,17032,42983,2022-05-12 20:28:31.719278
37600,101,693,77,117,3414,4402,2022-05-12 20:28:36.747438
37601,3679,12675,1517,6514,15321,39706,2022-05-12 20:28:36.934266
37602,7,146,1,11,34,199,2022-05-12 20:28:40.103226
37604,6,127,1,11,37,182,2022-05-12 20:28:42.428862
37605,5,149,0,14,39,207,2022-05-12 20:28:44.574419
37606,3,140,0,12,41,196,2022-05-12 20:28:45.637371
37608,8,465,5,13,66,557,2022-05-12 20:28:47.797541
37610,4,177,2,13,45,241,2022-05-12 20:28:50.881539
37611,91,1216,46,129,480,1962,2022-05-12 20:28:52.778237
37614,15469,98453,6872,9276,60747,190817,2022-05-12 20:28:53.023119
37616,0,1,0,0,32270,32271,2022-05-12 20:28:53.421833
37618,1459,8468,375,422,7168,17892,2022-05-12 20:28:57.28249
37619,824,708,314,328,3063,5237,2022-05-12 20:28:59.795885
37620,134,101,52,75,1198,1560,2022-05-12 20:29:01.851247
37621,1188,59348,469,272,15997,77274,2022-05-12 20:29:02.274074
37622,136,2915,66,112,2137,5366,2022-05-12 20:29:04.919478
37623,451,14706,234,211,6997,22599,2022-05-12 20:29:06.40941
37626,4,341,7,34,93,479,2022-05-12 20:29:06.830833
37630,16,33,5,66,62,182,2022-05-12 20:29:08.138571
37639,7,132,3,17,41,200,2022-05-12 20:29:09.356071
37640,19,44,8,47,60,178,2022-05-12 20:29:11.441369
37641,241,640,64,106,1514,2565,2022-05-12 20:29:14.116744
37642,28,114,7,42,153,344,2022-05-12 20:29:15.553363
37643,200,199,81,130,491,1101,2022-05-12 20:29:17.187033
37646,160,2003,76,188,832,3259,2022-05-12 20:29:19.302232
37651,1712,41612,833,662,17264,62083,2022-05-12 20:29:22.327171
37653,24,56,14,95,104,293,2022-05-12 20:29:23.484449
37655,839,18196,392,855,4962,25244,2022-05-12 20:29:26.099424
37661,13,110,8,47,196,374,2022-05-12 20:29:30.488798
37663,303,1417,109,181,3546,5556,2022-05-12 20:29:35.257921
37665,14,123,7,62,116,322,2022-05-12 20:29:38.149324
37666,14,149,9,75,106,353,2022-05-12 20:29:39.312818
37668,45,306,14,60,308,733,2022-05-12 20:29:41.431271
37669,6,103,1,17,31,158,2022-05-12 20:29:42.498344
37672,168,2141,51,95,839,3294,2022-05-12 20:29:45.579388
37675,28808,602454,6038,5743,92457,735500,2022-05-12 20:29:49.911099
37679,26,904,16,37,200,1183,2022-05-12 20:29:51.987869
37680,25,256,19,41,257,598,2022-05-12 20:29:54.031581
37683,9,158,1,13,45,226,2022-05-12 20:29:55.586921
37684,35,1404,12,30,622,2103,2022-05-12 20:29:57.865344
37686,7,31,3,43,41,125,2022-05-12 20:29:58.93153
37687,7,53,3,32,39,134,2022-05-12 20:30:00.14228
37688,6,74,1,16,23,120,2022-05-12 20:30:01.239493
37689,6,72,2,17,26,123,2022-05-12 20:30:03.727981
37690,4,127,1,18,28,178,2022-05-12 20:30:04.714336
37692,8,137,0,17,35,197,2022-05-12 20:30:07.171635
37693,10,96,1,18,39,164,2022-05-12 20:30:08.296829
37695,12,147,0,22,35,216,2022-05-12 20:30:10.613316
37696,6,107,3,18,27,161,2022-05-12 20:30:11.714816
37698,5,44,5,43,54,151,2022-05-12 20:30:12.703458
37703,307,2048,207,182,8209,10953,2022-05-12 20:30:15.193139
37704,402,5313,235,102,7984,14036,2022-05-12 20:30:18.306485
37706,601,0,249,171,544,1565,2022-05-12 20:30:18.487502
37710,114,904,46,107,1343,2514,2022-05-12 20:30:20.584699
37711,992,16475,631,353,15145,33596,2022-05-12 20:30:23.645439
37714,7,58,2,47,54,168,2022-05-12 20:30:24.987292
37716,6813,38766,3191,5494,29199,83463,2022-05-12 20:30:27.480744
37717,69,329,25,41,566,1030,2022-05-12 20:30:29.344332
37719,2335,62163,695,697,13677,79567,2022-05-12 20:30:32.015467
37729,6,219,2,19,44,290,2022-05-12 20:30:40.024174
37732,6,102,3,9,32,152,2022-05-12 20:30:43.386706
37733,8,180,2,25,76,291,2022-05-12 20:30:45.1534
37734,1,103,0,8,29,141,2022-05-12 20:30:46.39713
37735,585,7094,191,451,4262,12583,2022-05-12 20:30:50.010705
37736,562,1420,207,294,2205,4688,2022-05-12 20:30:53.406081
37739,254,1332,120,264,581,2551,2022-05-12 20:30:57.714249
37742,18,1343,8,36,177,1582,2022-05-12 20:31:02.27339
37744,19562,166502,5156,32934,40948,265102,2022-05-12 20:31:02.627308
37747,605,3322,193,801,3567,8488,2022-05-12 20:31:06.129785
37749,17,91,5,64,95,272,2022-05-12 20:31:07.86582
37750,13,94,7,57,105,276,2022-05-12 20:31:08.944508
37752,38,92,11,64,145,350,2022-05-12 20:31:11.459436
37753,14,139,1,37,93,284,2022-05-12 20:31:12.490524
37755,669,1365,267,197,2650,5148,2022-05-12 20:31:15.117989
37760,781,8216,186,143,6112,15438,2022-05-12 20:31:16.081545
37762,2,58,2,40,39,141,2022-05-12 20:31:17.826932
37764,427,9731,150,137,5337,15782,2022-05-12 20:31:20.882985
37765,689,14373,178,90,9184,24514,2022-05-12 20:31:21.296174
37775,12,204,1,25,72,314,2022-05-12 20:31:25.844049
37776,11,193,2,26,73,305,2022-05-12 20:31:27.183653
37777,9,265,3,28,67,372,2022-05-12 20:31:28.46334
37778,264,3901,73,142,1105,5485,2022-05-12 20:31:30.883078
37779,89211,1328297,24631,23183,206477,1671799,2022-05-12 20:31:31.236478
37780,32,55,15,100,622,824,2022-05-12 20:31:34.471545
37784,73,911,6,34,589,1613,2022-05-12 20:31:37.824849
37786,21613,134273,9426,8965,106924,281201,2022-05-12 20:31:38.163698
37789,54,400,41,48,548,1091,2022-05-12 20:31:40.472425
37790,7,150,1,30,68,256,2022-05-12 20:31:41.965397
37792,25,315,3,32,148,523,2022-05-12 20:31:43.336838
37799,30080,551048,11310,33220,96769,722427,2022-05-12 20:31:45.089272
37801,7,75,3,25,48,158,2022-05-12 20:31:46.48457
37802,20,252,5,35,146,458,2022-05-12 20:31:47.767148
37806,11886,72039,4851,18178,26878,133832,2022-05-12 20:31:55.039723
37814,126,4062,58,93,1232,5571,2022-05-12 20:31:58.749023
37816,12,42,8,42,179,283,2022-05-12 20:32:01.860803
37818,98,79,44,75,672,968,2022-05-12 20:32:04.293009
37823,8893,41434,3250,23192,29282,106051,2022-05-12 20:32:06.209401
37826,590,19415,235,128,8094,28462,2022-05-12 20:32:14.719307
37827,10,24,6,41,190,271,2022-05-12 20:32:16.365327
37828,707,8989,361,220,14452,24729,2022-05-12 20:32:19.055354
37831,801,24724,431,598,9235,35789,2022-05-12 20:32:21.681538
37843,2,315,8,57,109,491,2022-05-12 20:32:24.242414
37850,57,0,27,80,100,264,2022-05-12 20:32:26.704364
37852,17,64,4,47,71,203,2022-05-12 20:32:29.180212
37853,8,148,2,19,50,227,2022-05-12 20:32:30.204369
37854,7,204,3,39,52,305,2022-05-12 20:32:31.472901
37856,36,609,20,77,340,1082,2022-05-12 20:32:33.854524
37857,50,475,14,16,446,1001,2022-05-12 20:32:35.802333
37858,159,2439,154,131,3041,5924,2022-05-12 20:32:36.861844
37859,140,2305,153,135,2936,5669,2022-05-12 20:32:39.226644
37860,156,2380,154,128,3076,5894,2022-05-12 20:32:40.86217
37863,62,1671,19,49,479,2280,2022-05-12 20:32:41.270593
37864,191,3812,82,129,1677,5891,2022-05-12 20:32:44.631146
37867,4,155,1,13,39,212,2022-05-12 20:32:49.867307
37869,2514,21900,1082,1323,10263,37082,2022-05-12 20:32:52.523536
37873,1179,12950,414,426,4303,19272,2022-05-12 20:32:55.277363
37876,29,63,8,33,147,280,2022-05-12 20:32:58.072262
37877,17,133,3,29,104,286,2022-05-12 20:32:59.874563
37878,5,25,5,36,94,165,2022-05-12 20:33:01.306335
37879,222,1908,39,61,1316,3546,2022-05-12 20:33:04.35343
37881,33,547,8,32,286,906,2022-05-12 20:33:06.156367
37884,372,13471,215,105,7438,21601,2022-05-12 20:33:10.184754
37885,27376,7,7242,14437,14701,63763,2022-05-12 20:33:10.363107
37886,142,909,50,83,1312,2496,2022-05-12 20:33:12.6957
37887,482,1230,133,176,1490,3511,2022-05-12 20:33:13.117483
37888,73,143,33,70,374,693,2022-05-12 20:33:14.857695
37890,2821,18026,1065,1918,12662,36492,2022-05-12 20:33:17.971898
37891,5,29,3,38,26,101,2022-05-12 20:33:19.577259
37894,87,759,34,52,493,1425,2022-05-12 20:33:25.795417
37895,72,706,30,47,455,1310,2022-05-12 20:33:27.716354
37896,190,428,56,79,505,1258,2022-05-12 20:33:29.908124
37897,391,22832,161,199,5646,29229,2022-05-12 20:33:33.095635
37902,417,15819,262,239,8097,24834,2022-05-12 20:33:33.423962
37904,59,50,26,66,579,780,2022-05-12 20:33:35.172543
37905,0,0,0,0,8916,8916,2022-05-12 20:33:38.385466
37910,230,4399,104,119,2455,7307,2022-05-12 20:33:43.176801
37914,1792,10579,373,523,11819,25086,2022-05-12 20:33:46.611158
37916,376,4970,211,140,5180,10877,2022-05-12 20:33:49.749028
37920,8070,56139,3130,8382,29758,105479,2022-05-12 20:33:50.185727
37922,118,875,57,81,1254,2385,2022-05-12 20:33:57.46422
37924,2448,27579,966,671,10368,42032,2022-05-12 20:34:00.430598
37926,8827,57244,3496,8417,35140,113124,2022-05-12 20:34:00.61654
37928,64,139,18,43,253,517,2022-05-12 20:34:05.815459
37930,11,195,0,19,59,284,2022-05-12 20:34:08.403622
37931,28,83,12,59,123,305,2022-05-12 20:34:10.196136
37932,8137,45151,1838,1159,43997,100282,2022-05-12 20:34:11.161541
37933,62,392,37,58,611,1160,2022-05-12 20:34:12.796507
37934,57,350,34,49,584,1074,2022-05-12 20:34:14.746994
37936,3058,16134,659,408,20593,40852,2022-05-12 20:34:18.965501
37937,332,2024,71,153,815,3395,2022-05-12 20:34:21.610583
37940,1875,15195,651,2079,8680,28480,2022-05-12 20:34:25.002565
37941,4,55,2,43,45,149,2022-05-12 20:34:26.230589
37942,4,63,5,42,44,158,2022-05-12 20:34:27.409878
37944,3,53,4,40,41,141,2022-05-12 20:34:28.921519
37945,5,54,4,43,38,144,2022-05-12 20:34:30.140757
37948,93,920,43,83,463,1602,2022-05-12 20:34:33.247287
37951,15,26,7,55,82,185,2022-05-12 20:34:35.585956
37952,5197,16115,2305,13250,23678,60545,2022-05-12 20:34:38.759443
37955,29,923,13,31,375,1371,2022-05-12 20:34:41.205653
37956,7865,106530,3396,4314,35070,157175,2022-05-12 20:34:41.398039
37958,3306,25640,1404,1282,13425,45057,2022-05-12 20:34:45.323695
37960,76,329,30,96,1654,2185,2022-05-12 20:34:48.327622
37962,2969,9195,944,678,10199,23985,2022-05-12 20:34:49.253557
37963,672,5475,194,341,6144,12826,2022-05-12 20:34:49.489111
37964,5132,26370,2143,6332,18555,58532,2022-05-12 20:34:52.80467
37965,22332,137181,9869,7747,82195,259324,2022-05-12 20:34:53.235504
37966,201,15692,160,236,4742,21031,2022-05-12 20:34:56.450495
37968,71,173,38,105,339,726,2022-05-12 20:35:01.415807
37969,26,524,26,57,792,1425,2022-05-12 20:35:03.592788
37970,240,4273,84,103,2230,6930,2022-05-12 20:35:07.022633
37972,11503,84732,4610,4959,64294,170098,2022-05-12 20:35:07.273485
37973,122,3327,61,77,2037,5624,2022-05-12 20:35:11.175519
37975,2269,25300,1171,1264,13151,43155,2022-05-12 20:35:14.127687
37976,36738,233399,19566,31000,107157,427860,2022-05-12 20:35:14.292695
37979,6751,28302,2447,7065,30029,74594,2022-05-12 20:35:22.877294
37981,2631,33335,922,421,46298,83607,2022-05-12 20:35:23.730002
37982,32677,446276,10681,26941,107978,624553,2022-05-12 20:35:24.161053
37983,958,18859,352,194,9662,30025,2022-05-12 20:35:28.480506
37984,58709,181445,8142,15181,66732,330209,2022-05-12 20:35:28.795395
37985,2132,84715,963,614,8749,97173,2022-05-12 20:35:33.009203
37986,1877,61421,749,380,28599,93026,2022-05-12 20:35:33.339368
37987,11484,209634,3675,966,204937,430696,2022-05-12 20:35:33.755203
37989,9123,106856,3973,1953,36260,158165,2022-05-12 20:35:37.919661
37990,207,2973,89,273,840,4382,2022-05-12 20:35:41.392944
37991,73624,629679,14200,8129,103925,829557,2022-05-12 20:35:41.64766
37992,2377,20970,803,4227,10468,38845,2022-05-12 20:35:44.885541
37993,12972,84663,5263,8719,63876,175493,2022-05-12 20:35:45.306509
37994,3028,28274,1198,1599,46347,80446,2022-05-12 20:35:48.644692
37996,508,30635,282,144,10305,41874,2022-05-12 20:35:49.069294
37997,415,11466,237,188,6846,19152,2022-05-12 20:35:49.390462
43944,0,3,0,6,8,17,2022-05-12 21:47:12.558505
37998,5729,32249,2165,6774,24439,71356,2022-05-12 20:35:52.622485
37999,89011,1044723,27174,23842,203131,1387881,2022-05-12 20:35:52.800574
38000,193903,1975122,34970,30025,170124,2404144,2022-05-12 20:35:53.185525
38002,509,30043,255,132,7391,38330,2022-05-12 20:35:57.359952
38003,27094,329569,10191,4593,115636,487083,2022-05-12 20:35:57.736796
38005,1679,7468,463,753,11632,21995,2022-05-12 20:36:02.462558
38006,0,0,0,0,9853,9853,2022-05-12 20:36:03.213412
38008,18,34,9,83,100,244,2022-05-12 20:36:06.62754
38010,23,47,10,99,139,318,2022-05-12 20:36:12.50736
38011,16,78,14,39,373,520,2022-05-12 20:36:13.976804
38012,14,224,16,38,590,882,2022-05-12 20:36:15.559351
38015,221,282,149,56,18190,18898,2022-05-12 20:36:19.435788
38017,60,711,23,75,544,1413,2022-05-12 20:36:22.54303
38018,36,50,14,50,269,419,2022-05-12 20:36:24.021576
38020,1147,20251,527,565,10449,32939,2022-05-12 20:36:25.474937
38021,153,309,68,86,2266,2882,2022-05-12 20:36:27.63801
38022,741,801,228,332,2730,4832,2022-05-12 20:36:29.794287
38024,61,601,30,56,523,1271,2022-05-12 20:36:33.249834
38025,56,0,25,75,150,306,2022-05-12 20:36:33.436825
38026,395,2207,238,218,11199,14257,2022-05-12 20:36:35.921204
38028,44,1013,34,78,540,1709,2022-05-12 20:36:38.396205
38029,5,118,4,31,54,212,2022-05-12 20:36:39.610722
38040,12845,498918,3238,2321,110064,627386,2022-05-12 20:36:39.778
38042,4,155,2,8,35,204,2022-05-12 20:36:42.718883
38044,2,166,1,13,31,213,2022-05-12 20:36:45.881794
38045,7,397,8,35,96,543,2022-05-12 20:36:47.854498
38046,116,1603,72,83,2633,4507,2022-05-12 20:36:50.107441
38049,10,94,4,20,70,198,2022-05-12 20:36:53.104411
38051,28,1058,13,30,316,1445,2022-05-12 20:36:55.808581
38054,20,331,4,21,221,597,2022-05-12 20:37:00.328255
38056,58,243,41,78,959,1379,2022-05-12 20:37:03.073743
38057,63,80,34,54,960,1191,2022-05-12 20:37:05.117698
38059,17,745,6,46,221,1035,2022-05-12 20:37:07.277721
38060,8,62,7,42,149,268,2022-05-12 20:37:08.421167
38062,5807,26657,2633,5698,27279,68074,2022-05-12 20:37:11.742249
38063,83,293,15,46,504,941,2022-05-12 20:37:13.672473
38065,38,1566,16,31,366,2017,2022-05-12 20:37:15.606442
38066,5,162,3,45,67,282,2022-05-12 20:37:17.176495
38067,166,928,78,126,1656,2954,2022-05-12 20:37:19.793978
38068,137,2700,76,117,2193,5223,2022-05-12 20:37:22.112571
38069,15,89,2,49,78,233,2022-05-12 20:37:23.650546
38072,6,122,6,45,45,224,2022-05-12 20:37:27.345979
38073,6,98,5,40,50,199,2022-05-12 20:37:29.0745
38078,30,331,9,26,307,703,2022-05-12 20:37:32.765528
38080,15765,113744,6421,6981,91884,234795,2022-05-12 20:37:32.984477
38081,728,16257,259,158,10094,27496,2022-05-12 20:37:33.391469
38082,0,0,0,0,13281,13281,2022-05-12 20:37:33.658021
38086,1194,17222,574,175,33357,52522,2022-05-12 20:37:37.572459
38087,45,133,29,80,693,980,2022-05-12 20:37:40.438643
38088,944,17770,310,271,15497,34792,2022-05-12 20:37:40.867327
38089,620,1397,395,743,2459,5614,2022-05-12 20:37:43.783801
38090,4,111,1,11,29,156,2022-05-12 20:37:44.737329
38091,2078,9222,1111,3926,8544,24881,2022-05-12 20:37:47.816207
38093,4,59,1,40,39,143,2022-05-12 20:37:49.547795
38094,2,32,2,34,31,101,2022-05-12 20:37:50.765796
38101,35287,603718,10853,15875,103480,769213,2022-05-12 20:37:56.912456
38104,229,2037,125,154,2190,4735,2022-05-12 20:37:59.331861
38110,154,178,87,84,651,1154,2022-05-12 20:38:01.543406
38112,73,158,38,56,386,711,2022-05-12 20:38:03.347105
38114,13,109,7,46,140,315,2022-05-12 20:38:04.633056
38118,5,103,4,51,43,206,2022-05-12 20:38:06.204346
38121,6,95,1,65,52,219,2022-05-12 20:38:10.14231
38123,4,105,1,55,37,202,2022-05-12 20:38:11.694471
38125,4,104,1,59,37,205,2022-05-12 20:38:13.472669
38135,6,84,2,53,39,184,2022-05-12 20:38:17.406875
38145,12791,94074,5456,6421,49235,167977,2022-05-12 20:38:19.80258
38158,6,165,4,29,64,268,2022-05-12 20:38:21.749038
38162,676,3296,339,2011,3750,10072,2022-05-12 20:38:24.527649
38163,1251,14313,414,422,12210,28610,2022-05-12 20:38:27.209818
38164,64,73,25,46,687,895,2022-05-12 20:38:29.004201
38166,3,29,5,36,46,119,2022-05-12 20:38:30.070583
38167,3,27,4,20,35,89,2022-05-12 20:38:32.294468
38174,12,74,10,29,141,266,2022-05-12 20:38:33.75765
38175,40,136,29,70,375,650,2022-05-12 20:38:35.858212
38177,94,892,66,73,1067,2192,2022-05-12 20:38:38.70746
38179,199,678,99,113,2784,3873,2022-05-12 20:38:42.753376
38180,140,1056,75,88,1468,2827,2022-05-12 20:38:44.649285
38181,38,2192,11,58,416,2715,2022-05-12 20:38:47.218357
38186,22537,244401,7864,12983,87160,374945,2022-05-12 20:38:48.271447
38191,2,189,2,19,32,244,2022-05-12 20:38:49.411729
38192,13830,23761,3124,8669,36705,86089,2022-05-12 20:38:49.579619
38194,4,40,4,51,66,165,2022-05-12 20:38:50.671727
38195,4,17,3,34,37,95,2022-05-12 20:38:51.932753
38196,36,216,18,51,285,606,2022-05-12 20:38:53.620468
38199,547,2191,265,1580,3057,7640,2022-05-12 20:38:57.561048
38201,248,7028,117,129,5272,12794,2022-05-12 20:38:57.765841
38203,184,1459,77,208,1345,3273,2022-05-12 20:38:59.940515
38206,62,102,33,52,592,841,2022-05-12 20:39:02.445856
38211,60,388,37,74,641,1200,2022-05-12 20:39:04.839642
38212,1250,8284,427,932,7120,18013,2022-05-12 20:39:05.318684
38226,1100,7759,504,2307,3910,15580,2022-05-12 20:39:11.247823
38234,2369,107802,592,350,22310,133423,2022-05-12 20:39:11.593571
38235,2256,13970,865,1076,4524,22691,2022-05-12 20:39:12.022492
38249,3604,148598,839,543,24393,177977,2022-05-12 20:39:12.725806
38256,12935,52083,5795,9816,57049,137678,2022-05-12 20:39:13.91617
43952,0,4,1,5,8,18,2022-05-12 21:47:16.074493
38262,1072,3966,287,685,3574,9584,2022-05-12 20:39:20.54166
38267,6,183,2,11,40,242,2022-05-12 20:39:22.79763
38268,1163,4990,401,708,8836,16098,2022-05-12 20:39:25.733901
38272,50,49,19,38,482,638,2022-05-12 20:39:29.100577
38274,0,0,0,0,1217,1217,2022-05-12 20:39:33.636207
38279,0,0,0,0,1509,1509,2022-05-12 20:39:40.029658
38284,247,410,126,397,1436,2616,2022-05-12 20:39:42.629037
38285,60,416,24,43,623,1166,2022-05-12 20:39:44.3504
38287,5,65,4,20,31,125,2022-05-12 20:39:45.385916
38291,63,918,54,84,1399,2518,2022-05-12 20:39:48.76755
38292,505,10360,163,141,7018,18187,2022-05-12 20:39:52.390519
38295,4084,25481,1491,5792,18969,55817,2022-05-12 20:39:52.81317
38297,13556,135566,3404,15535,32813,200874,2022-05-12 20:39:55.983112
38299,7,44,9,52,84,196,2022-05-12 20:39:57.071447
38302,4364,19610,2029,6024,19803,51830,2022-05-12 20:40:00.412345
38304,4,84,3,15,31,137,2022-05-12 20:40:02.278633
38306,5,83,1,16,24,129,2022-05-12 20:40:04.996005
38308,3,75,3,16,26,123,2022-05-12 20:40:08.870868
38309,4,88,3,15,30,140,2022-05-12 20:40:11.102464
38311,3,70,1,19,27,120,2022-05-12 20:40:12.525387
38313,434,11049,215,118,8528,20344,2022-05-12 20:40:16.133466
38320,3,76,4,15,24,122,2022-05-12 20:40:18.260923
38321,3,101,2,15,24,145,2022-05-12 20:40:19.957015
38322,2,61,0,20,23,106,2022-05-12 20:40:21.466507
38323,3,115,0,15,24,157,2022-05-12 20:40:22.575805
38325,542,1708,201,124,4150,6725,2022-05-12 20:40:26.057375
38326,3,98,1,16,48,166,2022-05-12 20:40:27.229948
38327,1,81,2,19,24,127,2022-05-12 20:40:28.402376
38328,16001,51737,6699,16471,53637,144545,2022-05-12 20:40:28.719524
38329,12314,444545,3167,1523,112827,574376,2022-05-12 20:40:28.902481
38331,1996,6362,781,3312,10792,23243,2022-05-12 20:40:33.763958
38333,554,12650,264,159,8075,21702,2022-05-12 20:40:35.899982
38337,4315,21001,1471,1029,24540,52356,2022-05-12 20:40:36.234952
38338,4,100,2,23,66,195,2022-05-12 20:40:38.610798
38341,18,223,8,29,233,511,2022-05-12 20:40:40.588327
38348,84,75,35,53,753,1000,2022-05-12 20:40:46.752336
38349,49291,55603,10651,1499,45972,163016,2022-05-12 20:40:47.017431
38352,4,72,0,22,46,144,2022-05-12 20:40:48.421353
38354,18,144,4,21,74,261,2022-05-12 20:40:51.021573
38357,233,4925,95,108,2675,8036,2022-05-12 20:40:54.157931
38361,143,458,50,59,859,1569,2022-05-12 20:40:56.50543
38362,2,112,3,10,25,152,2022-05-12 20:40:57.888852
38363,11,115,9,70,141,346,2022-05-12 20:40:59.492119
38365,34,51,13,149,155,402,2022-05-12 20:41:00.642156
38367,85,757,47,50,752,1691,2022-05-12 20:41:03.02797
38368,14,138,9,53,161,375,2022-05-12 20:41:04.962839
38375,4,144,0,11,46,205,2022-05-12 20:41:10.864241
38376,8,162,2,22,50,244,2022-05-12 20:41:12.044716
38378,26,240,5,48,63,382,2022-05-12 20:41:13.963403
38379,11,135,4,49,50,249,2022-05-12 20:41:15.237592
38383,524,18161,177,165,4217,23244,2022-05-12 20:41:17.766597
38384,16,56,8,38,94,212,2022-05-12 20:41:18.841694
38385,6,354,3,17,101,481,2022-05-12 20:41:20.269003
38386,78,391,28,73,664,1234,2022-05-12 20:41:22.296551
38387,2,103,2,12,29,148,2022-05-12 20:41:23.621424
38389,621,6356,289,442,4889,12597,2022-05-12 20:41:26.066603
38390,3391,16504,1654,4853,15515,41917,2022-05-12 20:41:28.740462
38392,10,630,9,23,107,779,2022-05-12 20:41:30.187353
38393,38,193,25,70,782,1108,2022-05-12 20:41:31.778015
38395,3382,15799,1013,2356,13957,36507,2022-05-12 20:41:35.157814
38397,20458,185383,6080,14352,64893,291166,2022-05-12 20:41:35.469464
38400,509,3706,392,116,44421,49144,2022-05-12 20:41:37.663985
38403,128,61,35,68,926,1218,2022-05-12 20:41:39.71858
38408,131991,1109055,27199,22114,150919,1441278,2022-05-12 20:41:40.479234
38409,3310,38313,1164,1076,17905,61768,2022-05-12 20:41:40.663976
38410,385,12247,124,101,2431,15288,2022-05-12 20:41:45.28231
38412,22,350,17,58,242,689,2022-05-12 20:41:53.807438
38413,161,264,54,86,1135,1700,2022-05-12 20:41:56.376032
38414,4343,136949,1555,683,65512,209042,2022-05-12 20:41:56.543435
38416,153,100,49,69,945,1316,2022-05-12 20:41:59.415496
38419,256,1999,132,120,3440,5947,2022-05-12 20:42:04.392399
38420,13,50,7,31,84,185,2022-05-12 20:42:05.435404
38422,1311,52689,453,333,9966,64752,2022-05-12 20:42:06.374624
38424,10,214,2,26,63,315,2022-05-12 20:42:07.632966
38426,257,3824,135,143,2998,7357,2022-05-12 20:42:13.613797
38429,113,989,82,78,1991,3253,2022-05-12 20:42:17.649624
38433,78,776,62,107,982,2005,2022-05-12 20:42:22.533333
38435,469,4969,127,167,1256,6988,2022-05-12 20:42:24.873288
38436,339,3712,73,131,1329,5584,2022-05-12 20:42:27.44278
38440,1300,2409,322,1730,8560,14321,2022-05-12 20:42:28.459641
38444,160,1312,64,86,1765,3387,2022-05-12 20:42:30.736597
38445,3,217,2,15,32,269,2022-05-12 20:42:31.958202
38449,556,1828,293,2573,3874,9124,2022-05-12 20:42:35.90816
38450,5386,47733,1321,896,27611,82947,2022-05-12 20:42:36.106253
38451,37,0,11,67,76,191,2022-05-12 20:42:37.316023
38464,763,6523,353,401,13251,21291,2022-05-12 20:42:40.966974
38467,296,742,52,92,885,2067,2022-05-12 20:42:43.470105
38471,13,230,2,35,123,403,2022-05-12 20:42:45.325457
38472,19957,234227,7367,11209,70843,343603,2022-05-12 20:42:45.982272
38473,66,1368,23,55,454,1966,2022-05-12 20:42:47.862979
38474,21072,76026,4873,1632,73967,177570,2022-05-12 20:42:48.269833
38475,0,0,1,0,39627,39628,2022-05-12 20:42:48.43669
38476,5511,46471,1873,2188,27737,83780,2022-05-12 20:42:51.23765
38478,1,111,2,12,44,170,2022-05-12 20:42:53.426485
38480,13629,101059,5599,7338,73083,200708,2022-05-12 20:42:53.878564
38481,22709,85134,5897,3122,78951,195813,2022-05-12 20:42:54.270341
38484,5,22,2,39,40,108,2022-05-12 20:42:57.608397
38485,15,277,3,33,132,460,2022-05-12 20:42:59.882603
38486,3,285,4,16,41,349,2022-05-12 20:43:01.754075
38487,4,267,4,16,54,345,2022-05-12 20:43:02.838683
38488,4,230,2,14,30,280,2022-05-12 20:43:04.109309
38489,71,535,22,60,529,1217,2022-05-12 20:43:06.148522
38491,585,3374,113,197,1590,5859,2022-05-12 20:43:08.787743
38493,10,126,1,30,71,238,2022-05-12 20:43:11.177628
38495,5,118,2,10,32,167,2022-05-12 20:43:12.122744
38497,12,118,4,39,93,266,2022-05-12 20:43:13.539573
38500,6,152,1,11,31,201,2022-05-12 20:43:16.138918
38502,6,119,1,10,27,163,2022-05-12 20:43:18.720894
38503,5,108,1,11,22,147,2022-05-12 20:43:19.715728
38504,4,117,0,11,22,154,2022-05-12 20:43:20.921415
38505,7,140,1,19,55,222,2022-05-12 20:43:23.664428
38508,9,184,2,21,56,272,2022-05-12 20:43:26.658116
38509,2,107,0,8,24,141,2022-05-12 20:43:27.989331
38510,7,246,2,26,60,341,2022-05-12 20:43:29.362504
38511,7,135,0,16,44,202,2022-05-12 20:43:30.58849
38520,26,861,3,26,180,1096,2022-05-12 20:43:32.506725
38521,28,357,12,27,197,621,2022-05-12 20:43:34.382135
38524,68773,1617974,7625,4979,120091,1819442,2022-05-12 20:43:34.797389
38525,17,147,7,61,55,287,2022-05-12 20:43:37.541715
38526,9,111,6,63,46,235,2022-05-12 20:43:40.515238
38528,2246,31514,547,586,7677,42570,2022-05-12 20:43:41.327739
38529,2875,10097,1175,4885,14922,33954,2022-05-12 20:43:42.573534
38530,56,2138,71,78,819,3162,2022-05-12 20:43:45.09858
38533,344,1473,109,113,2425,4464,2022-05-12 20:43:48.136059
38534,22,161,12,36,78,309,2022-05-12 20:43:50.028226
38535,13,136,8,32,63,252,2022-05-12 20:43:53.147428
38536,2606,8837,852,727,19370,32392,2022-05-12 20:43:54.187856
38537,8,58,2,41,51,160,2022-05-12 20:43:55.56056
38538,10,60,3,34,55,162,2022-05-12 20:43:56.693916
38539,11,124,7,17,137,296,2022-05-12 20:43:58.953033
38544,3185,13225,1326,5308,11919,34963,2022-05-12 20:44:03.092658
38545,10,407,12,38,162,629,2022-05-12 20:44:04.436892
38552,11,53,1,30,44,139,2022-05-12 20:44:09.801834
38554,12,224,4,46,69,355,2022-05-12 20:44:11.032244
38555,31655,235695,8500,11829,78136,365815,2022-05-12 20:44:11.452506
38556,148,213,62,83,1302,1808,2022-05-12 20:44:13.813698
38557,60,0,19,67,318,464,2022-05-12 20:44:15.995624
38558,157,1297,76,108,2996,4634,2022-05-12 20:44:18.912018
38560,7,63,6,47,71,194,2022-05-12 20:44:20.435546
38561,58,37,31,49,599,774,2022-05-12 20:44:22.132229
38562,31,202,23,66,674,996,2022-05-12 20:44:23.497434
38568,5,39,2,41,64,151,2022-05-12 20:44:24.707566
38569,4,41,3,42,52,142,2022-05-12 20:44:25.644802
38570,5,40,3,43,53,144,2022-05-12 20:44:26.617252
38572,23184,170888,8306,34006,59501,295885,2022-05-12 20:44:27.477227
38573,22034,110188,8170,38778,62301,241471,2022-05-12 20:44:30.95511
38578,1436,3001,657,694,3550,9338,2022-05-12 20:44:36.392554
38579,39,33,13,45,338,468,2022-05-12 20:44:36.823653
38585,0,0,0,0,5923,5923,2022-05-12 20:44:39.321519
38594,4306,82827,1633,690,75085,164541,2022-05-12 20:44:40.655845
38600,109,423,86,102,1560,2280,2022-05-12 20:44:43.644374
38601,175,1354,67,100,2193,3889,2022-05-12 20:44:46.015689
38603,59,49,15,47,209,379,2022-05-12 20:44:47.311552
38609,17,15,7,37,42,118,2022-05-12 20:44:49.564215
38610,19076,131320,6824,17835,63430,238485,2022-05-12 20:44:49.923479
38611,10,88,7,49,62,216,2022-05-12 20:44:51.606243
38612,6,74,3,43,50,176,2022-05-12 20:44:52.634428
38613,7,41,3,38,51,140,2022-05-12 20:44:54.26806
38614,5,49,4,37,49,144,2022-05-12 20:44:55.645018
38616,3,203,6,38,94,344,2022-05-12 20:44:56.973687
38619,8117,46484,3102,4811,38822,101336,2022-05-12 20:44:58.465123
38622,5,120,3,45,44,217,2022-05-12 20:45:00.018744
38623,33,0,18,55,51,157,2022-05-12 20:45:01.15718
38624,8,106,2,43,89,248,2022-05-12 20:45:02.197959
38628,2120,11919,1123,2637,10380,28179,2022-05-12 20:45:08.198662
38629,64,805,34,71,731,1705,2022-05-12 20:45:09.119972
38640,1,119,3,15,31,169,2022-05-12 20:45:13.784234
38644,4,187,1,21,63,276,2022-05-12 20:45:17.137271
38646,29,145,14,71,552,811,2022-05-12 20:45:18.796877
38650,51,538,26,62,545,1222,2022-05-12 20:45:24.031481
38653,324,10481,157,237,3649,14848,2022-05-12 20:45:24.299963
38656,33522,295682,9474,20701,95373,454752,2022-05-12 20:45:24.717854
38659,32548,369841,9368,14282,79017,505056,2022-05-12 20:45:27.381621
38663,1957,17200,724,1779,10279,31939,2022-05-12 20:45:27.823316
38664,243,5474,81,76,3291,9165,2022-05-12 20:45:33.623861
43961,0,2,0,7,8,17,2022-05-12 21:47:18.53453
38667,83,1112,43,93,1133,2464,2022-05-12 20:45:37.051745
38668,29503,254613,11176,11331,123038,429661,2022-05-12 20:45:37.233958
38669,546,1793,203,356,3794,6692,2022-05-12 20:45:43.884167
38671,129569,645349,48254,62188,180637,1065997,2022-05-12 20:45:44.495793
38672,53,1090,46,83,971,2243,2022-05-12 20:45:48.309076
38673,325,2979,118,407,1920,5749,2022-05-12 20:45:52.424191
38674,18,259,5,33,101,416,2022-05-12 20:45:55.150135
43970,0,3,0,6,8,17,2022-05-12 21:47:21.047389
38677,277,804,106,137,2270,3594,2022-05-12 20:45:58.575793
38680,70604,357174,30415,24910,176118,659221,2022-05-12 20:46:05.059264
38681,229,2015,86,114,2564,5008,2022-05-12 20:46:05.491548
38683,8,118,9,54,112,301,2022-05-12 20:46:09.393807
38685,31,103,8,47,129,318,2022-05-12 20:46:11.69114
38688,82,173,23,73,338,689,2022-05-12 20:46:13.304214
38689,91,107,27,62,252,539,2022-05-12 20:46:14.812768
38690,50,116,23,58,272,519,2022-05-12 20:46:16.393423
38691,139342,999549,41840,42951,202098,1425780,2022-05-12 20:46:16.815383
38693,411,9600,220,256,5576,16063,2022-05-12 20:46:20.616288
38699,2557,83581,1098,632,29348,117216,2022-05-12 20:46:21.049668
38700,11,220,1,18,64,314,2022-05-12 20:46:23.738837
38701,11,452,3,25,83,574,2022-05-12 20:46:25.666493
38702,5,323,3,21,98,450,2022-05-12 20:46:28.074637
38705,18,72,14,66,250,420,2022-05-12 20:46:29.747995
38707,2708,10228,1345,5012,11503,30796,2022-05-12 20:46:32.709571
38710,826,9551,477,147,7320,18321,2022-05-12 20:46:35.778395
38714,69,909,52,75,1764,2869,2022-05-12 20:46:42.860381
38715,225,430,98,263,1091,2107,2022-05-12 20:46:45.998159
38716,0,1,0,0,5252,5253,2022-05-12 20:46:48.670503
38719,457,973,158,463,1716,3767,2022-05-12 20:46:54.902227
38720,126,2748,77,74,2393,5418,2022-05-12 20:46:55.99124
38722,20,139,10,22,231,422,2022-05-12 20:46:57.412249
38727,10,571,0,36,84,701,2022-05-12 20:46:59.458377
38729,12,50,1,33,146,242,2022-05-12 20:47:03.113565
38731,11245,42270,2589,1419,17150,74673,2022-05-12 20:47:03.557108
38733,547,35445,282,127,6704,43105,2022-05-12 20:47:06.280484
38735,4918,65588,2621,7506,32661,113294,2022-05-12 20:47:07.18235
38739,69,885,43,60,1140,2197,2022-05-12 20:47:11.450462
38742,378,915,116,194,2637,4240,2022-05-12 20:47:17.20057
38745,0,0,0,0,3574,3574,2022-05-12 20:47:24.431277
38748,4,456,3,28,92,583,2022-05-12 20:47:24.938512
38749,1795,2720,356,1273,14205,20349,2022-05-12 20:47:25.415797
38752,4,106,2,8,29,149,2022-05-12 20:47:26.616213
38753,19430,152068,7872,9541,93538,282449,2022-05-12 20:47:26.828758
38757,7,154,2,12,66,241,2022-05-12 20:47:28.548282
38758,5,178,1,12,40,236,2022-05-12 20:47:29.874149
38759,27043,176637,12211,17324,71260,304475,2022-05-12 20:47:30.039209
38764,7,189,1,11,32,240,2022-05-12 20:47:31.833492
38765,7,151,1,12,36,207,2022-05-12 20:47:34.039455
38766,11,263,0,26,48,348,2022-05-12 20:47:34.772508
38769,5,144,4,18,135,306,2022-05-12 20:47:43.268956
38770,479,17297,155,167,5168,23266,2022-05-12 20:47:43.709827
38771,9,147,0,21,47,224,2022-05-12 20:47:45.145757
38772,11,162,2,18,43,236,2022-05-12 20:47:48.134514
38773,7,220,0,20,50,297,2022-05-12 20:47:49.996066
38774,59,78,15,53,78,283,2022-05-12 20:47:51.358612
38776,63,0,21,165,126,375,2022-05-12 20:47:53.305739
38777,4762,16500,777,815,20449,43303,2022-05-12 20:47:53.554447
38778,15486,140735,5292,12081,57458,231052,2022-05-12 20:47:54.000556
38785,3,88,2,25,38,156,2022-05-12 20:47:56.26075
38786,4,87,2,29,35,157,2022-05-12 20:47:59.348304
38787,12486,85991,4566,6757,55512,165312,2022-05-12 20:47:59.597255
38788,73,778,62,78,1087,2078,2022-05-12 20:47:59.911888
38790,32500,281223,9867,16338,68671,408599,2022-05-12 20:48:03.679927
38793,23653,111751,6798,2410,41353,185965,2022-05-12 20:48:03.922742
38795,6,208,1,14,40,269,2022-05-12 20:48:08.747323
38796,4,174,1,12,38,229,2022-05-12 20:48:11.041762
38797,1762,18870,423,1070,6636,28761,2022-05-12 20:48:11.46962
38800,7,134,0,19,47,207,2022-05-12 20:48:17.059171
38803,87,706,60,91,1048,1992,2022-05-12 20:48:19.160246
38804,234,669,66,176,1166,2311,2022-05-12 20:48:21.128755
38805,6,121,3,32,56,218,2022-05-12 20:48:24.00316
38807,824,33977,289,619,8442,44151,2022-05-12 20:48:27.309389
38808,11,554,6,11,94,676,2022-05-12 20:48:29.10527
38809,10,583,3,12,118,726,2022-05-12 20:48:30.261085
38810,224,6854,165,96,3206,10545,2022-05-12 20:48:32.860563
38811,1,143,0,9,23,176,2022-05-12 20:48:34.301519
38812,1,173,2,12,36,224,2022-05-12 20:48:35.478595
38813,7,204,2,15,45,273,2022-05-12 20:48:36.632195
38814,5709,38403,1663,7399,18964,72138,2022-05-12 20:48:37.043295
38815,378,42685,130,120,3730,47043,2022-05-12 20:48:40.524115
38816,5934,106525,1952,1233,78003,193647,2022-05-12 20:48:40.856913
38819,6,285,1,24,58,374,2022-05-12 20:48:44.801317
38820,46,11,22,51,86,216,2022-05-12 20:48:46.227845
38821,27,50,11,51,138,277,2022-05-12 20:48:47.768063
38824,197,5938,55,52,1934,8176,2022-05-12 20:48:50.651326
38826,18063,576814,4259,1364,188287,788787,2022-05-12 20:48:50.898941
38827,60,24,12,47,82,225,2022-05-12 20:48:52.46308
38830,14833,131177,2582,10271,27613,186476,2022-05-12 20:48:56.468536
38837,76,440,25,92,572,1205,2022-05-12 20:49:01.526492
38843,7535,42100,1649,6860,21007,79151,2022-05-12 20:49:01.723721
38848,4,46,5,29,46,130,2022-05-12 20:49:06.636372
38849,5,128,0,18,44,195,2022-05-12 20:49:08.028171
38850,76,1479,48,102,1287,2992,2022-05-12 20:49:08.433373
38851,765,1764,356,1827,3029,7741,2022-05-12 20:49:09.032625
38852,14,575,5,12,82,688,2022-05-12 20:49:11.033293
38853,8780,11645,1503,28182,23192,73302,2022-05-12 20:49:14.198002
38854,34,315,25,37,567,978,2022-05-12 20:49:16.007499
38855,4,168,4,12,27,215,2022-05-12 20:49:17.413654
38856,4,117,1,7,24,153,2022-05-12 20:49:19.046675
38857,21,103,6,77,184,391,2022-05-12 20:49:21.357318
38860,778,2446,311,997,6752,11284,2022-05-12 20:49:23.896141
38861,3,55,2,34,47,141,2022-05-12 20:49:25.146988
38862,3,35,4,32,45,119,2022-05-12 20:49:26.622915
38870,2,29,4,29,38,102,2022-05-12 20:49:34.713063
38872,4,60,5,42,97,208,2022-05-12 20:49:37.360574
38873,4,25,6,36,41,112,2022-05-12 20:49:38.657597
38876,3,25,3,41,34,106,2022-05-12 20:49:42.257617
38877,5,26,5,36,44,116,2022-05-12 20:49:44.190427
38879,2,25,4,33,30,94,2022-05-12 20:49:46.858886
38882,51,156,28,58,3678,3971,2022-05-12 20:49:47.542711
38883,51716,598377,10879,4199,98073,763244,2022-05-12 20:49:47.901826
38888,2,149,2,11,32,196,2022-05-12 20:49:50.936648
38889,6746,91167,2360,1488,34656,136417,2022-05-12 20:49:51.372225
38891,203,1907,70,65,2602,4847,2022-05-12 20:49:54.994816
38893,4,214,0,12,39,269,2022-05-12 20:49:56.41276
38897,588,7322,351,177,9115,17553,2022-05-12 20:50:04.107915
38901,2,170,3,12,35,222,2022-05-12 20:50:11.885391
38903,0,0,0,0,1959,1959,2022-05-12 20:50:18.355549
38905,6,225,1,15,35,282,2022-05-12 20:50:19.578649
38906,15,682,6,23,200,926,2022-05-12 20:50:21.373462
38907,11,156,6,40,58,271,2022-05-12 20:50:22.68371
38909,15561,78824,4786,17077,33175,149423,2022-05-12 20:50:23.138777
38911,7,89,4,33,42,175,2022-05-12 20:50:25.185387
38914,5,124,2,7,26,164,2022-05-12 20:50:28.864474
38916,92,418,27,74,412,1023,2022-05-12 20:50:31.788129
38917,2159,17443,586,730,10456,31374,2022-05-12 20:50:31.979471
38918,280,505,70,114,717,1686,2022-05-12 20:50:34.075418
38920,2419,8981,859,2816,10670,25745,2022-05-12 20:50:40.046835
38923,100,551,20,84,266,1021,2022-05-12 20:50:45.962804
38924,14415,60050,6698,11938,56992,150093,2022-05-12 20:50:49.156875
38926,21,0,15,44,51,131,2022-05-12 20:50:50.801201
38927,20,0,12,36,51,119,2022-05-12 20:50:52.003401
38931,24,42,6,30,70,172,2022-05-12 20:50:53.669668
38932,3,146,0,11,50,210,2022-05-12 20:50:55.049627
38933,6,123,3,16,59,207,2022-05-12 20:50:56.331561
38934,24,661,8,15,205,913,2022-05-12 20:50:58.447699
38935,7475,53346,2248,4746,34543,102358,2022-05-12 20:50:58.871124
38937,192,2470,91,126,2344,5223,2022-05-12 20:51:05.72026
38938,4593,32521,1512,1557,30479,70662,2022-05-12 20:51:05.904571
38939,755,16211,417,409,10214,28006,2022-05-12 20:51:06.192168
38954,14,248,9,62,196,529,2022-05-12 20:51:15.145442
38955,6,217,2,18,50,293,2022-05-12 20:51:17.174047
38957,21,1001,9,20,202,1253,2022-05-12 20:51:20.527226
38958,465,11393,181,168,3305,15512,2022-05-12 20:51:23.142779
38959,11993,63025,5190,6872,46930,134010,2022-05-12 20:51:25.942332
38960,7,237,2,14,40,300,2022-05-12 20:51:27.277118
38963,619,11549,362,238,9239,22007,2022-05-12 20:51:31.281523
38970,12,233,6,23,90,364,2022-05-12 20:51:35.069488
38971,286,6114,175,179,3405,10159,2022-05-12 20:51:35.272135
38972,1051,25658,352,662,8019,35742,2022-05-12 20:51:38.957835
38974,4,389,3,14,51,461,2022-05-12 20:51:40.502707
38976,12,187,5,23,78,305,2022-05-12 20:51:42.261604
38977,10,209,2,20,85,326,2022-05-12 20:51:43.412958
38980,14,742,3,32,61,852,2022-05-12 20:51:45.544471
38982,0,1,0,0,9762,9763,2022-05-12 20:51:49.112487
38987,49,580,29,57,517,1232,2022-05-12 20:51:54.625424
38990,1110,8413,187,248,3522,13480,2022-05-12 20:51:57.48176
38992,27300,130561,10670,14079,89037,271647,2022-05-12 20:51:57.677836
38993,15924,183888,6204,4214,68329,278559,2022-05-12 20:52:00.612399
38997,3,215,2,13,53,286,2022-05-12 20:52:02.144799
38998,38,174,21,50,569,852,2022-05-12 20:52:04.217646
39001,9,526,4,14,88,641,2022-05-12 20:52:09.794436
39003,30,43,15,114,265,467,2022-05-12 20:52:12.528808
39007,33,37,9,95,685,859,2022-05-12 20:52:14.872324
39011,161,2507,80,115,1325,4188,2022-05-12 20:52:17.492359
39012,10,26,6,54,57,153,2022-05-12 20:52:19.117298
39014,516,8780,352,233,13743,23624,2022-05-12 20:52:20.153849
39018,11,470,3,22,116,622,2022-05-12 20:52:25.428987
39020,28,575,14,41,573,1231,2022-05-12 20:52:27.267092
39022,303,882,143,322,1997,3647,2022-05-12 20:52:29.626104
39023,131,0,31,81,771,1014,2022-05-12 20:52:29.788545
39024,630,3048,105,184,1466,5433,2022-05-12 20:52:32.293235
39026,36013,174481,16490,20049,84571,331604,2022-05-12 20:52:35.261388
39027,13,214,3,49,84,363,2022-05-12 20:52:37.028839
39028,5,53,2,26,61,147,2022-05-12 20:52:38.275827
39030,15407,99873,4743,14604,37443,172070,2022-05-12 20:52:42.404442
39031,52,68,17,151,298,586,2022-05-12 20:52:43.87257
39032,9,68,7,38,103,225,2022-05-12 20:52:45.225244
39033,4,22,3,35,35,99,2022-05-12 20:52:46.218652
39036,4,84,0,20,39,147,2022-05-12 20:52:49.946934
39037,11,77,8,28,142,266,2022-05-12 20:52:51.073811
39038,6,176,3,23,45,253,2022-05-12 20:52:52.124209
39039,80,146,21,161,555,963,2022-05-12 20:52:54.278178
39048,43,0,22,26,32,123,2022-05-12 20:52:59.984196
39049,1805,16600,845,685,11170,31105,2022-05-12 20:53:00.183622
39056,15,318,6,19,100,458,2022-05-12 20:53:03.938772
39057,52,1659,16,57,259,2043,2022-05-12 20:53:06.03264
39065,55,3385,10,31,445,3926,2022-05-12 20:53:07.042106
39066,180,1246,78,120,1323,2947,2022-05-12 20:53:07.263717
39071,11572,59114,4241,4544,51985,131456,2022-05-12 20:53:13.294539
39078,512,1817,132,245,1796,4502,2022-05-12 20:53:18.941807
39080,464,1769,76,170,826,3305,2022-05-12 20:53:21.691497
39082,2,39,1,36,34,112,2022-05-12 20:53:22.822648
39083,6,57,12,82,60,217,2022-05-12 20:53:24.12163
39087,7,113,1,13,26,160,2022-05-12 20:53:27.190385
39088,5,144,3,16,45,213,2022-05-12 20:53:28.466272
39089,7,153,3,11,60,234,2022-05-12 20:53:29.563664
39091,19,0,7,24,39,89,2022-05-12 20:53:31.708358
39093,125,3596,44,68,1224,5057,2022-05-12 20:53:33.807881
39096,2,181,1,20,27,231,2022-05-12 20:53:39.825765
39097,3,157,2,10,31,203,2022-05-12 20:53:40.953576
39098,3,131,2,15,31,182,2022-05-12 20:53:41.968622
39099,6,76,3,17,31,133,2022-05-12 20:53:43.150023
39101,8,71,7,27,93,206,2022-05-12 20:53:44.178618
39103,1,10,2,30,25,68,2022-05-12 20:53:46.359768
39104,2,18,2,30,29,81,2022-05-12 20:53:47.302018
39105,11,147,8,35,173,374,2022-05-12 20:53:48.555747
39107,17,180,10,31,198,436,2022-05-12 20:53:51.098683
39108,11,164,9,26,149,359,2022-05-12 20:53:52.452283
39109,6,66,7,43,104,226,2022-05-12 20:53:53.481109
39110,0,0,0,0,233,233,2022-05-12 20:53:54.521564
39112,542,20683,120,181,2945,24471,2022-05-12 20:53:55.591663
39113,39,3915,16,32,289,4291,2022-05-12 20:53:57.958826
39115,74,1200,41,61,689,2065,2022-05-12 20:54:03.051289
39117,14,78,9,38,159,298,2022-05-12 20:54:04.928791
39121,4,24,1,31,33,93,2022-05-12 20:54:07.526384
39122,4,30,1,31,32,98,2022-05-12 20:54:08.541547
39123,2,23,2,33,34,94,2022-05-12 20:54:09.557001
39124,2,24,1,31,34,92,2022-05-12 20:54:10.516838
39125,3,26,1,34,35,99,2022-05-12 20:54:11.528293
39126,3,25,1,30,35,94,2022-05-12 20:54:12.467227
39129,3,56,2,31,35,127,2022-05-12 20:54:16.939701
39130,4,27,2,33,37,103,2022-05-12 20:54:18.42713
39132,3,35,2,37,35,112,2022-05-12 20:54:20.262629
39133,3,25,1,27,31,87,2022-05-12 20:54:21.793778
39135,2,33,2,29,32,98,2022-05-12 20:54:22.97235
39136,5,24,1,32,34,96,2022-05-12 20:54:23.988901
39138,4,25,2,38,38,107,2022-05-12 20:54:25.881599
39139,3,24,1,28,34,90,2022-05-12 20:54:27.447244
39140,4,32,2,42,46,126,2022-05-12 20:54:28.544634
39144,2,13,1,36,28,80,2022-05-12 20:54:30.718265
39148,1,19,2,30,36,88,2022-05-12 20:54:33.364111
39149,2,11,2,32,31,78,2022-05-12 20:54:34.876838
39150,22,1219,10,23,134,1408,2022-05-12 20:54:36.703464
39151,2,37,1,20,31,91,2022-05-12 20:54:37.725881
39152,2,12,2,35,29,80,2022-05-12 20:54:38.750012
39153,3,36,4,24,58,125,2022-05-12 20:54:39.762266
39155,1,8,3,32,31,75,2022-05-12 20:54:42.047071
39166,452,6629,191,63,9783,17118,2022-05-12 20:54:45.856726
39173,2,233,3,13,39,290,2022-05-12 20:54:48.499093
39174,9,410,3,11,52,485,2022-05-12 20:54:49.984452
39175,3144,107921,918,614,45300,157897,2022-05-12 20:54:50.322835
39179,10,217,2,17,68,314,2022-05-12 20:54:53.782487
39182,15,181,1,21,51,269,2022-05-12 20:54:57.209296
39189,2,12,2,23,32,71,2022-05-12 20:55:07.745151
39194,1032,4084,427,1512,3437,10492,2022-05-12 20:55:14.617793
39195,35644,537550,14413,20953,113900,722460,2022-05-12 20:55:15.054236
39196,35178,231871,10628,11188,66158,355023,2022-05-12 20:55:15.212921
39197,7,140,4,30,68,249,2022-05-12 20:55:17.454365
39198,15892,147138,5904,7881,80856,257671,2022-05-12 20:55:17.630017
39202,4,109,1,10,26,150,2022-05-12 20:55:25.627871
39204,7,491,2,14,53,567,2022-05-12 20:55:29.29741
39205,25,7,15,39,58,144,2022-05-12 20:55:31.552646
39207,7,146,1,17,50,221,2022-05-12 20:55:33.194223
39208,7,370,4,31,68,480,2022-05-12 20:55:33.654819
39209,5,139,1,11,36,192,2022-05-12 20:55:34.62424
39213,4,158,1,14,22,199,2022-05-12 20:55:36.128783
39216,3,214,2,14,40,273,2022-05-12 20:55:37.530779
39219,8,135,1,9,31,184,2022-05-12 20:55:39.314701
39220,8,111,2,19,45,185,2022-05-12 20:55:40.9454
39221,5489,19832,2714,9585,25474,63094,2022-05-12 20:55:41.203234
39222,138,0,74,63,286,561,2022-05-12 20:55:42.866049
39223,335,450,52,74,1589,2500,2022-05-12 20:55:45.19743
39224,6,196,5,19,91,317,2022-05-12 20:55:45.517061
39226,20,262,13,39,275,609,2022-05-12 20:55:48.014464
39227,16,295,16,44,264,635,2022-05-12 20:55:49.564461
39229,2,13,3,29,25,72,2022-05-12 20:55:53.055385
39231,126,448,45,99,666,1384,2022-05-12 20:55:54.969647
39239,765,28725,331,474,7854,38149,2022-05-12 20:56:00.4822
39243,9,350,4,15,56,434,2022-05-12 20:56:03.247501
39245,3,117,2,13,27,162,2022-05-12 20:56:07.318768
39247,55785,223300,7728,4262,142119,433194,2022-05-12 20:56:07.517896
39250,43,530,15,63,642,1293,2022-05-12 20:56:12.207195
39251,2,139,0,13,36,190,2022-05-12 20:56:13.53244
39252,9,278,6,18,83,394,2022-05-12 20:56:15.35747
39255,3,18,4,33,30,88,2022-05-12 20:56:19.401662
39256,2,13,2,29,29,75,2022-05-12 20:56:20.941483
39257,49,2982,20,56,425,3532,2022-05-12 20:56:23.500529
39258,6,350,4,21,54,435,2022-05-12 20:56:24.956318
39259,3,194,0,15,53,265,2022-05-12 20:56:26.113157
39260,1,13,2,29,41,86,2022-05-12 20:56:27.474572
39261,1,13,2,29,40,85,2022-05-12 20:56:28.559021
39262,2,14,2,30,34,82,2022-05-12 20:56:30.050031
39263,1,13,3,30,30,77,2022-05-12 20:56:31.577583
39264,36,548,31,43,492,1150,2022-05-12 20:56:33.513263
39265,2,10,1,33,32,78,2022-05-12 20:56:34.459383
39271,8,112,7,29,85,241,2022-05-12 20:56:35.542314
39273,8,121,2,18,55,204,2022-05-12 20:56:37.001768
39274,200,9934,96,171,3057,13458,2022-05-12 20:56:38.571655
39275,9,157,3,9,35,213,2022-05-12 20:56:38.988741
39277,169,1180,102,175,904,2530,2022-05-12 20:56:40.973383
39279,9,145,2,19,89,264,2022-05-12 20:56:42.063699
39281,12,405,2,13,52,484,2022-05-12 20:56:43.264364
39282,681,3765,241,506,1873,7066,2022-05-12 20:56:43.438388
39284,11,452,5,22,127,617,2022-05-12 20:56:44.946782
39285,4,223,2,17,31,277,2022-05-12 20:56:46.101436
39286,6,386,1,32,61,486,2022-05-12 20:56:47.428464
39288,11,492,1,13,69,586,2022-05-12 20:56:49.068149
39290,31,1976,10,27,395,2439,2022-05-12 20:56:51.506066
39292,27368,112612,9616,15718,67490,232804,2022-05-12 20:56:54.631136
39294,4,145,0,8,31,188,2022-05-12 20:56:57.731105
39295,36,370,25,50,313,794,2022-05-12 20:56:59.327374
39296,3,148,1,9,22,183,2022-05-12 20:57:00.437414
39305,4,144,0,16,34,198,2022-05-12 20:57:03.917438
39306,6,133,0,15,56,210,2022-05-12 20:57:05.712887
39307,3,11,1,34,27,76,2022-05-12 20:57:06.643547
39308,2,13,2,35,30,82,2022-05-12 20:57:08.233887
39310,15,53,4,28,133,233,2022-05-12 20:57:10.196635
39314,15,491,7,15,112,640,2022-05-12 20:57:12.043752
39315,33,306,16,40,273,668,2022-05-12 20:57:13.549712
39316,51,531,36,64,616,1298,2022-05-12 20:57:15.292346
39320,3,206,4,10,35,258,2022-05-12 20:57:16.748108
39321,4,213,3,7,43,270,2022-05-12 20:57:18.421388
39322,7,176,2,12,55,252,2022-05-12 20:57:19.611694
39323,20,355,13,24,227,639,2022-05-12 20:57:21.318228
39324,16620,105407,6244,13822,39048,181141,2022-05-12 20:57:21.759705
39326,19077,161518,5957,12700,68089,267341,2022-05-12 20:57:22.344848
39329,57,366,39,66,758,1286,2022-05-12 20:57:24.357321
43977,0,2,0,9,8,19,2022-05-12 21:47:23.371009
39330,3,126,1,9,22,161,2022-05-12 20:57:25.529317
39360,15,127,8,34,177,361,2022-05-12 20:57:31.274922
39363,28,432,17,45,319,841,2022-05-12 20:57:37.515181
39364,26,32,18,16,281,373,2022-05-12 20:57:38.93456
39367,2,17,3,32,36,90,2022-05-12 20:57:40.0991
39368,7,71,10,37,177,302,2022-05-12 20:57:41.291563
39370,5,82,4,33,70,194,2022-05-12 20:57:43.089621
39372,8,54,9,33,59,163,2022-05-12 20:57:45.444679
39373,2,17,4,31,36,90,2022-05-12 20:57:46.96035
39375,3,20,6,27,36,92,2022-05-12 20:57:49.830823
39376,5,31,6,30,48,120,2022-05-12 20:57:50.826493
39378,2,13,2,31,41,89,2022-05-12 20:57:53.485622
39381,1,15,6,42,32,96,2022-05-12 20:57:57.513922
39382,108,2845,54,75,2132,5214,2022-05-12 20:57:58.460836
39384,3,17,3,33,31,87,2022-05-12 20:58:00.088895
39385,3,101,2,9,56,171,2022-05-12 20:58:01.945715
39388,7389,29672,3713,8469,27122,76365,2022-05-12 20:58:02.274266
39394,3,207,3,10,30,253,2022-05-12 20:58:05.359389
39396,4,214,3,8,31,260,2022-05-12 20:58:07.803256
39397,524,8874,176,187,3626,13387,2022-05-12 20:58:11.172839
39401,12,90,11,30,148,291,2022-05-12 20:58:12.403664
39403,2,10,3,33,25,73,2022-05-12 20:58:13.408423
39404,1,10,4,35,27,77,2022-05-12 20:58:15.165974
39405,2,12,3,30,35,82,2022-05-12 20:58:16.470523
39408,2,14,2,39,32,89,2022-05-12 20:58:20.459436
39409,2,13,2,35,32,84,2022-05-12 20:58:21.578812
39410,37,57,19,49,133,295,2022-05-12 20:58:22.812451
39412,5,32,7,35,68,147,2022-05-12 20:58:23.966065
39413,10,104,5,45,99,263,2022-05-12 20:58:25.161249
39414,60,122,39,47,653,921,2022-05-12 20:58:26.756939
39415,75,598,24,66,441,1204,2022-05-12 20:58:28.673876
39416,96,850,49,59,870,1924,2022-05-12 20:58:29.085776
39417,4219,17482,2107,7030,17457,48295,2022-05-12 20:58:31.898234
39421,1144,2340,371,672,4402,8929,2022-05-12 20:58:35.145646
39426,2,18,3,34,30,87,2022-05-12 20:58:36.180493
39427,1,10,3,34,34,82,2022-05-12 20:58:37.35451
39428,3,10,2,40,31,86,2022-05-12 20:58:38.526849
39429,98,796,75,64,1358,2391,2022-05-12 20:58:40.543791
39431,7,247,9,40,73,376,2022-05-12 20:58:43.203782
39435,2,29,4,37,71,143,2022-05-12 20:58:44.832627
39448,17,236,22,43,197,515,2022-05-12 20:58:47.115977
39449,122,138,4,15,97,376,2022-05-12 20:58:48.311771
39450,7,68,5,52,62,194,2022-05-12 20:58:49.839532
39453,2,11,4,37,32,86,2022-05-12 20:58:54.842725
39455,3,44,3,39,32,121,2022-05-12 20:58:56.437117
39456,10900,78396,3566,10127,34936,137925,2022-05-12 20:58:58.820172
39463,39778,215083,12155,27362,109568,403946,2022-05-12 20:59:01.980921
39464,13,202,7,30,177,429,2022-05-12 20:59:03.396032
39468,14319,147124,4253,5590,56787,228073,2022-05-12 20:59:04.459816
39474,0,0,0,0,201,201,2022-05-12 20:59:07.186791
39478,837,4319,516,587,11033,17292,2022-05-12 20:59:10.639805
39488,2,9,2,29,26,68,2022-05-12 20:59:13.420009
39489,0,0,0,1,9231,9232,2022-05-12 20:59:13.626876
39491,14189,89062,6611,5365,115771,230998,2022-05-12 20:59:17.242634
39495,1407,17599,340,100,19382,38828,2022-05-12 20:59:21.009515
39499,1,126,1,14,20,162,2022-05-12 20:59:24.168174
39506,2667,6413,898,1901,10263,22142,2022-05-12 20:59:34.442775
39507,2,9,3,27,25,66,2022-05-12 20:59:36.061635
39511,39,2562,19,26,274,2920,2022-05-12 20:59:38.206711
39513,5,135,1,11,31,183,2022-05-12 20:59:39.313494
39514,29,268,28,31,470,826,2022-05-12 20:59:40.904158
39517,4,129,0,10,24,167,2022-05-12 20:59:41.320604
39518,5,0,0,0,15230,15235,2022-05-12 20:59:41.485071
39519,887,13736,278,1124,4968,20993,2022-05-12 20:59:44.544514
39523,16817,140820,4940,16028,40585,219190,2022-05-12 20:59:45.424486
39527,1200,4785,498,3454,7954,17891,2022-05-12 20:59:48.758643
39528,4,28,3,60,55,150,2022-05-12 20:59:50.322627
39531,2209,14947,1056,2501,18262,38975,2022-05-12 20:59:56.873989
39533,23726,316650,8212,9642,103118,461348,2022-05-12 20:59:57.2235
39534,45422,268863,19816,20101,123854,478056,2022-05-12 20:59:57.456618
39535,93285,649537,9800,11832,157083,921537,2022-05-12 20:59:57.864777
39544,4,107,0,7,26,144,2022-05-12 21:00:07.933486
39546,18,0,6,33,50,107,2022-05-12 21:00:10.520415
39547,47481,376198,13063,7756,152917,597415,2022-05-12 21:00:10.984523
39549,3,238,1,14,41,297,2022-05-12 21:00:13.898392
39551,69271,498593,6833,4696,143854,723247,2022-05-12 21:00:14.256353
39555,3784,109807,1003,893,21375,136862,2022-05-12 21:00:14.664785
39559,75,19,27,51,420,592,2022-05-12 21:00:16.273001
39560,4,163,3,8,33,211,2022-05-12 21:00:18.168626
39564,10,179,2,33,56,280,2022-05-12 21:00:20.750083
39565,6400,364445,1777,931,87346,460899,2022-05-12 21:00:21.026579
39566,8,142,0,26,50,226,2022-05-12 21:00:22.843759
39567,4410,15525,1886,6694,15009,43524,2022-05-12 21:00:26.712679
39568,6,344,2,17,47,416,2022-05-12 21:00:28.825598
39570,5163,82328,2095,1533,25028,116147,2022-05-12 21:00:32.535277
39572,125,260,52,77,861,1375,2022-05-12 21:00:35.948512
44005,1,37,0,25,32,95,2022-05-12 21:47:45.440286
39575,27555,115050,12485,13671,83058,251819,2022-05-12 21:00:45.12175
39576,4222,128749,1516,656,77395,212538,2022-05-12 21:00:45.549809
39581,109,479,40,218,348,1194,2022-05-12 21:00:47.755574
39583,4541,19283,1876,4018,22137,51855,2022-05-12 21:00:51.967002
39585,157,1925,96,102,6576,8856,2022-05-12 21:00:55.597371
39586,23794,86516,8695,5847,105631,230483,2022-05-12 21:00:58.278501
39587,86845,614997,18117,10731,187348,918038,2022-05-12 21:00:58.490477
39589,210,207,88,89,1413,2007,2022-05-12 21:01:03.85266
39591,498,6162,252,144,5019,12075,2022-05-12 21:01:11.027251
39592,905,9552,373,305,5508,16643,2022-05-12 21:01:14.494862
39597,32851,485892,7811,8029,91845,626428,2022-05-12 21:01:16.738054
39605,591,6482,289,206,7710,15278,2022-05-12 21:01:19.605826
39606,424,12295,157,100,3807,16783,2022-05-12 21:01:20.022424
39609,2875,10450,1072,2101,16963,33461,2022-05-12 21:01:24.576804
39610,283,7568,144,106,6246,14347,2022-05-12 21:01:27.451787
39611,29,47,21,50,124,271,2022-05-12 21:01:28.839724
39616,3,126,3,12,25,169,2022-05-12 21:01:30.142606
39617,112407,350868,22793,107755,200932,794755,2022-05-12 21:01:30.463405
39618,7,128,4,28,63,230,2022-05-12 21:01:32.96785
39620,172,1264,76,724,519,2755,2022-05-12 21:01:36.868701
39622,531,2596,231,926,1632,5916,2022-05-12 21:01:43.795334
39623,10,773,3,19,62,867,2022-05-12 21:01:45.579898
39624,3,7,1,32,26,69,2022-05-12 21:01:46.821457
39629,68,112,15,51,306,552,2022-05-12 21:01:54.850009
39638,4161,6,942,190,5709,11008,2022-05-12 21:01:58.838661
39643,305,1053,138,168,1126,2790,2022-05-12 21:02:01.343929
39644,6,136,3,12,64,221,2022-05-12 21:02:02.873223
39650,54,108,24,80,101,367,2022-05-12 21:02:04.093774
39651,1012,61211,437,162,14656,77478,2022-05-12 21:02:08.106424
39652,1452,36600,514,666,14131,53363,2022-05-12 21:02:08.516826
39653,402,1,185,133,911,1632,2022-05-12 21:02:08.681277
39659,95,0,69,56,311,531,2022-05-12 21:02:12.758542
39664,6,29,7,46,51,139,2022-05-12 21:02:15.919305
39668,162,172,68,181,1578,2161,2022-05-12 21:02:18.204946
39674,210,3358,80,92,1367,5107,2022-05-12 21:02:20.707682
39675,540,970,117,216,1999,3842,2022-05-12 21:02:23.63886
39676,176,490,71,139,905,1781,2022-05-12 21:02:25.773335
39677,17,41,4,45,205,312,2022-05-12 21:02:26.994439
39679,52,52,34,59,183,380,2022-05-12 21:02:28.014428
39681,3122,11907,952,1198,11035,28214,2022-05-12 21:02:30.984918
39682,4,112,2,15,21,154,2022-05-12 21:02:32.094394
39684,12,529,4,14,133,692,2022-05-12 21:02:33.583868
39686,3,21,1,21,35,81,2022-05-12 21:02:35.867587
39689,875,38817,283,214,9938,50127,2022-05-12 21:02:36.05948
39690,9,170,4,16,72,271,2022-05-12 21:02:38.019417
39694,14,192,2,18,58,284,2022-05-12 21:02:41.028397
39696,7,144,4,32,94,281,2022-05-12 21:02:42.803784
39697,9,190,6,37,106,348,2022-05-12 21:02:43.865897
39699,308,1422,164,368,2512,4774,2022-05-12 21:02:46.333366
39700,6,215,5,12,54,292,2022-05-12 21:02:48.169153
39701,49724,420722,14772,47177,83823,616218,2022-05-12 21:02:48.352584
39704,3,161,3,10,52,229,2022-05-12 21:02:53.077113
39705,6696,66535,2360,904,30705,107200,2022-05-12 21:02:53.550575
39706,3,161,3,12,33,212,2022-05-12 21:02:55.053359
44018,0,3,0,7,8,18,2022-05-12 21:47:59.549532
39707,13,200,5,28,116,362,2022-05-12 21:02:56.078671
39709,137,755,92,63,1736,2783,2022-05-12 21:03:01.107271
39710,24419,138376,8216,14713,84304,270028,2022-05-12 21:03:01.693128
39711,11,68,2,40,73,194,2022-05-12 21:03:03.07553
39714,2,192,1,13,30,238,2022-05-12 21:03:04.313462
39718,5,128,3,13,38,187,2022-05-12 21:03:08.350034
39720,58,116,16,45,198,433,2022-05-12 21:03:10.033188
39721,119,2477,103,130,1652,4481,2022-05-12 21:03:12.595623
39725,1676,3927,593,1452,6636,14284,2022-05-12 21:03:16.009255
39727,0,50,2,2,9,63,2022-05-12 21:03:16.943371
39730,5296,23913,2151,2863,18932,53155,2022-05-12 21:03:23.092417
39736,324,228,131,163,1793,2639,2022-05-12 21:03:32.79484
39741,6096,244672,2168,678,76335,329949,2022-05-12 21:03:35.715705
39753,2015,20072,712,287,36434,59520,2022-05-12 21:03:40.803467
39754,60,42,16,41,160,319,2022-05-12 21:03:42.668762
39759,3,17,3,33,36,92,2022-05-12 21:03:45.697458
39760,34,418,15,28,301,796,2022-05-12 21:03:47.493431
39763,0,0,0,0,1746,1746,2022-05-12 21:03:53.453736
39764,316,6395,141,91,7265,14208,2022-05-12 21:03:53.663464
39766,14,149,4,9,96,272,2022-05-12 21:03:55.126466
39767,55,253,20,54,278,660,2022-05-12 21:03:56.732979
39769,16,1492,3,25,127,1663,2022-05-12 21:03:57.83783
39778,5,35,4,24,50,118,2022-05-12 21:03:58.943806
39780,14,585,6,19,129,753,2022-05-12 21:04:00.576416
44019,0,1,1,7,9,18,2022-05-12 21:48:00.364346
39783,49724,374851,8407,6459,112487,551928,2022-05-12 21:04:05.243323
39787,3,90,0,10,24,127,2022-05-12 21:04:09.473778
39790,15434,64789,6293,8343,62496,157355,2022-05-12 21:04:09.746345
39792,34401,122857,17222,14497,100302,289279,2022-05-12 21:04:10.149039
39793,12,569,6,15,118,720,2022-05-12 21:04:11.890307
39799,8468,35326,2808,10238,26653,83493,2022-05-12 21:04:15.343563
39805,13,97,7,20,195,332,2022-05-12 21:04:15.626044
39806,9067,22535,4492,6400,25902,68396,2022-05-12 21:04:19.285834
39808,9013,41574,2255,1040,47211,101093,2022-05-12 21:04:19.720253
39810,56,388,25,58,507,1034,2022-05-12 21:04:21.634635
39811,2867,19422,1193,2476,16900,42858,2022-05-12 21:04:24.232685
39812,7,163,3,10,34,217,2022-05-12 21:04:25.629723
39819,2560,37669,863,345,16699,58136,2022-05-12 21:04:29.956196
39820,18,62,9,108,70,267,2022-05-12 21:04:31.755855
39823,172,186,27,82,547,1014,2022-05-12 21:04:33.799721
39826,95,2713,43,94,974,3919,2022-05-12 21:04:36.052355
39827,7,67,2,32,50,158,2022-05-12 21:04:37.348566
39833,28,295,13,31,338,705,2022-05-12 21:04:41.642458
39836,878,9997,318,505,5742,17440,2022-05-12 21:04:42.075931
39839,22,37,10,67,102,238,2022-05-12 21:04:43.7061
39840,45,411,12,38,328,834,2022-05-12 21:04:45.31009
39841,7,165,2,17,64,255,2022-05-12 21:04:46.660414
39846,230,3057,107,97,3765,7256,2022-05-12 21:04:49.026981
39849,150,930,64,189,342,1675,2022-05-12 21:04:51.15539
39851,65,52,23,42,756,938,2022-05-12 21:04:52.899672
39854,8,126,1,16,40,191,2022-05-12 21:04:54.098685
39856,7,319,1,16,52,395,2022-05-12 21:04:57.537732
39857,5,82,0,9,18,114,2022-05-12 21:04:58.766834
39862,7,95,0,27,82,211,2022-05-12 21:05:02.831458
39864,738,970,329,174,2248,4459,2022-05-12 21:05:05.15039
39870,3,78,0,11,20,112,2022-05-12 21:05:07.339924
39872,16,594,3,22,123,758,2022-05-12 21:05:09.114368
39874,5,169,3,20,38,235,2022-05-12 21:05:10.060557
39875,54,1795,21,45,489,2404,2022-05-12 21:05:11.876904
39877,5,134,1,16,38,194,2022-05-12 21:05:14.269741
39884,135,1772,42,67,1241,3257,2022-05-12 21:05:16.298759
39885,21,292,11,35,239,598,2022-05-12 21:05:18.003708
39886,4,130,1,17,33,185,2022-05-12 21:05:19.435361
39890,5,276,2,17,44,344,2022-05-12 21:05:24.343707
39891,4,92,0,12,21,129,2022-05-12 21:05:25.337979
39893,643,1586,165,1180,1700,5274,2022-05-12 21:05:26.274977
39895,3,63,2,19,26,113,2022-05-12 21:05:33.220276
39900,1,128,0,11,26,166,2022-05-12 21:05:35.61159
39901,2,120,0,13,27,162,2022-05-12 21:05:36.626284
39905,0,0,0,0,4203,4203,2022-05-12 21:05:39.50105
39911,4,113,1,18,22,158,2022-05-12 21:05:42.868112
39917,589,695,104,1497,1970,4855,2022-05-12 21:05:46.495885
39918,57,181,30,54,292,614,2022-05-12 21:05:47.977626
39922,3,122,2,10,21,158,2022-05-12 21:05:55.593672
39923,4,103,0,10,19,136,2022-05-12 21:05:56.812882
39925,3,95,0,10,20,128,2022-05-12 21:05:57.862874
39931,35,148,30,63,829,1105,2022-05-12 21:06:00.412134
39935,295,1467,30,53,4424,6269,2022-05-12 21:06:00.602622
39936,11,180,14,47,137,389,2022-05-12 21:06:03.087814
39939,2,139,2,9,27,179,2022-05-12 21:06:05.539531
39947,5,122,3,11,30,171,2022-05-12 21:06:15.393675
39948,1699,7667,589,754,12292,23001,2022-05-12 21:06:18.152411
39959,1298,20638,424,322,9095,31777,2022-05-12 21:06:23.856212
39962,22,1053,13,26,253,1367,2022-05-12 21:06:29.155255
39963,1511,13648,471,1136,8332,25098,2022-05-12 21:06:29.606437
39966,2504,9717,978,5285,11020,29504,2022-05-12 21:06:29.85261
39967,28,286,14,44,651,1023,2022-05-12 21:06:31.644445
39972,208,4536,82,91,3280,8197,2022-05-12 21:06:34.670498
39975,16,874,9,14,94,1007,2022-05-12 21:06:36.434262
39979,282,415,246,459,2039,3441,2022-05-12 21:06:40.5675
39987,184,1806,105,104,2936,5135,2022-05-12 21:06:42.919535
39988,12881,148948,4398,3550,33315,203092,2022-05-12 21:06:43.097506
39989,128,5717,48,109,1149,7151,2022-05-12 21:06:46.005733
39990,3786,5415,1421,4057,15090,29769,2022-05-12 21:06:47.050564
39991,336,18348,131,69,4367,23251,2022-05-12 21:06:50.096459
39994,8,100,6,15,38,167,2022-05-12 21:06:54.459564
39995,570,5313,181,97,5404,11565,2022-05-12 21:06:58.055524
39996,5,244,1,17,37,304,2022-05-12 21:06:59.285614
39997,4,213,3,19,43,282,2022-05-12 21:07:00.76954
40001,18,416,3,25,107,569,2022-05-12 21:07:06.079154
40002,13,240,5,28,87,373,2022-05-12 21:07:07.366735
40003,9,182,4,24,42,261,2022-05-12 21:07:08.500836
40004,14173,183206,4354,4391,47551,253675,2022-05-12 21:07:08.900104
40005,1672,18155,353,350,6077,26607,2022-05-12 21:07:09.301607
40010,76625,223957,13751,24873,72146,411352,2022-05-12 21:07:15.193384
40014,60,452,31,53,611,1207,2022-05-12 21:07:19.916298
40015,10,167,2,35,61,275,2022-05-12 21:07:21.656614
40016,7,193,1,37,56,294,2022-05-12 21:07:23.454332
40028,302992,1076475,20446,10939,158643,1569495,2022-05-12 21:07:29.141373
40029,46,0,15,46,66,173,2022-05-12 21:07:31.837498
40030,4,59,5,41,42,151,2022-05-12 21:07:32.972576
40031,880,7498,355,507,5214,14454,2022-05-12 21:07:36.67764
40033,9,216,6,28,66,325,2022-05-12 21:07:38.158222
40035,30,408,17,43,496,994,2022-05-12 21:07:41.103148
40036,24,39,15,38,407,523,2022-05-12 21:07:42.840308
40037,21,42,15,40,348,466,2022-05-12 21:07:45.608572
40042,21,164,9,13,129,336,2022-05-12 21:07:50.481785
40046,24075,149478,9960,12022,105474,301009,2022-05-12 21:07:54.06365
40052,60996,270302,26800,15831,151253,525182,2022-05-12 21:07:54.388266
40057,12,333,7,41,197,590,2022-05-12 21:08:07.818727
40058,3,132,1,18,22,176,2022-05-12 21:08:09.022058
40059,9162,70518,2346,961,41714,124701,2022-05-12 21:08:09.443512
40060,21994,197117,9081,10965,69556,308713,2022-05-12 21:08:12.807521
40066,88,677,25,51,1035,1876,2022-05-12 21:08:17.502388
40073,191,768,85,80,2098,3222,2022-05-12 21:08:19.993702
40075,5509,16496,2040,4606,21616,50267,2022-05-12 21:08:24.532669
40076,574,6182,231,165,6576,13728,2022-05-12 21:08:26.845556
40078,7,103,3,23,105,241,2022-05-12 21:08:28.060699
40080,1595,27081,401,295,11767,41139,2022-05-12 21:08:28.479453
40082,482,15761,160,132,8786,25321,2022-05-12 21:08:28.88513
40083,1862,39926,627,389,13792,56596,2022-05-12 21:08:31.612779
40085,842,2885,397,1802,4480,10406,2022-05-12 21:08:34.399212
40087,3,29,3,31,47,113,2022-05-12 21:08:36.052924
40089,187,18,7,133,108,453,2022-05-12 21:08:38.233556
40090,36,81,16,49,173,355,2022-05-12 21:08:39.577591
40092,8,67,6,47,90,218,2022-05-12 21:08:42.644867
40097,489,877,184,137,2051,3738,2022-05-12 21:08:45.386965
40102,913,22781,283,364,13248,37589,2022-05-12 21:08:50.917454
40103,8,36,4,44,84,176,2022-05-12 21:08:52.046858
40104,54,439,23,49,676,1241,2022-05-12 21:08:52.23478
40105,7,198,3,14,54,276,2022-05-12 21:08:54.040634
40106,8,178,1,17,39,243,2022-05-12 21:08:55.095758
40111,413,6823,117,136,3958,11447,2022-05-12 21:09:00.630686
40112,15,281,3,22,110,431,2022-05-12 21:09:02.160969
40117,42,244,11,46,212,555,2022-05-12 21:09:03.646398
40121,83,71,21,89,610,874,2022-05-12 21:09:05.935308
40128,9783,55378,4160,7659,34876,111856,2022-05-12 21:09:09.162672
40129,657,386,228,701,1985,3957,2022-05-12 21:09:11.587771
40136,1917,6703,851,3062,5998,18531,2022-05-12 21:09:16.973635
40139,8,224,5,17,103,357,2022-05-12 21:09:19.379558
40140,10,467,5,14,74,570,2022-05-12 21:09:21.049494
40141,19,25,7,70,74,195,2022-05-12 21:09:22.787661
40142,6,61,6,64,86,223,2022-05-12 21:09:24.538359
40143,43,1365,24,56,450,1938,2022-05-12 21:09:26.634483
40145,3020,1015,973,2313,7646,14967,2022-05-12 21:09:27.062851
40148,3044,15757,1394,3528,16439,40162,2022-05-12 21:09:28.683616
40152,149,1276,84,94,1232,2835,2022-05-12 21:09:31.494206
40153,10,194,7,19,92,322,2022-05-12 21:09:32.779941
40155,38,31,24,39,74,206,2022-05-12 21:09:34.354732
40158,9,209,3,20,55,296,2022-05-12 21:09:36.355367
40159,8,165,0,20,46,239,2022-05-12 21:09:37.414363
40164,6,142,1,11,39,199,2022-05-12 21:09:38.698385
40165,5663,15815,2349,14180,20289,58296,2022-05-12 21:09:40.888958
40171,12,206,1,20,82,321,2022-05-12 21:09:45.249413
40174,18620,74104,4988,3917,74417,176046,2022-05-12 21:09:49.810839
40176,484,16033,164,122,5560,22363,2022-05-12 21:09:53.353368
40178,1560,10130,685,2427,5758,20560,2022-05-12 21:09:55.716457
40179,47,753,32,66,428,1326,2022-05-12 21:09:58.035587
40180,70,1238,11,43,522,1884,2022-05-12 21:09:59.817387
40181,93,2125,68,111,1170,3567,2022-05-12 21:09:59.979411
40188,10,28,7,21,33,99,2022-05-12 21:10:04.992691
40196,3525,12151,1321,4403,13561,34961,2022-05-12 21:10:11.172065
40197,391,2954,147,754,915,5161,2022-05-12 21:10:13.464207
40202,5,203,2,19,47,276,2022-05-12 21:10:17.01611
40204,8,246,1,21,38,314,2022-05-12 21:10:18.096716
40205,8,124,3,15,89,239,2022-05-12 21:10:19.102556
40206,1237,45041,522,216,11433,58449,2022-05-12 21:10:22.375229
40209,6,169,1,13,48,237,2022-05-12 21:10:24.45643
40210,4,150,5,15,25,199,2022-05-12 21:10:25.57015
40211,749,5997,206,171,8456,15579,2022-05-12 21:10:25.970768
40215,1595,59202,539,315,8643,70294,2022-05-12 21:10:29.067971
40221,70702,525060,15682,22629,128985,763058,2022-05-12 21:10:29.342999
40222,14,554,5,20,125,718,2022-05-12 21:10:31.68074
40228,680,8195,304,443,3197,12819,2022-05-12 21:10:37.564285
40237,9,180,1,22,71,283,2022-05-12 21:10:46.494584
40238,14,142,6,39,249,450,2022-05-12 21:10:47.691132
40239,759,23358,210,444,4731,29502,2022-05-12 21:10:48.115226
40242,0,0,0,0,606,606,2022-05-12 21:10:49.728148
40244,4,81,7,23,88,203,2022-05-12 21:10:51.586046
40245,74,1889,28,39,1149,3179,2022-05-12 21:10:53.624728
40246,148,2218,67,58,1857,4348,2022-05-12 21:10:56.629483
40249,242,69,20,120,536,987,2022-05-12 21:10:58.324547
40250,17,188,19,42,305,571,2022-05-12 21:10:59.831216
40251,35,409,32,38,544,1058,2022-05-12 21:11:01.457398
40254,1951,14391,583,1410,11957,30292,2022-05-12 21:11:03.090785
40262,4063,203057,1164,578,36692,245554,2022-05-12 21:11:07.177638
40267,1391,1644,437,1032,13943,18447,2022-05-12 21:11:12.592751
40269,2135,62213,541,490,9692,75071,2022-05-12 21:11:12.803076
40272,1112,6649,431,532,10145,18869,2022-05-12 21:11:15.701385
40273,6,34,3,29,43,115,2022-05-12 21:11:16.821071
40280,361,4325,202,107,4485,9480,2022-05-12 21:11:19.871069
40282,8,933,6,38,96,1081,2022-05-12 21:11:21.74835
40283,5,167,6,13,41,232,2022-05-12 21:11:23.823208
40286,9,356,6,14,49,434,2022-05-12 21:11:25.076739
40291,23,792,10,33,140,998,2022-05-12 21:11:27.293348
40292,15,813,8,34,141,1011,2022-05-12 21:11:29.177986
40293,19,791,9,33,133,985,2022-05-12 21:11:30.84104
40294,18,696,11,32,131,888,2022-05-12 21:11:32.424565
40295,1016,16550,490,273,9521,27850,2022-05-12 21:11:34.872541
40297,5,121,3,9,26,164,2022-05-12 21:11:36.533642
40298,468,8287,191,281,5735,14962,2022-05-12 21:11:39.263811
40301,9,106,8,26,130,279,2022-05-12 21:11:41.617283
40302,9,116,6,21,90,242,2022-05-12 21:11:42.726287
40304,2,114,2,9,19,146,2022-05-12 21:11:43.797949
40312,7,750,5,15,39,816,2022-05-12 21:11:45.409615
40314,446,9807,183,148,11367,21951,2022-05-12 21:11:48.783563
40320,651,1824,173,928,4248,7824,2022-05-12 21:11:56.379967
40321,110,643,102,80,3139,4074,2022-05-12 21:11:59.217793
40323,652,5630,219,167,6378,13046,2022-05-12 21:12:02.403393
40327,1053,884,449,586,3385,6357,2022-05-12 21:12:05.317241
40329,34,542,24,57,722,1379,2022-05-12 21:12:07.284627
40331,150,2980,69,75,3800,7074,2022-05-12 21:12:07.455325
40332,626,11565,205,292,6394,19082,2022-05-12 21:12:10.190688
40333,2,1,1,0,70020,70024,2022-05-12 21:12:10.438156
40334,179,2961,173,154,2661,6128,2022-05-12 21:12:12.729164
40340,52,552,21,47,546,1218,2022-05-12 21:12:19.080352
40341,7,145,5,17,99,273,2022-05-12 21:12:20.982956
40342,4,78,10,52,101,245,2022-05-12 21:12:22.202528
40344,10,1410,3,17,79,1519,2022-05-12 21:12:24.447193
40346,3,127,2,12,33,177,2022-05-12 21:12:26.461185
40348,37,682,21,39,280,1059,2022-05-12 21:12:28.533489
40349,2,170,5,14,45,236,2022-05-12 21:12:29.773558
40351,34381,3,8724,6632,13413,63153,2022-05-12 21:12:30.54949
40353,4,162,3,10,34,213,2022-05-12 21:12:31.933634
40356,174116,47,3129,5418,343908,526618,2022-05-12 21:12:32.130552
40375,24,412,5,36,132,609,2022-05-12 21:12:36.294609
40376,31,76,4,48,141,300,2022-05-12 21:12:37.638102
40377,13,154,12,34,265,478,2022-05-12 21:12:39.425698
40378,7,192,3,10,28,240,2022-05-12 21:12:41.441594
40379,618,4011,283,311,6795,12018,2022-05-12 21:12:44.575957
40383,4,109,2,18,35,168,2022-05-12 21:12:46.227495
40385,4,145,1,39,60,249,2022-05-12 21:12:47.548587
40386,0,0,0,0,0,0,2022-05-12 21:12:49.235335
40389,156,464,63,36,3487,4206,2022-05-12 21:12:51.514212
40392,8472,54370,3442,4386,40384,111054,2022-05-12 21:12:54.409816
40393,28,0,21,44,96,189,2022-05-12 21:12:54.571476
40394,423,3157,110,113,2618,6421,2022-05-12 21:12:56.908352
40395,13,207,13,33,130,396,2022-05-12 21:12:58.849601
40403,1601,3904,631,2639,8014,16789,2022-05-12 21:13:04.366115
40405,144,3461,70,136,1309,5120,2022-05-12 21:13:07.056492
40407,2,32,4,25,50,113,2022-05-12 21:13:09.495698
40410,12,613,8,9,149,791,2022-05-12 21:13:12.988931
40414,9,269,4,9,38,329,2022-05-12 21:13:16.021378
40415,5,105,3,7,56,176,2022-05-12 21:13:17.204804
40416,2177,42200,797,277,40446,85897,2022-05-12 21:13:20.075438
40417,43903,226320,12870,5748,105444,394285,2022-05-12 21:13:20.502162
40421,2948,128000,866,476,51630,183920,2022-05-12 21:13:20.747176
40423,35,72,16,112,233,468,2022-05-12 21:13:22.348848
40425,2,42,6,35,206,291,2022-05-12 21:13:23.687399
40427,2,58,1,12,34,107,2022-05-12 21:13:25.910467
40429,294,9283,148,95,7424,17244,2022-05-12 21:13:26.086314
40430,9,166,1,28,42,246,2022-05-12 21:13:27.864578
40434,6230,16279,857,504,31160,55030,2022-05-12 21:13:30.328187
40435,2806,7329,595,402,7326,18458,2022-05-12 21:13:33.699932
40436,18114,77492,4230,19173,40358,159367,2022-05-12 21:13:34.122798
40437,34,55,15,45,137,286,2022-05-12 21:13:35.658413
40438,619,1345,242,489,2541,5236,2022-05-12 21:13:39.02044
40439,5,69,4,33,39,150,2022-05-12 21:13:40.616349
40441,6,168,3,16,26,219,2022-05-12 21:13:43.477099
40452,4,121,3,11,42,181,2022-05-12 21:13:45.057272
40453,1417,61575,485,289,17529,81295,2022-05-12 21:13:47.606197
40454,46152,291351,12464,10615,109220,469802,2022-05-12 21:13:48.56359
40455,4,30,4,24,45,107,2022-05-12 21:13:50.359178
40456,19812,906998,3170,1283,195983,1127246,2022-05-12 21:13:50.678641
40459,82,124,34,70,950,1260,2022-05-12 21:13:53.555805
40460,374,6901,155,110,7182,14722,2022-05-12 21:13:55.015093
40463,2,92,1,12,24,131,2022-05-12 21:13:57.070266
40464,123,643,41,69,1382,2258,2022-05-12 21:14:00.086547
40468,2,81,2,10,26,121,2022-05-12 21:14:01.620526
40469,27,614,26,25,250,942,2022-05-12 21:14:03.344493
40473,230,586,94,544,2909,4363,2022-05-12 21:14:05.433689
40475,9,197,1,18,72,297,2022-05-12 21:14:08.100639
40476,10,267,2,13,102,394,2022-05-12 21:14:09.934453
40477,236,3459,87,129,3115,7026,2022-05-12 21:14:13.81457
40478,7,80,8,33,80,208,2022-05-12 21:14:16.040581
40479,5,69,3,30,49,156,2022-05-12 21:14:17.13471
40480,55,1717,20,49,493,2334,2022-05-12 21:14:19.809755
40482,9,60,4,33,88,194,2022-05-12 21:14:21.034389
40483,13882,105299,4220,8215,39124,170740,2022-05-12 21:14:24.235186
40484,17,61,12,38,148,276,2022-05-12 21:14:26.241285
40485,12695,18540,3215,1876,33644,69970,2022-05-12 21:14:28.913623
40486,897,14391,352,180,8112,23932,2022-05-12 21:14:32.120452
40487,37,39,16,102,165,359,2022-05-12 21:14:33.393324
40488,4870,5081,636,4104,10730,25421,2022-05-12 21:14:33.558059
40489,1764,31672,447,689,10694,45266,2022-05-12 21:14:34.54241
40491,628,13212,150,131,5897,20018,2022-05-12 21:14:34.796704
40495,6,56,5,41,44,152,2022-05-12 21:14:36.124773
40496,47324,437393,8130,14952,82978,590777,2022-05-12 21:14:36.294819
40497,31209,163721,7164,8641,82519,293254,2022-05-12 21:14:41.613618
40499,8,138,0,10,34,190,2022-05-12 21:14:42.871628
40502,4,168,3,9,34,218,2022-05-12 21:14:45.099448
40504,2487,9520,570,492,5356,18425,2022-05-12 21:14:47.917009
40506,2680,1991,873,3026,4456,13026,2022-05-12 21:14:50.475227
40507,47572,77037,3408,5485,118783,252285,2022-05-12 21:14:50.656451
40508,7,154,2,18,46,227,2022-05-12 21:14:52.158741
40509,2,126,3,12,33,176,2022-05-12 21:14:53.509378
40515,4909,83538,2343,5924,33417,130131,2022-05-12 21:14:59.360084
40517,62,958,26,47,694,1787,2022-05-12 21:15:01.935203
40523,4,168,1,9,28,210,2022-05-12 21:15:04.718563
40526,6088,16344,1694,8173,14678,46977,2022-05-12 21:15:07.416579
40527,3,108,3,9,29,152,2022-05-12 21:15:08.870576
40529,5402,32477,2012,2460,27796,70147,2022-05-12 21:15:11.830474
40531,3,150,1,20,31,205,2022-05-12 21:15:16.043878
40532,12332,47408,5229,7428,44589,116986,2022-05-12 21:15:17.175739
40540,30473,361852,5617,7865,86693,492500,2022-05-12 21:15:19.112177
40542,5297,149259,1618,964,25308,182446,2022-05-12 21:15:23.309687
40543,32,113,16,39,377,577,2022-05-12 21:15:23.619221
40550,7578,26755,2729,7947,28782,73791,2022-05-12 21:15:26.413574
40553,2,34,3,28,25,92,2022-05-12 21:15:27.894516
40554,70,174,46,57,3135,3482,2022-05-12 21:15:28.322433
40555,4,146,2,7,29,188,2022-05-12 21:15:29.847853
40556,9,503,4,9,47,572,2022-05-12 21:15:31.661586
40557,7,492,5,7,61,572,2022-05-12 21:15:33.252384
40558,11,339,7,10,62,429,2022-05-12 21:15:34.562703
40560,6,437,4,14,65,526,2022-05-12 21:15:37.052466
40564,7,500,5,10,67,589,2022-05-12 21:15:40.85127
40568,53,252,16,44,426,791,2022-05-12 21:15:43.93478
40576,3,79,3,15,24,124,2022-05-12 21:15:51.180446
40582,3,74,3,14,31,125,2022-05-12 21:15:53.267905
40586,44957,145715,10290,22989,64953,288904,2022-05-12 21:15:54.510646
40587,53,757,34,67,1194,2105,2022-05-12 21:15:56.444484
40589,1,12,1,27,29,70,2022-05-12 21:15:57.64978
40590,0,0,0,0,12825,12825,2022-05-12 21:15:57.812534
40591,80799,792183,15532,8279,166188,1062981,2022-05-12 21:15:58.434789
40593,2,45,4,23,32,106,2022-05-12 21:15:59.566606
40595,24937,120722,6626,14735,58961,225981,2022-05-12 21:15:59.98036
40606,13,280,3,30,97,423,2022-05-12 21:16:02.428948
40608,4154,8298,863,3197,13549,30061,2022-05-12 21:16:02.62278
40620,28480,60951,6575,9014,56120,161140,2022-05-12 21:16:05.078588
40630,162,3204,57,61,1536,5020,2022-05-12 21:16:09.705261
40633,2,59,0,9,34,104,2022-05-12 21:16:14.195693
40636,13,80,7,42,229,371,2022-05-12 21:16:15.609462
40641,5,69,0,18,45,137,2022-05-12 21:16:18.431893
40642,2,125,0,11,74,212,2022-05-12 21:16:19.781537
40644,8,24,2,15,469,518,2022-05-12 21:16:22.198331
40645,7,151,0,35,88,281,2022-05-12 21:16:23.367484
40646,790,26301,184,160,13898,41333,2022-05-12 21:16:23.610602
40651,119,1702,43,112,920,2896,2022-05-12 21:16:26.110193
40655,4,108,1,11,22,146,2022-05-12 21:16:27.847053
40659,160,1415,71,81,1639,3366,2022-05-12 21:16:33.428655
40661,256,6357,80,72,2252,9017,2022-05-12 21:16:36.149487
40664,260,3388,117,91,5592,9448,2022-05-12 21:16:39.085991
40665,160,1939,84,75,2945,5203,2022-05-12 21:16:41.519736
40667,144,1032,73,76,1363,2688,2022-05-12 21:16:43.738643
40670,3,46,4,33,47,133,2022-05-12 21:16:44.877537
40671,2,38,2,31,45,118,2022-05-12 21:16:45.809645
40674,3,13,3,32,47,98,2022-05-12 21:16:49.067561
40677,895,3453,457,734,4657,10196,2022-05-12 21:16:50.534699
40679,14328,36294,5120,14068,28660,98470,2022-05-12 21:16:53.435932
40682,15355,18812,2243,1243,30286,67939,2022-05-12 21:16:53.795509
40683,8,434,4,8,68,522,2022-05-12 21:16:55.346169
40684,11,344,4,9,51,419,2022-05-12 21:16:56.379557
40685,12882,35993,3991,5461,32420,90747,2022-05-12 21:16:56.796539
40686,8,423,5,10,60,506,2022-05-12 21:16:58.091439
40689,3,89,3,9,21,125,2022-05-12 21:17:00.426605
40690,16,358,3,23,66,466,2022-05-12 21:17:01.739995
40691,26,501,10,26,251,814,2022-05-12 21:17:03.301641
40693,76,733,24,55,816,1704,2022-05-12 21:17:05.53543
40695,4,113,1,10,23,151,2022-05-12 21:17:07.660582
40699,3,147,2,16,30,198,2022-05-12 21:17:08.76746
40702,3,133,4,5,24,169,2022-05-12 21:17:10.268634
40703,6,211,3,6,25,251,2022-05-12 21:17:11.459168
40707,26,99,7,36,228,396,2022-05-12 21:17:12.681462
40709,3,184,3,6,23,219,2022-05-12 21:17:16.766319
40710,4,202,2,5,26,239,2022-05-12 21:17:17.192229
40711,247,1736,79,134,2414,4610,2022-05-12 21:17:19.489142
40712,224,2322,111,169,2025,4851,2022-05-12 21:17:21.832483
40713,7,225,4,6,30,272,2022-05-12 21:17:23.738379
40714,197,177,95,142,740,1351,2022-05-12 21:17:26.009733
40715,8,183,3,6,28,228,2022-05-12 21:17:27.778748
40716,27658,134152,10808,9504,101048,283170,2022-05-12 21:17:28.054592
40717,46,35,14,22,1089,1206,2022-05-12 21:17:30.444504
40721,6,354,2,12,52,426,2022-05-12 21:17:32.981917
40722,151,48,110,26,8814,9149,2022-05-12 21:17:35.723795
40727,4,188,2,11,82,287,2022-05-12 21:17:37.059248
40728,7,113,1,19,68,208,2022-05-12 21:17:38.786047
40729,20750,70536,4138,2626,69384,167434,2022-05-12 21:17:39.194908
40730,9583,43929,2270,1972,34926,92680,2022-05-12 21:17:39.427872
40732,96,201,18,49,592,956,2022-05-12 21:17:41.893913
40734,778,2722,95,176,1261,5032,2022-05-12 21:17:49.137956
40735,803,2632,191,257,2461,6344,2022-05-12 21:17:51.719687
40737,6,136,2,8,36,188,2022-05-12 21:17:53.781255
40738,1554,7734,596,2165,10368,22417,2022-05-12 21:17:56.652748
40741,2,96,2,6,19,125,2022-05-12 21:17:57.841153
40745,4,215,3,7,36,265,2022-05-12 21:18:01.536987
40746,7515,75118,1743,3605,25689,113670,2022-05-12 21:18:01.977676
40747,538,6378,198,244,10073,17431,2022-05-12 21:18:02.22339
40748,328073,1271351,34858,18025,179613,1831920,2022-05-12 21:18:02.466923
40763,1023,4731,403,901,6053,13111,2022-05-12 21:18:07.363533
40765,6,80,2,28,92,208,2022-05-12 21:18:08.855637
44020,0,2,0,6,10,18,2022-05-12 21:48:01.203532
40769,80,1277,20,79,679,2135,2022-05-12 21:18:13.597055
40776,55107,470798,9183,4136,105237,644461,2022-05-12 21:18:14.090639
40777,0,0,0,0,0,0,2022-05-12 21:18:14.993159
40779,48,222,22,24,532,848,2022-05-12 21:18:17.841741
40780,74,1275,25,84,652,2110,2022-05-12 21:18:20.993753
40784,1999,34693,574,424,9638,47328,2022-05-12 21:18:23.68883
40785,2,101,4,5,24,136,2022-05-12 21:18:25.918615
40786,4738,11110,1673,3551,14758,35830,2022-05-12 21:18:26.104574
40787,9170,163871,2223,443,112742,288449,2022-05-12 21:18:26.843232
40792,0,0,0,0,0,0,2022-05-12 21:18:29.388204
40793,16,135,3,22,163,339,2022-05-12 21:18:31.805299
40800,1,108,4,8,20,141,2022-05-12 21:18:36.135043
40803,6095,16785,2353,5237,20986,51456,2022-05-12 21:18:37.314603
40806,200,895,64,73,1361,2593,2022-05-12 21:18:39.638573
40808,0,0,0,0,373,373,2022-05-12 21:18:44.71605
40811,5,157,2,8,41,213,2022-05-12 21:18:45.862609
40812,5,139,2,11,38,195,2022-05-12 21:18:47.023236
40813,0,0,0,0,302,302,2022-05-12 21:18:48.20068
40815,10522,111512,2444,1786,25575,151839,2022-05-12 21:18:48.776314
40823,72,297,25,63,245,702,2022-05-12 21:18:51.188291
40827,5,116,3,7,29,160,2022-05-12 21:18:51.644253
40833,1761,6681,428,815,3039,12724,2022-05-12 21:18:55.988927
40834,121068,154482,8598,4637,107776,396561,2022-05-12 21:18:56.277821
40835,249,1592,98,111,1592,3642,2022-05-12 21:18:59.222354
40836,75,1095,87,96,935,2288,2022-05-12 21:19:00.875671
40837,2,93,3,8,22,128,2022-05-12 21:19:02.959187
40839,53511,577029,13781,28903,110544,783768,2022-05-12 21:19:04.756403
40840,2,90,2,10,26,130,2022-05-12 21:19:07.828701
40842,5032,15221,1864,2229,28098,52444,2022-05-12 21:19:15.360849
40844,13,38,4,24,42,121,2022-05-12 21:19:16.887705
40845,111,2891,45,103,1889,5039,2022-05-12 21:19:19.500064
40849,668,15385,221,453,5234,21961,2022-05-12 21:19:19.814066
40850,1008,2937,466,1633,3628,9672,2022-05-12 21:19:23.054507
44021,0,2,0,7,10,19,2022-05-12 21:48:02.085821
40852,94911,517264,15101,7753,172025,807054,2022-05-12 21:19:24.962975
40853,337,10240,129,132,4551,15389,2022-05-12 21:19:25.407915
40854,871,5866,212,195,2170,9314,2022-05-12 21:19:28.58907
40858,2317,41311,1018,513,31015,76174,2022-05-12 21:19:29.007402
40863,2,19,2,26,75,124,2022-05-12 21:19:36.433136
40868,5,112,2,18,46,183,2022-05-12 21:19:39.608883
40870,11063,35617,3264,5493,50816,106253,2022-05-12 21:19:42.398116
44079,0,0,0,0,420,420,2022-05-12 21:48:59.402337
44081,0,0,0,0,2618,2618,2022-05-12 21:49:01.902627
40873,331,4858,140,98,3636,9063,2022-05-12 21:19:44.795269
40876,175,231,64,73,1321,1864,2022-05-12 21:19:47.080263
40877,4,122,3,10,25,164,2022-05-12 21:19:48.265546
40879,7096,27074,2177,2199,23762,62308,2022-05-12 21:19:49.192605
40880,240,400,62,162,942,1806,2022-05-12 21:19:51.272398
40881,258,8969,168,109,8374,17878,2022-05-12 21:19:51.441702
40885,403,570,71,153,1000,2197,2022-05-12 21:19:53.76121
40888,95,0,46,63,407,611,2022-05-12 21:19:53.944392
40889,6,128,1,6,26,167,2022-05-12 21:19:55.665602
40890,58,579,36,62,795,1530,2022-05-12 21:19:57.798696
40894,416,1345,226,210,3402,5599,2022-05-12 21:20:04.30347
40897,751,9693,330,197,7648,18619,2022-05-12 21:20:05.227909
40900,50,1104,13,30,279,1476,2022-05-12 21:20:07.113408
40901,325,2124,110,82,2419,5060,2022-05-12 21:20:09.583436
40902,44744,264937,13394,12666,101543,437284,2022-05-12 21:20:13.421182
40904,37085,125550,7396,10800,79764,260595,2022-05-12 21:20:14.000085
40905,3,96,2,8,21,130,2022-05-12 21:20:16.249234
40906,28329,0,4948,6432,18870,58579,2022-05-12 21:20:16.421705
40907,10487,53252,1838,1263,49339,116179,2022-05-12 21:20:16.844848
40911,29094,149502,7965,6624,119084,312269,2022-05-12 21:20:19.320537
40921,30,287,16,38,372,743,2022-05-12 21:20:22.501756
40928,3,108,4,8,20,143,2022-05-12 21:20:25.242542
40930,3610,18258,963,1188,16481,40500,2022-05-12 21:20:25.705395
40932,76,2521,37,47,989,3670,2022-05-12 21:20:28.276128
40934,5695,10427,2527,6457,19781,44887,2022-05-12 21:20:33.773589
40935,32571,205731,8173,4916,109836,361227,2022-05-12 21:20:34.197403
40938,77251,270755,13914,23339,105685,490944,2022-05-12 21:20:38.374539
40939,54,30,19,119,341,563,2022-05-12 21:20:41.299826
40940,2272,3087,621,940,9293,16213,2022-05-12 21:20:45.519823
40942,746,5602,155,171,2360,9034,2022-05-12 21:20:45.770516
44108,0,4,0,9,8,21,2022-05-12 21:49:24.461185
40948,111,728,42,71,961,1913,2022-05-12 21:20:50.686668
40953,9,28,10,54,85,186,2022-05-12 21:20:52.547914
40956,87802,347962,25603,17941,111683,590991,2022-05-12 21:20:52.723642
40958,2299,9302,795,3984,8845,25225,2022-05-12 21:20:59.000288
40960,13526,41700,3210,11525,34082,104043,2022-05-12 21:20:59.208295
40964,5459,9480,1665,6222,12391,35217,2022-05-12 21:21:06.254459
40966,155,1292,32,78,313,1870,2022-05-12 21:21:09.090607
40979,2178,9690,392,512,9611,22383,2022-05-12 21:21:20.747922
40982,232,3570,116,77,2633,6628,2022-05-12 21:21:24.088432
40983,71,180,33,170,331,785,2022-05-12 21:21:25.444725
40989,138,674,69,101,1481,2463,2022-05-12 21:21:27.606458
40991,117,1057,25,78,449,1726,2022-05-12 21:21:30.348955
40994,74,178,27,50,502,831,2022-05-12 21:21:32.818918
40995,466,1723,161,689,2028,5067,2022-05-12 21:21:35.222608
41005,0,0,0,0,12319,12319,2022-05-12 21:21:37.876708
41010,0,0,0,0,0,0,2022-05-12 21:21:45.566837
41019,10,79,7,44,100,240,2022-05-12 21:21:48.24246
41023,9,287,4,9,35,344,2022-05-12 21:21:51.409017
41024,0,0,0,0,0,0,2022-05-12 21:21:52.292668
41025,161200,233003,35920,23632,216760,670515,2022-05-12 21:21:52.552627
41028,5,45,2,27,192,271,2022-05-12 21:21:56.078343
41029,0,0,0,0,2017,2017,2022-05-12 21:21:59.549785
41030,70,1264,40,47,843,2264,2022-05-12 21:22:01.550632
41033,2,184,0,5,28,219,2022-05-12 21:22:03.770592
41034,2,166,3,5,25,201,2022-05-12 21:22:06.429711
41036,0,0,0,0,0,0,2022-05-12 21:22:10.168003
41039,5,132,2,8,25,172,2022-05-12 21:22:11.528543
41051,1422,5791,466,552,7931,16162,2022-05-12 21:22:17.67337
41053,1013,30545,455,260,10842,43115,2022-05-12 21:22:20.7084
41054,6,55,8,26,67,162,2022-05-12 21:22:22.236926
41061,209,10594,113,61,4059,15036,2022-05-12 21:22:29.50613
41069,10,310,7,21,132,480,2022-05-12 21:22:37.442807
41070,13,263,7,16,130,429,2022-05-12 21:22:38.865372
41072,12,289,6,17,130,454,2022-05-12 21:22:40.81844
41074,15924,8261,5556,7354,13620,50715,2022-05-12 21:22:44.090367
41075,38,686,67,69,463,1323,2022-05-12 21:22:45.399726
41076,21,73,14,14,226,348,2022-05-12 21:22:46.933668
41079,39,61,16,39,114,269,2022-05-12 21:22:49.744511
41083,0,0,0,0,0,0,2022-05-12 21:22:52.479167
41084,5,2,5,1,143614,143627,2022-05-12 21:22:52.675274
41088,0,0,0,0,0,0,2022-05-12 21:22:55.056821
41090,8,647,7,12,105,779,2022-05-12 21:22:55.474844
41102,8,156,4,18,88,274,2022-05-12 21:22:58.429899
41103,25180,98922,4672,11623,54984,195381,2022-05-12 21:23:01.833428
41105,227,4174,108,143,3242,7894,2022-05-12 21:23:03.312368
41111,3,28,3,24,35,93,2022-05-12 21:23:05.990745
41113,3,22,3,30,30,88,2022-05-12 21:23:08.859669
41114,4,54,4,23,49,134,2022-05-12 21:23:11.595707
41115,12,70,9,36,95,222,2022-05-12 21:23:12.925959
41116,3,22,4,29,36,94,2022-05-12 21:23:13.879579
41118,6,34,4,23,111,178,2022-05-12 21:23:17.761374
41119,2,22,3,18,29,74,2022-05-12 21:23:18.876565
41120,46270,179989,17068,14384,95435,353146,2022-05-12 21:23:19.287851
41124,367,2284,103,798,1233,4785,2022-05-12 21:23:22.389347
41129,0,0,0,0,0,0,2022-05-12 21:23:27.42136
41132,261,3884,65,61,1964,6235,2022-05-12 21:23:32.675509
41139,0,0,0,0,0,0,2022-05-12 21:23:36.642542
41140,325,2195,179,49,6394,9142,2022-05-12 21:23:36.841599
41141,0,0,0,0,4030,4030,2022-05-12 21:23:39.854859
41160,2,23,5,28,38,96,2022-05-12 21:23:45.287833
41161,2,24,3,25,28,82,2022-05-12 21:23:46.314511
41164,28,2062,8,20,189,2307,2022-05-12 21:23:46.886321
41176,8,879,4,10,48,949,2022-05-12 21:23:50.079524
41177,3,522,3,8,51,587,2022-05-12 21:23:51.539873
41179,4,425,3,7,44,483,2022-05-12 21:23:54.340434
41180,10,707,3,11,55,786,2022-05-12 21:23:55.609263
41182,76,651,81,73,1175,2056,2022-05-12 21:24:00.94072
41183,11,177,1,19,54,262,2022-05-12 21:24:02.904293
41184,2,28,4,19,29,82,2022-05-12 21:24:04.550566
41185,3,145,2,9,27,186,2022-05-12 21:24:05.790509
41189,64,1143,57,78,989,2331,2022-05-12 21:24:10.135715
41190,15,53,19,46,306,439,2022-05-12 21:24:11.713707
41191,34,375,28,52,425,914,2022-05-12 21:24:13.305231
41192,10,242,2,37,72,363,2022-05-12 21:24:15.017712
41193,14,333,6,7,52,412,2022-05-12 21:24:16.465485
41194,556,8097,238,358,5839,15088,2022-05-12 21:24:17.39705
41195,118,3753,24,35,520,4450,2022-05-12 21:24:19.478478
41197,3,101,3,7,35,149,2022-05-12 21:24:20.569394
41199,1,25,2,32,44,104,2022-05-12 21:24:22.216058
41201,0,0,0,0,0,0,2022-05-12 21:24:23.124716
41202,76,2005,36,41,795,2953,2022-05-12 21:24:23.547778
41203,19,108,15,25,237,404,2022-05-12 21:24:24.898072
41205,81,245,45,51,1886,2308,2022-05-12 21:24:29.470201
41206,614,1786,303,187,2011,4901,2022-05-12 21:24:31.083014
41208,0,0,0,0,0,0,2022-05-12 21:24:32.486129
41215,53,354,22,49,208,686,2022-05-12 21:24:36.98919
41219,388,1349,88,160,1478,3463,2022-05-12 21:24:40.55063
41221,719,871,134,138,2427,4289,2022-05-12 21:24:41.241696
41224,840,1259,316,280,4287,6982,2022-05-12 21:24:45.181075
41227,5,126,3,17,40,191,2022-05-12 21:24:49.968328
41233,0,0,0,0,0,0,2022-05-12 21:24:54.190431
41237,0,0,0,0,0,0,2022-05-12 21:24:55.965568
41240,0,0,0,0,0,0,2022-05-12 21:24:58.499938
41243,0,0,0,0,0,0,2022-05-12 21:25:00.29506
41246,0,0,0,0,0,0,2022-05-12 21:25:01.373539
41250,26,65,11,34,187,323,2022-05-12 21:25:03.05137
41252,0,0,0,0,0,0,2022-05-12 21:25:05.926965
41253,0,0,0,0,0,0,2022-05-12 21:25:07.027678
41266,2310,5088,993,1743,5785,15919,2022-05-12 21:25:10.671484
41271,65,2679,36,78,1203,4061,2022-05-12 21:25:13.244785
41276,32,0,20,57,86,195,2022-05-12 21:25:14.123148
41278,5,163,0,11,32,211,2022-05-12 21:25:16.940881
41279,3,166,2,10,45,226,2022-05-12 21:25:18.165147
41280,8,131,3,29,82,253,2022-05-12 21:25:19.478981
41285,94,1444,36,100,934,2608,2022-05-12 21:25:22.437987
41289,0,0,0,0,7521,7521,2022-05-12 21:25:27.774683
41293,3,153,1,15,45,217,2022-05-12 21:25:30.65165
41296,16,282,7,20,80,405,2022-05-12 21:25:35.410613
41299,91,198,40,65,820,1214,2022-05-12 21:25:37.558506
41302,0,0,0,0,0,0,2022-05-12 21:25:38.473918
41303,4,130,1,4,15,154,2022-05-12 21:25:40.058628
41306,0,0,0,0,0,0,2022-05-12 21:25:40.765406
41307,115,518,42,63,2053,2791,2022-05-12 21:25:41.839507
41308,3,113,0,5,13,134,2022-05-12 21:25:42.984984
41309,4,155,3,5,25,192,2022-05-12 21:25:44.555333
41312,12517,96666,2413,7349,25054,143999,2022-05-12 21:25:44.808388
41317,54,543,27,38,577,1239,2022-05-12 21:25:49.795477
41319,33,1368,16,36,230,1683,2022-05-12 21:25:52.760381
41332,1730,11848,521,1000,10456,25555,2022-05-12 21:25:54.850398
41335,7,133,6,17,132,295,2022-05-12 21:25:56.195144
41339,49,605,27,27,629,1337,2022-05-12 21:25:56.511617
41341,960,14295,294,499,10837,26885,2022-05-12 21:26:02.419252
41345,24954,113835,6606,20685,72128,238208,2022-05-12 21:26:05.340906
41349,14,64,14,91,177,360,2022-05-12 21:26:07.125459
41353,76090,484300,17313,46972,120465,745140,2022-05-12 21:26:07.294545
41360,36,480,14,50,330,910,2022-05-12 21:26:09.472412
41361,786,5601,233,87,10998,17705,2022-05-12 21:26:09.894278
41364,1821,13773,548,608,12360,29110,2022-05-12 21:26:14.728558
44110,0,4,0,9,8,21,2022-05-12 21:49:26.326088
41372,4444,12921,1624,4839,16635,40463,2022-05-12 21:26:17.1045
41374,4,80,1,16,78,179,2022-05-12 21:26:18.849626
41377,9,228,5,8,32,282,2022-05-12 21:26:20.110728
41379,2294,9836,756,638,34902,48426,2022-05-12 21:26:20.351342
41380,21379,140545,5604,17566,42110,227204,2022-05-12 21:26:20.599602
41381,249,202,137,276,1065,1929,2022-05-12 21:26:22.991463
41384,49,0,31,93,141,314,2022-05-12 21:26:26.705681
41389,56285,371486,14895,16235,118910,577811,2022-05-12 21:26:27.139011
41391,13,28,12,24,38,115,2022-05-12 21:26:29.75126
41395,0,0,0,0,0,0,2022-05-12 21:26:31.57928
41401,112,296,30,142,560,1140,2022-05-12 21:26:36.774494
41402,40208,109746,5635,3240,56862,215691,2022-05-12 21:26:37.342489
41404,24,28,12,62,184,310,2022-05-12 21:26:38.627025
41405,441,904,88,380,1144,2957,2022-05-12 21:26:41.821412
41412,9,35,3,32,50,129,2022-05-12 21:26:44.579814
41416,3,17,1,19,35,75,2022-05-12 21:26:46.470493
44233,0,0,0,0,335,335,2022-05-12 21:50:28.889
41417,4,31,3,26,46,110,2022-05-12 21:26:47.991384
41421,47,515,20,63,154,799,2022-05-12 21:26:50.795439
41431,3,156,3,9,36,207,2022-05-12 21:26:53.876209
41433,31441,182917,10101,11570,106492,342521,2022-05-12 21:26:54.162113
41439,738,1669,170,271,1281,4129,2022-05-12 21:26:54.490381
41440,83,41,27,140,467,758,2022-05-12 21:26:55.957266
41443,4,151,2,7,28,192,2022-05-12 21:26:58.307704
41444,5,170,0,7,29,211,2022-05-12 21:26:59.743966
41446,2,105,1,8,27,143,2022-05-12 21:27:02.223653
41447,5,241,1,9,55,311,2022-05-12 21:27:03.39355
41449,6,253,5,19,41,324,2022-05-12 21:27:05.621055
41452,3,81,3,8,28,123,2022-05-12 21:27:09.731389
41453,5,128,8,7,26,174,2022-05-12 21:27:10.736259
41456,39627,154118,7894,16045,75099,292783,2022-05-12 21:27:13.106038
41457,60085,281671,12926,12366,150882,517930,2022-05-12 21:27:13.444326
41461,45265,31,1019,658,112723,159696,2022-05-12 21:27:16.990676
41471,229,345,162,40,8999,9775,2022-05-12 21:27:18.339644
41487,61710,352225,4755,2722,109788,531200,2022-05-12 21:27:19.610053
41496,4,115,2,6,26,153,2022-05-12 21:27:21.637655
41497,1376,18798,579,147,31810,52710,2022-05-12 21:27:21.945058
41509,8,53,4,52,63,180,2022-05-12 21:27:24.031628
41511,492,908,150,185,1907,3642,2022-05-12 21:27:26.256043
41514,1,0,0,0,88260,88261,2022-05-12 21:27:26.606582
41522,4,25,6,56,49,140,2022-05-12 21:27:31.32286
44583,0,0,0,0,3010,3010,2022-05-12 21:53:27.656883
41528,240,1847,58,93,499,2737,2022-05-12 21:27:34.155675
41529,73,105,21,148,365,712,2022-05-12 21:27:35.903663
41530,3418,15357,967,744,29452,49938,2022-05-12 21:27:36.076427
41531,305,2846,156,150,3054,6511,2022-05-12 21:27:41.259221
41534,6,102,3,4,16,131,2022-05-12 21:27:42.925599
41535,5,278,6,9,102,400,2022-05-12 21:27:44.033673
41539,0,0,0,0,0,0,2022-05-12 21:27:44.976146
41542,5,195,2,16,38,256,2022-05-12 21:27:46.915998
41545,54,229,22,40,382,727,2022-05-12 21:27:48.745528
41547,15,336,7,41,113,512,2022-05-12 21:27:50.482216
41549,346,4832,91,196,2974,8439,2022-05-12 21:27:53.970273
41556,2904,2228,652,1067,7446,14297,2022-05-12 21:27:57.082535
41558,349,739,152,684,1489,3413,2022-05-12 21:27:59.93118
41567,1,0,1,0,62105,62107,2022-05-12 21:28:01.883714
41568,26,384,17,55,551,1033,2022-05-12 21:28:04.200457
41570,23,379,6,11,110,529,2022-05-12 21:28:06.070654
44758,0,0,0,0,0,0,2022-05-12 21:55:02.175494
44761,0,0,0,0,0,0,2022-05-12 21:55:03.404788
41573,2230,7616,606,1128,10248,21828,2022-05-12 21:28:08.67558
41574,896,4447,265,849,5944,12401,2022-05-12 21:28:11.497164
41585,0,0,0,0,0,0,2022-05-12 21:28:13.126163
41586,96,1301,38,76,882,2393,2022-05-12 21:28:15.342278
41587,238208,398429,33164,22078,201919,893798,2022-05-12 21:28:15.557368
41589,0,0,0,0,17137,17137,2022-05-12 21:28:15.719763
41590,934,17308,370,295,10731,29638,2022-05-12 21:28:19.413683
41595,4130,5,539,86,10080,14840,2022-05-12 21:28:19.570292
41602,38,617,16,14,242,927,2022-05-12 21:28:21.091905
44763,0,0,0,0,0,0,2022-05-12 21:55:04.412532
41609,3,49,6,30,69,157,2022-05-12 21:28:22.20838
41611,848,7236,234,176,6255,14749,2022-05-12 21:28:25.694629
41617,0,0,0,0,0,0,2022-05-12 21:28:28.393869
41619,25132,149518,7106,13266,71091,266113,2022-05-12 21:28:31.646866
41623,37515,162914,6541,10787,97404,315161,2022-05-12 21:28:33.329512
41624,0,0,0,0,0,0,2022-05-12 21:28:36.289246
41627,5,211,2,5,19,242,2022-05-12 21:28:40.745461
41632,147,217,44,102,708,1218,2022-05-12 21:28:45.210817
41633,2,101,2,14,19,138,2022-05-12 21:28:46.340404
41636,27,179,16,49,174,445,2022-05-12 21:28:50.282388
41637,15,186,15,29,103,348,2022-05-12 21:28:51.679841
41638,55,0,17,71,165,308,2022-05-12 21:28:52.845565
41656,3,89,3,6,20,121,2022-05-12 21:29:00.620307
41659,193,2017,130,81,3544,5965,2022-05-12 21:29:03.81458
41662,0,0,0,0,0,0,2022-05-12 21:29:05.586161
41663,2,60,2,16,22,102,2022-05-12 21:29:07.094464
41664,2,74,3,7,16,102,2022-05-12 21:29:08.770774
44767,0,0,0,0,0,0,2022-05-12 21:55:06.238336
44768,0,0,0,0,0,0,2022-05-12 21:55:07.114121
44770,0,0,0,0,0,0,2022-05-12 21:55:08.069963
41667,12,74,6,33,53,178,2022-05-12 21:29:10.140426
41674,227,2715,137,66,6100,9245,2022-05-12 21:29:12.035458
41684,2,90,2,10,20,124,2022-05-12 21:29:14.07687
41686,45,61,17,84,200,407,2022-05-12 21:29:16.565644
41688,657,2614,200,451,1424,5346,2022-05-12 21:29:19.248871
41689,8,199,12,29,91,339,2022-05-12 21:29:20.585617
41694,24219,69665,9862,8040,81351,193137,2022-05-12 21:29:21.461965
44884,0,0,0,0,0,0,2022-05-12 21:55:53.085133
44885,0,0,0,0,0,0,2022-05-12 21:55:53.882042
41708,7,126,1,7,37,178,2022-05-12 21:29:24.454765
41710,36721,165093,4909,9841,64664,281228,2022-05-12 21:29:26.041177
41714,118,521,63,57,2032,2791,2022-05-12 21:29:28.364401
41725,5,207,0,5,46,263,2022-05-12 21:29:31.877577
41729,3,81,2,6,16,108,2022-05-12 21:29:34.242853
41734,17,35,13,40,320,425,2022-05-12 21:29:35.71239
41739,2,73,2,10,18,105,2022-05-12 21:29:37.308089
41744,4,196,2,16,23,241,2022-05-12 21:29:38.583726
41762,8796,28341,2854,6694,19873,66558,2022-05-12 21:29:45.794869
41763,4,129,3,4,18,158,2022-05-12 21:29:47.076333
41764,3,115,2,4,17,141,2022-05-12 21:29:48.659892
41766,1,82,2,9,16,110,2022-05-12 21:29:50.63456
41768,7,443,1,8,62,521,2022-05-12 21:29:51.858284
41769,6,383,2,8,31,430,2022-05-12 21:29:52.9935
41776,4,44,5,41,87,181,2022-05-12 21:29:54.171598
41777,5,37,4,49,69,164,2022-05-12 21:29:55.175319
41780,159,2381,109,68,4319,7036,2022-05-12 21:29:58.738644
41781,153,2022,87,60,3159,5481,2022-05-12 21:29:59.186812
41782,97,131,65,36,4928,5257,2022-05-12 21:30:01.64231
41783,8348,33228,3112,9285,27363,81336,2022-05-12 21:30:06.143356
41786,4,72,1,10,20,107,2022-05-12 21:30:09.386517
41796,3,170,3,8,54,238,2022-05-12 21:30:11.53796
41797,4,115,1,15,40,175,2022-05-12 21:30:12.994817
41802,269,434,56,126,500,1385,2022-05-12 21:30:16.207555
41808,7,52,9,36,115,219,2022-05-12 21:30:19.953179
41812,20092,63903,3914,8474,45452,141835,2022-05-12 21:30:20.145418
41813,3,22,7,56,62,150,2022-05-12 21:30:21.544985
41814,79,208,33,33,1785,2138,2022-05-12 21:30:24.021395
41820,6,111,2,4,20,143,2022-05-12 21:30:25.681378
41822,11,51,3,13,116,194,2022-05-12 21:30:27.462267
41833,9080,22375,2039,5790,23338,62622,2022-05-12 21:30:27.637168
41834,10408,14750,3003,9620,20828,58609,2022-05-12 21:30:31.10899
41842,131,771,43,57,1335,2337,2022-05-12 21:30:33.342556
41851,100,255,47,73,102,577,2022-05-12 21:30:36.639501
41853,11,970,4,6,78,1069,2022-05-12 21:30:39.455768
41854,76,222,13,35,381,727,2022-05-12 21:30:41.440299
41856,0,0,0,0,0,0,2022-05-12 21:30:44.371311
41863,0,0,0,0,0,0,2022-05-12 21:30:45.670912
41873,9,156,9,10,126,310,2022-05-12 21:30:46.918406
41877,447,4871,174,122,7009,12623,2022-05-12 21:30:50.808333
41884,1082,0,86,117,590,1875,2022-05-12 21:30:52.061196
41899,35633,180906,5359,18368,56004,296270,2022-05-12 21:30:55.530789
41902,2,58,1,7,20,88,2022-05-12 21:30:56.639685
41911,20479,25444,6273,9473,45476,107145,2022-05-12 21:30:57.782841
41912,0,0,0,0,206,206,2022-05-12 21:30:58.94245
41913,85,78,32,71,447,713,2022-05-12 21:31:00.939492
41915,3731,2,208,204,9551,13696,2022-05-12 21:31:01.148232
41916,239,376,64,127,1471,2277,2022-05-12 21:31:03.439083
41919,0,0,0,0,4285,4285,2022-05-12 21:31:09.918618
41920,77,143,26,85,236,567,2022-05-12 21:31:11.330385
45021,0,0,0,0,0,0,2022-05-12 21:57:06.529979
41923,2036,1996,372,367,3915,8686,2022-05-12 21:31:13.90242
41926,5,101,3,6,23,138,2022-05-12 21:31:14.960264
41930,22637,109723,7553,13781,69875,223569,2022-05-12 21:31:15.991354
41939,9,696,3,8,36,752,2022-05-12 21:31:19.332682
41942,4,8,5,19,45,81,2022-05-12 21:31:20.874619
41946,41854,51156,5746,11371,72959,183086,2022-05-12 21:31:22.331428
41967,0,0,0,0,0,0,2022-05-12 21:31:32.077705
41968,0,0,0,0,0,0,2022-05-12 21:31:32.926401
41969,0,0,0,0,0,0,2022-05-12 21:31:33.663443
42004,103,109,43,43,383,681,2022-05-12 21:31:48.716871
42005,0,0,0,0,0,0,2022-05-12 21:31:50.121522
42008,1,24,6,24,30,85,2022-05-12 21:31:51.261212
42009,1,76,3,9,22,111,2022-05-12 21:31:52.829958
42012,18,363,6,11,119,517,2022-05-12 21:31:54.067106
42013,7,111,1,28,67,214,2022-05-12 21:31:55.28877
42014,5,174,2,21,46,248,2022-05-12 21:31:56.577561
42015,3,103,4,6,19,135,2022-05-12 21:31:58.172727
45114,0,0,0,0,0,0,2022-05-12 21:57:39.873925
45127,0,0,0,0,0,0,2022-05-12 21:57:43.484422
42027,3,70,2,10,41,126,2022-05-12 21:31:59.886347
42033,8,30,2,26,62,128,2022-05-12 21:32:05.102371
42044,51,998,18,49,386,1502,2022-05-12 21:32:08.940411
42055,32,140,16,33,295,516,2022-05-12 21:32:12.475393
42057,196,1180,49,81,1246,2752,2022-05-12 21:32:12.920792
42061,8,43,6,46,46,149,2022-05-12 21:32:14.016566
42070,16,71,9,35,137,268,2022-05-12 21:32:15.911362
45133,0,0,0,0,0,0,2022-05-12 21:57:44.674195
45136,0,0,0,0,0,0,2022-05-12 21:57:45.941341
42071,369,1442,131,284,3955,6181,2022-05-12 21:32:18.462707
42072,15290,27339,1294,7071,28384,79378,2022-05-12 21:32:18.635649
42074,21,154,15,38,332,560,2022-05-12 21:32:22.43568
42076,82,3177,12,38,190,3499,2022-05-12 21:32:24.742649
42078,7,1127,3,7,77,1221,2022-05-12 21:32:26.238529
42082,113,251,26,85,173,648,2022-05-12 21:32:28.326214
42090,29,36,10,98,134,307,2022-05-12 21:32:32.300094
45153,0,0,0,0,0,0,2022-05-12 21:57:54.545266
42091,1620,33566,733,982,34950,71851,2022-05-12 21:32:32.719444
42104,5,352,4,7,47,415,2022-05-12 21:32:34.198813
42106,251,1748,84,89,3647,5819,2022-05-12 21:32:35.057917
42121,7,217,5,6,49,284,2022-05-12 21:32:38.208823
42129,357,2924,178,124,5286,8869,2022-05-12 21:32:40.781475
42132,31,97,12,35,162,337,2022-05-12 21:32:42.276781
42134,0,0,0,0,0,0,2022-05-12 21:32:43.196458
42135,1,28,3,9,38,79,2022-05-12 21:32:44.660978
45165,0,0,0,0,0,0,2022-05-12 21:57:58.969859
45170,0,0,0,0,0,0,2022-05-12 21:58:01.289288
42136,32,881,40,66,491,1510,2022-05-12 21:32:46.754377
42137,1,29,3,9,32,74,2022-05-12 21:32:47.167715
42138,1,36,4,9,42,92,2022-05-12 21:32:48.373186
42142,7,364,4,15,83,473,2022-05-12 21:32:50.917996
42143,151,7208,67,167,3208,10801,2022-05-12 21:32:53.989675
42144,5,35,5,34,45,124,2022-05-12 21:32:55.21625
42145,40,195,26,95,354,710,2022-05-12 21:32:56.722923
42146,7,31,6,34,95,173,2022-05-12 21:32:57.837892
42148,122,186,30,104,471,913,2022-05-12 21:33:00.54729
42149,28,132,11,33,119,323,2022-05-12 21:33:01.650657
42153,7,40,5,25,84,161,2022-05-12 21:33:04.300089
42156,25,449,11,16,152,653,2022-05-12 21:33:06.244467
42158,61,94,24,62,425,666,2022-05-12 21:33:07.741634
42161,2498,4,918,234,1242,4896,2022-05-12 21:33:08.264345
42163,496,1,115,61,1594,2267,2022-05-12 21:33:08.502392
45178,0,0,0,0,0,0,2022-05-12 21:58:03.761827
45182,0,0,0,0,0,0,2022-05-12 21:58:05.130542
42168,6,131,1,32,53,223,2022-05-12 21:33:12.359016
42170,7,65,3,31,59,165,2022-05-12 21:33:13.571573
42172,3,63,2,26,50,144,2022-05-12 21:33:14.79637
42176,167,818,68,72,1077,2202,2022-05-12 21:33:19.403573
42178,250,286,75,185,1802,2598,2022-05-12 21:33:21.750229
42179,5,15,8,56,74,158,2022-05-12 21:33:22.870388
42181,2,75,1,24,35,137,2022-05-12 21:33:24.140769
42191,2,21,2,21,35,81,2022-05-12 21:33:29.230839
42192,39922,56487,9863,15258,68012,189542,2022-05-12 21:33:29.653155
42198,8,62,7,22,46,145,2022-05-12 21:33:35.056387
42203,83465,441906,14698,8597,135988,684654,2022-05-12 21:33:35.701157
42205,73609,13235,16755,27468,88068,219135,2022-05-12 21:33:35.887828
42247,5,100,1,12,56,174,2022-05-12 21:33:41.841711
42249,211868,466206,29767,33783,178331,919955,2022-05-12 21:33:44.303438
42250,10328,40091,2886,1997,31473,86775,2022-05-12 21:33:44.635092
45189,0,0,0,0,0,0,2022-05-12 21:58:09.244795
42256,3,84,2,12,57,158,2022-05-12 21:33:45.874489
42257,5,105,1,14,72,197,2022-05-12 21:33:47.703947
42258,4,75,1,10,69,159,2022-05-12 21:33:49.469769
42260,1131,3690,294,2836,7226,15177,2022-05-12 21:33:52.432614
42263,2,12,1,18,35,68,2022-05-12 21:33:54.685272
42266,217,1857,41,85,609,2809,2022-05-12 21:33:58.946196
42267,941,0,100,156,472,1669,2022-05-12 21:34:00.42421
42268,163,359,40,104,291,957,2022-05-12 21:34:01.883329
42271,2,77,2,11,42,134,2022-05-12 21:34:03.091697
42274,3,68,4,11,30,116,2022-05-12 21:34:05.281281
42275,3,75,2,11,33,124,2022-05-12 21:34:06.585941
42276,3,81,2,9,40,135,2022-05-12 21:34:07.700226
42277,2,110,2,12,52,178,2022-05-12 21:34:08.83154
42278,5,79,2,10,40,136,2022-05-12 21:34:10.273372
42279,4,78,3,11,36,132,2022-05-12 21:34:11.270637
42281,5,111,1,9,34,160,2022-05-12 21:34:12.954256
42282,25754,80148,5605,6555,62929,180991,2022-05-12 21:34:15.724297
42284,346,1568,55,122,660,2751,2022-05-12 21:34:17.836922
42285,240,235,51,121,1063,1710,2022-05-12 21:34:18.161617
42286,1,11,1,15,29,57,2022-05-12 21:34:19.524914
42291,251,239,46,115,416,1067,2022-05-12 21:34:21.494447
42293,0,0,0,0,201,201,2022-05-12 21:34:23.627446
42295,251,0,134,156,693,1234,2022-05-12 21:34:25.963425
42297,16,13,9,13,142,193,2022-05-12 21:34:27.766352
45200,0,0,0,0,0,0,2022-05-12 21:58:14.625452
45216,0,0,0,0,0,0,2022-05-12 21:58:18.645161
42307,7374,17387,2382,8456,27016,62615,2022-05-12 21:34:29.934293
42310,1,0,0,0,25990,25991,2022-05-12 21:34:32.819315
42314,4,171,1,6,26,208,2022-05-12 21:34:33.766369
42317,14,530,4,27,97,672,2022-05-12 21:34:37.04248
42319,73,116,20,62,539,810,2022-05-12 21:34:38.497083
42321,676,1963,224,1435,2748,7046,2022-05-12 21:34:42.777405
42323,3,19,4,15,47,88,2022-05-12 21:34:43.840473
42328,1,54,2,21,34,112,2022-05-12 21:34:44.988704
45219,0,0,0,0,0,0,2022-05-12 21:58:21.776622
45223,0,0,0,0,0,0,2022-05-12 21:58:23.02344
45226,0,0,0,0,0,0,2022-05-12 21:58:24.123255
42329,1,24,3,22,40,90,2022-05-12 21:34:46.118403
42330,10,17,4,44,68,143,2022-05-12 21:34:47.925102
42331,12,22,9,47,232,322,2022-05-12 21:34:49.068244
42339,1,22,2,14,40,79,2022-05-12 21:34:52.191526
42341,0,0,0,0,0,0,2022-05-12 21:34:55.24939
42346,8,29,5,31,43,116,2022-05-12 21:35:01.417354
42351,32978,123983,5089,4915,75090,242055,2022-05-12 21:35:03.342248
42354,2,121,2,8,47,180,2022-05-12 21:35:05.131068
45230,0,0,0,0,0,0,2022-05-12 21:58:25.494083
45233,0,0,0,0,0,0,2022-05-12 21:58:26.62191
45236,0,0,0,0,0,0,2022-05-12 21:58:28.361767
42357,3,90,0,17,26,136,2022-05-12 21:35:06.717497
42358,1,95,0,15,29,140,2022-05-12 21:35:08.100391
42359,189,553,56,54,2312,3164,2022-05-12 21:35:11.055527
42364,3504,11405,1138,936,9820,26803,2022-05-12 21:35:17.110755
42366,2,21,1,20,42,86,2022-05-12 21:35:18.319347
42367,2,20,1,20,35,78,2022-05-12 21:35:19.279986
42373,2,55,5,31,43,136,2022-05-12 21:35:23.029814
45259,0,0,0,0,0,0,2022-05-12 21:58:34.449433
42378,8,225,4,8,32,277,2022-05-12 21:35:24.770356
42380,13,417,12,15,89,546,2022-05-12 21:35:26.077873
42385,0,0,0,0,3502,3502,2022-05-12 21:35:28.034046
42387,642,2980,475,219,18373,22689,2022-05-12 21:35:30.54166
42391,3080,6548,963,762,7793,19146,2022-05-12 21:35:34.260663
42395,12528,36205,3402,7096,28939,88170,2022-05-12 21:35:40.783569
42399,2,37,4,22,63,128,2022-05-12 21:35:43.736495
42400,5,53,5,27,96,186,2022-05-12 21:35:45.177555
42423,1249,30466,519,148,22496,54878,2022-05-12 21:35:50.976755
42429,31455,9,470,276,46925,79135,2022-05-12 21:35:51.181342
42431,7,209,4,7,25,252,2022-05-12 21:35:52.612269
42432,8,290,5,8,61,372,2022-05-12 21:35:53.745759
42433,7,165,5,6,21,204,2022-05-12 21:35:55.049731
42435,8,222,3,7,29,269,2022-05-12 21:35:56.323297
42436,7,202,5,5,25,244,2022-05-12 21:35:57.241786
42438,6,266,6,7,40,325,2022-05-12 21:35:58.533847
42439,10,217,7,11,64,309,2022-05-12 21:36:00.163146
42443,20,134,12,40,161,367,2022-05-12 21:36:03.404283
42445,12,90,9,39,90,240,2022-05-12 21:36:05.412393
42447,2,29,4,36,41,112,2022-05-12 21:36:06.821612
42449,59,721,53,73,801,1707,2022-05-12 21:36:07.416898
42455,31,275,17,37,256,616,2022-05-12 21:36:09.868601
42456,8,21,6,32,119,186,2022-05-12 21:36:11.145548
42457,7,27,2,27,58,121,2022-05-12 21:36:12.152183
42460,7,70,7,41,89,214,2022-05-12 21:36:15.021256
42463,45,0,8,46,82,181,2022-05-12 21:36:16.860164
42464,2,25,3,19,57,106,2022-05-12 21:36:17.847264
42490,20,260,28,51,167,526,2022-05-12 21:36:22.148818
42491,29,224,12,49,123,437,2022-05-12 21:36:22.590285
42497,327,5532,74,140,1139,7212,2022-05-12 21:36:27.961747
42498,1562,4503,145,228,2206,8644,2022-05-12 21:36:30.511243
42500,13,153,6,47,82,301,2022-05-12 21:36:31.456215
42501,8,155,8,25,101,297,2022-05-12 21:36:32.632765
42506,777,2819,243,481,5188,9508,2022-05-12 21:36:36.261682
42507,8,156,3,28,49,244,2022-05-12 21:36:38.128225
42512,0,0,0,0,0,0,2022-05-12 21:36:39.81658
42514,512,1545,209,368,622,3256,2022-05-12 21:36:42.834989
42517,1228,9587,353,495,7617,19280,2022-05-12 21:36:49.076799
42522,58,71,29,69,211,438,2022-05-12 21:36:52.069968
42532,0,0,0,0,0,0,2022-05-12 21:36:57.016058
42540,5,24,3,22,36,90,2022-05-12 21:37:00.15386
42542,2,43,1,18,30,94,2022-05-12 21:37:01.362557
42544,21865,53853,4691,5735,63701,149845,2022-05-12 21:37:01.540438
42550,17,10,5,43,145,220,2022-05-12 21:37:08.359499
42562,464,1762,193,212,4377,7008,2022-05-12 21:37:11.717107
42563,7,157,3,6,23,196,2022-05-12 21:37:13.197594
42568,5203,13136,1721,4117,16246,40423,2022-05-12 21:37:17.656169
45436,0,0,0,0,0,0,2022-05-12 21:59:54.366212
42571,4922,27171,1280,3758,22865,59996,2022-05-12 21:37:18.082763
42576,1,124,2,6,29,162,2022-05-12 21:37:19.611452
42584,7,142,3,5,31,188,2022-05-12 21:37:21.372341
42585,8,87,12,22,116,245,2022-05-12 21:37:22.943628
42593,139,461,140,89,3973,4802,2022-05-12 21:37:30.567845
42600,43,1309,24,21,419,1816,2022-05-12 21:37:32.293315
42601,4,83,1,13,25,126,2022-05-12 21:37:33.562516
42603,3560,108381,900,622,29051,142514,2022-05-12 21:37:34.220331
42612,2,88,2,6,15,113,2022-05-12 21:37:35.547079
42616,4,97,2,7,21,131,2022-05-12 21:37:36.864396
42618,5,91,3,7,24,130,2022-05-12 21:37:38.875784
42619,3,97,3,6,20,129,2022-05-12 21:37:40.661194
42625,15683,67201,3290,4770,59135,150079,2022-05-12 21:37:41.086469
42627,23867,57684,5446,15247,45957,148201,2022-05-12 21:37:44.00659
42628,2,61,3,3,18,87,2022-05-12 21:37:45.136467
42629,177,5845,97,53,1902,8074,2022-05-12 21:37:47.518121
42636,3,69,2,6,19,99,2022-05-12 21:37:51.013884
42639,2,67,3,5,16,93,2022-05-12 21:37:53.381567
42640,407,4487,98,107,1894,6993,2022-05-12 21:37:56.605928
42641,67,110,37,66,1633,1913,2022-05-12 21:37:58.861412
42645,0,0,0,0,0,0,2022-05-12 21:37:59.637156
42646,2,66,3,6,18,95,2022-05-12 21:38:00.795477
42650,3,112,1,13,23,152,2022-05-12 21:38:03.113363
42653,477,731,164,277,1043,2692,2022-05-12 21:38:03.448243
45676,0,0,0,0,0,0,2022-05-12 22:02:09.884418
42656,1,63,1,5,18,88,2022-05-12 21:38:04.872592
42657,82,383,41,263,219,988,2022-05-12 21:38:06.602807
42658,79,111,25,79,146,440,2022-05-12 21:38:08.012593
42660,4,67,5,30,43,149,2022-05-12 21:38:09.128089
42666,2,74,2,8,18,104,2022-05-12 21:38:12.645529
42667,6,13,6,17,78,120,2022-05-12 21:38:13.698305
42668,4352,19428,1984,4107,21210,51081,2022-05-12 21:38:16.637733
42670,15183,26292,1688,1643,44376,89182,2022-05-12 21:38:17.142797
42672,1,74,1,9,16,101,2022-05-12 21:38:18.306228
42681,1,71,1,8,19,100,2022-05-12 21:38:20.245822
42682,1,69,1,11,15,97,2022-05-12 21:38:21.377235
42685,342,2745,140,203,2513,5943,2022-05-12 21:38:23.6453
42690,1,63,2,5,15,86,2022-05-12 21:38:24.779148
42697,7,186,6,29,112,340,2022-05-12 21:38:26.079726
42699,15,61,5,28,109,218,2022-05-12 21:38:28.601765
45871,0,0,0,0,0,0,2022-05-12 22:03:39.601464
42703,12,502,5,8,79,606,2022-05-12 21:38:30.03016
42714,1079,4979,325,567,6689,13639,2022-05-12 21:38:31.083821
42717,72,111,72,136,445,836,2022-05-12 21:38:32.750159
42725,2,114,3,6,27,152,2022-05-12 21:38:37.043488
42729,4,189,2,10,39,244,2022-05-12 21:38:40.156155
42733,2,70,3,7,19,101,2022-05-12 21:38:42.998025
42736,3,73,2,7,17,102,2022-05-12 21:38:44.485528
42737,27,208,12,28,342,617,2022-05-12 21:38:46.07559
42740,17,62,9,37,70,195,2022-05-12 21:38:47.297456
42744,1,69,1,7,16,94,2022-05-12 21:38:48.373925
42745,14726,0,347,306,25617,40996,2022-05-12 21:38:48.543605
42748,3,63,2,17,32,117,2022-05-12 21:38:49.978323
42749,3,62,2,5,17,89,2022-05-12 21:38:50.955804
42750,139,154,64,42,2313,2712,2022-05-12 21:38:51.126727
45894,0,0,0,0,0,0,2022-05-12 22:03:47.792051
42783,35,969,26,18,341,1389,2022-05-12 21:38:55.030447
42784,71,118,23,56,144,412,2022-05-12 21:38:56.820092
42792,3,68,4,5,19,99,2022-05-12 21:39:03.730027
42794,57,245,13,46,286,647,2022-05-12 21:39:06.922407
42798,200,3793,96,96,5117,9302,2022-05-12 21:39:10.522392
42799,1,63,2,18,30,114,2022-05-12 21:39:11.652641
42802,4,88,1,7,23,123,2022-05-12 21:39:14.257163
42803,953,7449,343,185,4420,13350,2022-05-12 21:39:16.751009
42804,50,0,20,40,342,452,2022-05-12 21:39:18.071457
42805,11,38,5,15,269,338,2022-05-12 21:39:19.345679
42808,4155,2867,384,842,6025,14273,2022-05-12 21:39:20.830373
42809,5,146,3,9,27,190,2022-05-12 21:39:22.096077
42811,3,62,2,6,19,92,2022-05-12 21:39:23.091138
42820,9,211,3,8,49,280,2022-05-12 21:39:27.111432
42822,7374,27933,2078,4739,17286,59410,2022-05-12 21:39:27.30037
46107,0,0,0,0,0,0,2022-05-12 22:05:06.115848
42826,16335,73200,3426,7408,33633,134002,2022-05-12 21:39:33.690479
42829,97,286,44,46,1383,1856,2022-05-12 21:39:36.21391
42834,20,30,12,38,159,259,2022-05-12 21:39:41.152648
42836,17,734,5,27,194,977,2022-05-12 21:39:44.944488
42837,3,54,2,5,16,80,2022-05-12 21:39:46.075491
42840,5,11,6,25,106,153,2022-05-12 21:39:47.996128
42842,3,88,3,9,23,126,2022-05-12 21:39:48.999285
42845,6,69,3,14,26,118,2022-05-12 21:39:53.26637
42846,5,58,1,5,16,85,2022-05-12 21:39:54.253808
42847,2304,5722,788,114,41788,50716,2022-05-12 21:39:54.656804
42852,2,6,3,11,41,63,2022-05-12 21:39:55.654957
42854,7,126,4,7,23,167,2022-05-12 21:39:58.026094
42855,72,1025,21,59,565,1742,2022-05-12 21:39:58.364579
42862,1150,4808,324,658,4135,11075,2022-05-12 21:40:00.934502
42865,5,170,2,11,45,233,2022-05-12 21:40:03.800284
46114,0,0,0,0,0,0,2022-05-12 22:05:10.921315
42870,59,0,24,134,384,601,2022-05-12 21:40:06.902066
42873,2,69,2,9,22,104,2022-05-12 21:40:09.787597
42875,20,21,13,24,124,202,2022-05-12 21:40:11.708738
42876,32,0,24,24,113,193,2022-05-12 21:40:11.892314
42880,17,370,19,21,302,729,2022-05-12 21:40:12.891421
42882,33,300,7,19,205,564,2022-05-12 21:40:14.248231
42883,458,3043,142,685,1576,5904,2022-05-12 21:40:17.17695
46122,0,0,0,0,0,0,2022-05-12 22:05:17.299935
42885,48,63,14,31,258,414,2022-05-12 21:40:18.630221
42886,3702,2,116,71,8065,11956,2022-05-12 21:40:18.803402
42889,94,1777,45,37,830,2783,2022-05-12 21:40:23.017718
42892,11651,7,1409,6782,26033,45882,2022-05-12 21:40:24.760089
42893,1057,12316,304,479,6979,21135,2022-05-12 21:40:25.246614
42894,845,8543,307,110,17443,27248,2022-05-12 21:40:25.734481
42897,139552,660987,19992,20857,170000,1011388,2022-05-12 21:40:26.27629
42911,3,56,1,4,12,76,2022-05-12 21:40:28.567335
42922,4,13,0,17,29,63,2022-05-12 21:40:31.130396
42923,61443,245363,12010,12213,105459,436488,2022-05-12 21:40:31.393887
42938,31725,181228,4642,2905,120455,340955,2022-05-12 21:40:33.459701
42948,9,25,4,49,82,169,2022-05-12 21:40:35.490061
42952,41,70,16,59,322,508,2022-05-12 21:40:39.556928
42954,2,58,2,7,26,95,2022-05-12 21:40:40.635465
42956,50,199,16,51,303,619,2022-05-12 21:40:42.457154
42958,2,59,2,9,21,93,2022-05-12 21:40:43.449668
42959,922,5994,249,331,4886,12382,2022-05-12 21:40:46.509592
42962,0,0,0,0,85244,85244,2022-05-12 21:40:46.963444
42963,5,2,6,2,200197,200212,2022-05-12 21:40:47.133448
42965,89,850,18,41,268,1266,2022-05-12 21:40:47.528395
42969,6,22,3,47,54,132,2022-05-12 21:40:48.935871
42971,1,64,1,7,15,88,2022-05-12 21:40:50.340343
42979,5,35,9,39,93,181,2022-05-12 21:40:52.520368
42981,360,1702,126,814,1242,4244,2022-05-12 21:40:53.542437
46397,0,0,0,0,0,0,2022-05-12 22:07:13.29563
46404,0,0,0,0,0,0,2022-05-12 22:07:15.855213
42988,4,96,3,7,21,131,2022-05-12 21:40:54.856923
42990,402,8334,155,137,5202,14230,2022-05-12 21:40:57.944142
42994,0,0,1,0,9064,9065,2022-05-12 21:40:58.136631
42995,4,93,2,5,20,124,2022-05-12 21:40:59.888375
42996,2,102,1,6,20,131,2022-05-12 21:41:01.53233
42998,8,14,6,66,67,161,2022-05-12 21:41:02.730873
43004,1,74,2,9,18,104,2022-05-12 21:41:04.371551
43007,30264,94861,7020,22793,63261,218199,2022-05-12 21:41:06.034201
46407,0,0,0,0,0,0,2022-05-12 22:07:18.265598
43201,3,173,1,9,27,213,2022-05-12 21:41:09.519363
43203,0,4,3,15,14,36,2022-05-12 21:41:11.017828
43204,35,317,35,36,1024,1447,2022-05-12 21:41:13.374426
43205,0,0,0,0,648,648,2022-05-12 21:41:13.546405
43206,0,0,0,0,622,622,2022-05-12 21:41:13.810389
43212,1,35,2,11,17,66,2022-05-12 21:41:17.204295
43214,0,13,1,10,13,37,2022-05-12 21:41:18.44927
43215,2,23,2,12,18,57,2022-05-12 21:41:19.343997
43216,0,15,2,10,13,40,2022-05-12 21:41:20.403865
46415,0,0,0,0,0,0,2022-05-12 22:07:21.61409
46439,0,0,0,0,0,0,2022-05-12 22:07:30.075553
43228,0,18,2,8,13,41,2022-05-12 21:41:30.89155
43229,6760,23461,2356,4929,19485,56991,2022-05-12 21:41:33.994299
43231,0,10,2,9,13,34,2022-05-12 21:41:34.89788
43232,0,9,2,9,12,32,2022-05-12 21:41:36.421487
43233,0,11,2,11,12,36,2022-05-12 21:41:37.37546
43235,0,10,2,10,13,35,2022-05-12 21:41:38.981339
43236,0,15,2,10,12,39,2022-05-12 21:41:39.865369
43238,0,8,1,10,13,32,2022-05-12 21:41:41.393625
43259,1,12,2,11,12,38,2022-05-12 21:41:52.048894
43267,0,9,1,10,15,35,2022-05-12 21:41:54.357428
43287,0,16,2,8,13,39,2022-05-12 21:41:59.272787
43293,5,120,2,6,23,156,2022-05-12 21:42:02.303624
43297,1,16,1,15,27,60,2022-05-12 21:42:03.749469
43299,88519,289735,24418,25294,195211,623177,2022-05-12 21:42:06.906048
43306,0,0,0,0,0,0,2022-05-12 21:42:12.035635
43308,0,0,0,0,0,0,2022-05-12 21:42:14.144462
43311,0,5,0,9,19,33,2022-05-12 21:42:17.14287
46442,0,0,0,0,0,0,2022-05-12 22:07:31.324388
43318,7,151,3,9,33,203,2022-05-12 21:42:24.394273
43319,0,6,0,9,19,34,2022-05-12 21:42:25.247815
43320,0,6,0,10,19,35,2022-05-12 21:42:26.098804
43322,0,4,0,8,20,32,2022-05-12 21:42:27.704253
43344,0,9,0,10,14,33,2022-05-12 21:42:31.99396
43346,0,10,2,9,12,33,2022-05-12 21:42:34.665604
43347,0,12,2,9,14,37,2022-05-12 21:42:35.611192
43349,260,8993,89,140,2010,11492,2022-05-12 21:42:39.361488
43350,57,472,20,66,415,1030,2022-05-12 21:42:41.046406
43352,6,116,3,5,18,148,2022-05-12 21:42:43.35254
43356,0,7,1,11,17,36,2022-05-12 21:42:47.865212
43357,0,9,1,9,16,35,2022-05-12 21:42:48.815546
43358,0,8,1,8,15,32,2022-05-12 21:42:49.665787
43359,0,9,1,9,13,32,2022-05-12 21:42:50.521702
43365,0,14,2,11,13,40,2022-05-12 21:42:53.402222
43367,0,12,2,9,15,38,2022-05-12 21:42:54.4831
43398,4,93,2,5,19,123,2022-05-12 21:43:04.396225
43406,0,11,2,7,13,33,2022-05-12 21:43:09.590056
43409,0,9,2,8,12,31,2022-05-12 21:43:12.04136
43410,0,16,2,9,15,42,2022-05-12 21:43:13.339832
43412,0,9,1,8,14,32,2022-05-12 21:43:15.381262
43415,6,169,3,5,35,218,2022-05-12 21:43:18.839484
43416,37,19,16,110,252,434,2022-05-12 21:43:20.950546
43418,16,244,7,13,98,378,2022-05-12 21:43:22.596286
43435,8,143,2,6,22,181,2022-05-12 21:43:34.651398
43439,20529,71764,5749,6376,63352,167770,2022-05-12 21:43:36.526241
43448,0,3,0,10,19,32,2022-05-12 21:43:40.705058
43450,0,6,0,10,17,33,2022-05-12 21:43:43.049365
43454,0,4,0,12,15,31,2022-05-12 21:43:43.947726
43462,0,13,2,8,14,37,2022-05-12 21:43:47.267678
43463,0,9,1,8,13,31,2022-05-12 21:43:48.827222
43464,1,4,2,9,13,29,2022-05-12 21:43:49.747307
46448,0,0,0,0,0,0,2022-05-12 22:07:33.593671
43470,36098,2,1066,1055,53486,91707,2022-05-12 21:43:51.54671
43476,0,0,0,0,0,0,2022-05-12 21:43:52.892409
43482,0,0,0,0,0,0,2022-05-12 21:43:55.700429
43489,4,50,1,18,26,99,2022-05-12 21:43:57.922682
43496,0,13,1,8,12,34,2022-05-12 21:44:00.073053
43502,0,11,1,10,12,34,2022-05-12 21:44:03.079587
43515,0,11,1,10,10,32,2022-05-12 21:44:08.326807
43518,0,10,0,10,14,34,2022-05-12 21:44:09.812309
43520,0,14,1,8,13,36,2022-05-12 21:44:12.187628
46452,0,0,0,0,0,0,2022-05-12 22:07:35.394448
43522,7,900,3,9,40,959,2022-05-12 21:44:14.02586
43523,28424,175278,3172,5009,58254,270137,2022-05-12 21:44:14.479068
43531,2,55,3,21,23,104,2022-05-12 21:44:16.06292
43538,0,6,1,12,12,31,2022-05-12 21:44:18.173084
43545,1,14,1,8,13,37,2022-05-12 21:44:20.345741
43550,2,65,3,10,15,95,2022-05-12 21:44:21.763091
43555,1476,28472,400,386,12754,43488,2022-05-12 21:44:25.826658
43556,0,0,0,0,12522,12522,2022-05-12 21:44:26.022024
46456,0,0,0,0,0,0,2022-05-12 22:07:38.875203
43568,72,4382,35,46,716,5251,2022-05-12 21:44:32.063957
43570,0,14,1,9,12,36,2022-05-12 21:44:34.567335
43571,0,11,0,8,17,36,2022-05-12 21:44:35.453369
43573,0,9,0,10,13,32,2022-05-12 21:44:36.927637
43578,0,10,2,9,13,34,2022-05-12 21:44:38.802998
43579,1,15,0,11,12,39,2022-05-12 21:44:39.715151
43586,0,10,1,9,14,34,2022-05-12 21:44:42.007707
43605,0,12,1,10,10,33,2022-05-12 21:44:47.286624
43620,1,12,0,8,15,36,2022-05-12 21:44:51.595324
43623,0,11,1,9,14,35,2022-05-12 21:44:53.180549
43626,760,0,63,112,331,1266,2022-05-12 21:44:55.3496
43628,3,72,2,6,15,98,2022-05-12 21:44:56.558083
43633,0,7,1,9,12,29,2022-05-12 21:45:00.042069
43634,0,23,2,9,11,45,2022-05-12 21:45:00.969713
43636,0,9,1,10,13,33,2022-05-12 21:45:01.762435
43637,0,26,1,7,12,46,2022-05-12 21:45:02.649445
43651,0,35,2,11,12,60,2022-05-12 21:45:07.454624
43653,1,15,1,7,11,35,2022-05-12 21:45:08.906584
43654,0,7,1,9,12,29,2022-05-12 21:45:09.995254
43655,0,7,1,10,13,31,2022-05-12 21:45:10.898322
43659,0,15,2,10,11,38,2022-05-12 21:45:13.803451
43660,0,9,2,9,10,30,2022-05-12 21:45:14.655669
43662,0,8,0,13,11,32,2022-05-12 21:45:15.788155
43664,0,10,2,8,11,31,2022-05-12 21:45:16.818505
43688,3,71,2,6,18,100,2022-05-12 21:45:23.451614
43689,1,75,1,9,17,103,2022-05-12 21:45:24.451938
43690,17616,146856,5787,12125,57733,240117,2022-05-12 21:45:24.617348
43704,5,89,2,7,31,134,2022-05-12 21:45:28.227128
43711,35,615,9,29,254,942,2022-05-12 21:45:28.678411
43735,7650,2,747,2169,8868,19436,2022-05-12 21:45:29.464309
43755,207,149,144,31,8690,9221,2022-05-12 21:45:33.413134
43756,12194,34546,3243,3960,32827,86770,2022-05-12 21:45:36.480326
43761,1,58,2,6,18,85,2022-05-12 21:45:42.791213
43762,60,54,46,29,3011,3200,2022-05-12 21:45:45.574681
43763,1669,6675,425,2836,6585,18190,2022-05-12 21:45:48.310766
43767,4128,8206,1108,3435,22653,39530,2022-05-12 21:45:48.478128
43768,3,71,5,6,17,102,2022-05-12 21:45:49.886873
43769,121,0,65,28,118,332,2022-05-12 21:45:50.068877
43778,44,73,13,68,254,452,2022-05-12 21:45:57.525131
43779,808,2496,224,342,3636,7506,2022-05-12 21:46:00.567112
43787,1,64,3,6,20,94,2022-05-12 21:46:04.01185
43794,0,15,1,12,11,39,2022-05-12 21:46:05.567947
43795,0,12,1,10,13,36,2022-05-12 21:46:06.425975
43796,0,6,1,11,12,30,2022-05-12 21:46:07.306642
43799,0,12,2,8,12,34,2022-05-12 21:46:10.364563
43800,0,10,1,9,11,31,2022-05-12 21:46:11.402662
43802,0,11,1,11,12,35,2022-05-12 21:46:13.403719
43803,0,6,0,13,13,32,2022-05-12 21:46:14.276582
46958,0,0,0,0,0,0,2022-05-12 22:10:49.557036
43814,18262,80735,3265,6618,35938,144818,2022-05-12 21:46:16.573919
43823,1,8,1,3,6,19,2022-05-12 21:46:18.637292
43827,2,9,0,4,5,20,2022-05-12 21:46:20.916428
43830,1,4,0,4,8,17,2022-05-12 21:46:22.098182
43843,0,3,0,6,10,19,2022-05-12 21:46:25.604285
43846,1,8,1,3,6,19,2022-05-12 21:46:27.168021
43847,1,7,1,4,6,19,2022-05-12 21:46:27.991739
43851,1,18,0,2,5,26,2022-05-12 21:46:29.230254
43860,0,1,0,6,9,16,2022-05-12 21:46:32.123978
43879,10,514,1,7,52,584,2022-05-12 21:46:41.387496
43882,0,0,0,0,0,0,2022-05-12 21:46:43.788106
43885,0,0,0,0,0,0,2022-05-12 21:46:45.435338
43888,0,4,0,13,10,27,2022-05-12 21:46:48.082373
43892,0,2,0,7,9,18,2022-05-12 21:46:52.239591
43894,0,5,2,4,8,19,2022-05-12 21:46:53.227939
43901,0,2,1,7,7,17,2022-05-12 21:46:55.741663
43908,2,11,0,3,6,22,2022-05-12 21:46:58.106787
43915,2,10,0,3,6,21,2022-05-12 21:47:00.574457
43918,1,3,2,4,7,17,2022-05-12 21:47:01.91415
43991,2,29,0,22,27,80,2022-05-12 21:47:27.355799
43993,1,25,0,23,25,74,2022-05-12 21:47:29.782718
43994,1,26,0,24,25,76,2022-05-12 21:47:31.106554
43998,2,28,2,24,24,80,2022-05-12 21:47:33.556966
43999,1,25,2,23,27,78,2022-05-12 21:47:35.094446
44001,2,28,0,23,28,81,2022-05-12 21:47:39.532423
44003,2,30,0,26,32,90,2022-05-12 21:47:42.575109
44004,1,22,0,22,32,77,2022-05-12 21:47:43.651528
44006,3,21,2,25,42,93,2022-05-12 21:47:46.673194
44007,2,22,2,25,33,84,2022-05-12 21:47:47.761923
44010,2,26,2,24,27,81,2022-05-12 21:47:51.475641
44012,1,23,1,24,28,77,2022-05-12 21:47:53.472319
44013,1,20,1,27,29,78,2022-05-12 21:47:54.482088
44014,3,11,0,15,23,52,2022-05-12 21:47:55.45696
44016,0,4,0,8,8,20,2022-05-12 21:47:57.299995
44017,0,3,0,8,8,19,2022-05-12 21:47:58.697411
44026,6,30,3,49,66,154,2022-05-12 21:48:03.657308
44040,182,1275,71,464,460,2452,2022-05-12 21:48:08.412292
44041,160,332,50,160,512,1214,2022-05-12 21:48:10.412264
44042,20152,2,2315,2027,20600,45096,2022-05-12 21:48:10.584404
44044,3548,12851,877,1509,14716,33501,2022-05-12 21:48:14.047325
44046,1,60,0,4,11,76,2022-05-12 21:48:15.566239
44047,249,439,40,99,261,1088,2022-05-12 21:48:17.175705
44048,17,32,5,35,131,220,2022-05-12 21:48:18.515448
44053,47,12,12,37,104,212,2022-05-12 21:48:19.299871
44055,27073,34751,1809,2719,44520,110872,2022-05-12 21:48:19.545899
44059,557,23205,125,54,8291,32232,2022-05-12 21:48:19.902616
44060,0,1,0,0,339,340,2022-05-12 21:48:25.684742
44061,74,2290,30,50,570,3014,2022-05-12 21:48:26.137401
44062,211,122,70,71,971,1445,2022-05-12 21:48:28.920405
44064,733,1476,118,268,2823,5418,2022-05-12 21:48:32.279152
44065,318,441,56,81,945,1841,2022-05-12 21:48:34.897888
46961,0,0,0,0,0,0,2022-05-12 22:10:50.653389
44067,165,483,52,60,1341,2101,2022-05-12 21:48:37.48726
44068,403,1162,69,85,1085,2804,2022-05-12 21:48:39.752556
44069,9996,26566,1518,893,28431,67404,2022-05-12 21:48:42.881226
44070,684,20698,186,190,8182,29940,2022-05-12 21:48:45.607422
44071,265,668,33,71,496,1533,2022-05-12 21:48:47.541394
44074,23088,69655,5283,2596,102675,203297,2022-05-12 21:48:51.242482
44075,43,76,19,59,335,532,2022-05-12 21:48:52.684416
44078,83,87,23,35,249,477,2022-05-12 21:48:57.980973
44084,7,245,2,4,37,295,2022-05-12 21:49:03.370459
44086,26,1347,9,25,188,1595,2022-05-12 21:49:05.325863
44093,0,0,0,0,0,0,2022-05-12 21:49:12.757656
44096,36,31,11,30,242,350,2022-05-12 21:49:14.577311
44097,143,439,55,67,907,1611,2022-05-12 21:49:17.006307
44099,7,71,2,6,20,106,2022-05-12 21:49:18.717339
44103,0,4,0,9,8,21,2022-05-12 21:49:21.536919
44105,0,4,0,9,8,21,2022-05-12 21:49:23.572912
47003,0,0,0,0,0,0,2022-05-12 22:11:05.29378
44111,0,4,0,9,8,21,2022-05-12 21:49:27.166731
44112,0,3,0,7,8,18,2022-05-12 21:49:27.993612
44116,0,4,0,7,8,19,2022-05-12 21:49:29.237424
44122,0,3,0,7,9,19,2022-05-12 21:49:31.666843
44129,97,1331,35,77,742,2282,2022-05-12 21:49:35.481672
44130,6,15,0,7,14,42,2022-05-12 21:49:36.477385
44132,5,18,4,13,56,96,2022-05-12 21:49:39.001175
47008,0,0,0,0,0,0,2022-05-12 22:11:08.086395
44133,1,13,0,12,19,45,2022-05-12 21:49:40.124525
44135,0,8,1,8,14,31,2022-05-12 21:49:40.972292
44137,0,5,0,8,10,23,2022-05-12 21:49:42.798736
44138,0,5,0,7,10,22,2022-05-12 21:49:43.644787
44145,0,14,0,15,16,45,2022-05-12 21:49:46.158462
44148,0,13,1,22,21,57,2022-05-12 21:49:47.31731
44152,0,13,1,18,19,51,2022-05-12 21:49:48.44549
44162,0,11,0,12,21,44,2022-05-12 21:49:50.972224
44164,0,10,0,12,16,38,2022-05-12 21:49:52.652303
44166,0,5,0,13,15,33,2022-05-12 21:49:55.092387
44167,3,8,0,15,73,99,2022-05-12 21:49:56.336504
44168,0,2,0,5,9,16,2022-05-12 21:49:57.694219
44171,0,5,0,11,17,33,2022-05-12 21:50:00.561048
44181,0,2,0,8,10,20,2022-05-12 21:50:02.836048
44184,0,3,0,5,8,16,2022-05-12 21:50:04.127394
44189,192,4023,58,94,575,4942,2022-05-12 21:50:08.364885
44196,1025,2694,210,210,2022,6161,2022-05-12 21:50:14.801772
44200,3294,67577,1461,340,90857,163529,2022-05-12 21:50:15.07861
44203,29947,158622,3341,8145,51963,252018,2022-05-12 21:50:16.430556
44204,3,0,3,0,55220,55226,2022-05-12 21:50:16.613646
44221,633,2614,149,139,2347,5882,2022-05-12 21:50:17.503938
44224,6,233,4,5,28,276,2022-05-12 21:50:23.202699
44225,2,57,4,14,42,119,2022-05-12 21:50:24.427394
44228,31,68,15,44,267,425,2022-05-12 21:50:25.887855
44235,1238,7480,266,416,2127,11527,2022-05-12 21:50:31.698088
44236,120,1166,30,73,867,2256,2022-05-12 21:50:33.961238
44245,1,47,2,16,21,87,2022-05-12 21:50:35.950288
44248,12107,8032,2980,499,16578,40196,2022-05-12 21:50:38.616781
44254,4,324,2,5,20,355,2022-05-12 21:50:45.850209
44255,0,0,0,0,0,0,2022-05-12 21:50:47.032267
44257,3,87,2,1,13,106,2022-05-12 21:50:49.406054
44258,0,0,0,0,0,0,2022-05-12 21:50:50.7052
44281,0,0,0,0,0,0,2022-05-12 21:50:59.34474
44282,0,3,0,7,9,19,2022-05-12 21:51:00.370277
44287,0,3,0,7,10,20,2022-05-12 21:51:02.532636
44314,0,0,0,0,0,0,2022-05-12 21:51:09.689292
44317,0,0,0,0,0,0,2022-05-12 21:51:10.792495
44328,0,0,0,0,0,0,2022-05-12 21:51:15.622518
44339,0,0,0,0,0,0,2022-05-12 21:51:18.12603
44341,0,0,0,0,0,0,2022-05-12 21:51:19.356826
44351,0,2,0,5,9,16,2022-05-12 21:51:26.548949
44355,0,0,0,0,0,0,2022-05-12 21:51:30.926574
44358,0,2,0,5,11,18,2022-05-12 21:51:33.564411
44363,0,2,0,6,11,19,2022-05-12 21:51:37.804167
44389,303,0,31,50,394,778,2022-05-12 21:51:44.596459
44393,0,4,0,5,10,19,2022-05-12 21:51:45.825397
44397,0,5,0,5,9,19,2022-05-12 21:51:48.157841
44408,0,0,0,0,410,410,2022-05-12 21:51:53.405404
44411,71,111,30,39,581,832,2022-05-12 21:51:58.40694
44413,0,2,0,5,9,16,2022-05-12 21:52:01.706544
44414,0,3,0,6,10,19,2022-05-12 21:52:02.577243
44415,0,3,0,6,10,19,2022-05-12 21:52:03.361591
44419,0,3,0,6,10,19,2022-05-12 21:52:07.883666
44420,0,3,0,5,9,17,2022-05-12 21:52:09.150069
47358,0,0,0,0,0,0,2022-05-12 22:13:38.167592
44421,0,3,0,6,9,18,2022-05-12 21:52:09.973533
44422,0,3,0,5,9,17,2022-05-12 21:52:11.272329
44423,0,3,0,6,9,18,2022-05-12 21:52:12.721382
44424,0,3,0,6,9,18,2022-05-12 21:52:14.087329
44425,0,3,0,5,9,17,2022-05-12 21:52:15.326446
44427,0,3,0,5,8,16,2022-05-12 21:52:16.873609
44445,0,3,0,6,9,18,2022-05-12 21:52:23.529623
44447,0,3,0,6,9,18,2022-05-12 21:52:24.625574
44456,0,3,0,6,10,19,2022-05-12 21:52:27.108921
44459,0,2,0,5,10,17,2022-05-12 21:52:28.351378
44465,0,2,0,8,10,20,2022-05-12 21:52:30.684552
44468,0,1,0,8,10,19,2022-05-12 21:52:31.942224
44474,0,2,1,7,9,19,2022-05-12 21:52:36.550212
44487,0,1,0,8,10,19,2022-05-12 21:52:46.282613
44490,2,7,0,11,20,40,2022-05-12 21:52:47.496646
44496,0,2,0,8,11,21,2022-05-12 21:52:49.904759
44499,0,4,1,6,9,20,2022-05-12 21:52:51.086354
47361,0,0,0,0,0,0,2022-05-12 22:13:39.315406
44513,138,551,27,75,286,1077,2022-05-12 21:52:55.646754
44516,23395,31679,2704,7468,47442,112688,2022-05-12 21:52:57.956305
44517,2,8,0,4,6,20,2022-05-12 21:52:59.538552
44520,0,0,0,0,0,0,2022-05-12 21:53:01.426263
44522,0,0,0,0,0,0,2022-05-12 21:53:03.648926
44523,0,0,0,0,0,0,2022-05-12 21:53:04.518647
44526,0,0,0,0,0,0,2022-05-12 21:53:06.819359
44532,1,4,1,5,7,18,2022-05-12 21:53:10.272216
44573,0,3,0,6,9,18,2022-05-12 21:53:22.496564
44582,0,16,0,4,10,30,2022-05-12 21:53:26.193759
44588,14,134,3,17,118,286,2022-05-12 21:53:34.68165
44590,32,532,45,51,532,1192,2022-05-12 21:53:34.874878
44591,45,239,30,44,229,587,2022-05-12 21:53:36.895637
44595,0,5,2,5,5,17,2022-05-12 21:53:39.526757
44596,0,5,1,5,5,16,2022-05-12 21:53:40.370204
44603,0,0,0,0,0,0,2022-05-12 21:53:43.947157
44610,0,5,0,6,6,17,2022-05-12 21:53:46.650211
44611,0,5,0,6,7,18,2022-05-12 21:53:47.760601
47380,0,0,0,0,0,0,2022-05-12 22:13:46.650252
44616,39,325,17,40,1096,1517,2022-05-12 21:53:51.194869
44618,0,4,0,5,8,17,2022-05-12 21:53:54.146285
44620,2,8,1,3,12,26,2022-05-12 21:53:56.29344
44623,1,3,0,9,12,25,2022-05-12 21:53:59.451296
44636,0,3,0,8,8,19,2022-05-12 21:54:04.521892
44639,0,3,0,6,9,18,2022-05-12 21:54:05.716364
44642,1,14,0,2,4,21,2022-05-12 21:54:06.896212
44653,0,4,0,6,6,16,2022-05-12 21:54:12.003138
44654,1,10,0,2,5,18,2022-05-12 21:54:12.915793
44664,4,13,1,9,23,50,2022-05-12 21:54:16.544174
44668,0,3,0,6,8,17,2022-05-12 21:54:18.922625
44683,0,0,0,0,0,0,2022-05-12 21:54:25.209562
44686,0,0,0,0,0,0,2022-05-12 21:54:27.759356
44704,0,0,0,0,0,0,2022-05-12 21:54:36.888346
44708,0,0,0,0,0,0,2022-05-12 21:54:39.279567
44720,0,0,0,0,0,0,2022-05-12 21:54:43.988443
44723,0,0,0,0,0,0,2022-05-12 21:54:45.170228
44733,0,0,0,0,0,0,2022-05-12 21:54:50.616282
44734,0,0,0,0,0,0,2022-05-12 21:54:51.496446
44736,0,0,0,0,0,0,2022-05-12 21:54:52.609929
44748,0,0,0,0,0,0,2022-05-12 21:54:57.318608
44752,15,179,5,28,244,471,2022-05-12 21:54:59.184344
44775,2,89,1,14,31,137,2022-05-12 21:55:11.063799
44781,0,0,0,0,0,0,2022-05-12 21:55:14.912698
44782,0,0,0,0,0,0,2022-05-12 21:55:16.371639
44784,0,0,0,0,0,0,2022-05-12 21:55:17.90405
44788,0,0,0,0,0,0,2022-05-12 21:55:20.304393
44790,0,0,0,0,0,0,2022-05-12 21:55:21.824093
44796,0,0,0,0,0,0,2022-05-12 21:55:23.638141
44807,3278,48036,855,266,44170,96605,2022-05-12 21:55:27.425561
44830,0,0,0,0,0,0,2022-05-12 21:55:33.347959
44840,1,16,1,26,23,67,2022-05-12 21:55:36.028939
44853,0,0,0,0,0,0,2022-05-12 21:55:40.480702
44873,0,0,0,0,0,0,2022-05-12 21:55:46.534699
44877,0,0,0,0,0,0,2022-05-12 21:55:49.004123
44880,0,3,0,7,8,18,2022-05-12 21:55:50.195277
44896,0,3,0,6,9,18,2022-05-12 21:55:57.322936
44899,0,3,0,6,8,17,2022-05-12 21:55:58.561632
44911,0,3,0,9,10,22,2022-05-12 21:56:03.391598
44916,0,0,0,0,0,0,2022-05-12 21:56:07.599325
44919,0,0,0,0,0,0,2022-05-12 21:56:09.325871
44929,0,0,0,0,0,0,2022-05-12 21:56:13.183234
44931,1487,66308,402,143,34177,102517,2022-05-12 21:56:13.521437
44940,9995,31053,1044,590,36249,78931,2022-05-12 21:56:14.887671
44957,0,3,0,6,8,17,2022-05-12 21:56:21.762228
47694,0,0,0,0,0,0,2022-05-12 22:16:08.425963
44958,1,2,0,6,9,18,2022-05-12 21:56:22.722888
44960,0,0,0,0,0,0,2022-05-12 21:56:23.707262
44964,0,3,0,6,8,17,2022-05-12 21:56:25.475846
44965,0,0,0,0,0,0,2022-05-12 21:56:26.313036
44967,0,0,0,0,0,0,2022-05-12 21:56:27.720258
44973,0,0,0,0,0,0,2022-05-12 21:56:32.097857
44980,0,0,0,0,0,0,2022-05-12 21:56:34.781685
44982,0,0,0,0,0,0,2022-05-12 21:56:36.338076
44983,1069,29623,428,214,24865,56199,2022-05-12 21:56:39.737316
44988,0,0,0,0,0,0,2022-05-12 21:56:45.213577
44991,0,0,0,0,0,0,2022-05-12 21:56:48.9518
44995,0,0,0,0,0,0,2022-05-12 21:56:52.751862
45011,0,2,0,7,8,17,2022-05-12 21:57:00.249438
45015,0,0,0,0,0,0,2022-05-12 21:57:03.380922
45016,0,0,0,0,0,0,2022-05-12 21:57:04.162173
45024,0,2,0,6,8,16,2022-05-12 21:57:08.751331
45032,0,4,0,7,7,18,2022-05-12 21:57:11.081136
45053,8,239,2,10,40,299,2022-05-12 21:57:18.494317
45055,13073,43569,2469,3167,35984,98262,2022-05-12 21:57:18.931745
45062,0,0,0,0,0,0,2022-05-12 21:57:20.747025
45064,0,0,0,0,0,0,2022-05-12 21:57:21.823297
45071,0,0,0,0,0,0,2022-05-12 21:57:23.528145
45079,0,2,0,8,10,20,2022-05-12 21:57:25.393937
45082,0,0,0,0,0,0,2022-05-12 21:57:26.62888
45085,0,4,1,8,9,22,2022-05-12 21:57:27.830626
45102,0,0,0,0,0,0,2022-05-12 21:57:33.836816
45262,1,7,1,14,19,42,2022-05-12 21:58:36.332011
45279,0,0,0,0,0,0,2022-05-12 21:58:42.362081
45282,0,0,0,0,0,0,2022-05-12 21:58:43.648693
45289,0,0,0,0,0,0,2022-05-12 21:58:45.785577
45302,1,7,1,16,18,43,2022-05-12 21:58:49.791715
45303,0,0,0,0,0,0,2022-05-12 21:58:51.127794
45308,0,0,0,0,0,0,2022-05-12 21:58:57.47035
45314,0,0,0,0,0,0,2022-05-12 21:59:01.534743
45328,0,0,0,0,0,0,2022-05-12 21:59:07.45161
45335,0,0,0,0,0,0,2022-05-12 21:59:09.768882
45351,0,0,0,0,0,0,2022-05-12 21:59:14.696732
45363,0,0,0,0,0,0,2022-05-12 21:59:18.307708
45376,0,2,1,8,11,22,2022-05-12 21:59:22.517828
47923,0,0,0,0,0,0,2022-05-12 22:17:58.041565
47925,0,0,0,0,0,0,2022-05-12 22:17:59.58073
45387,0,2,0,8,11,21,2022-05-12 21:59:25.593686
45396,0,3,1,8,9,21,2022-05-12 21:59:29.210139
45399,0,5,1,7,7,20,2022-05-12 21:59:31.217324
45400,0,2,0,9,10,21,2022-05-12 21:59:32.107909
45401,0,3,0,7,10,20,2022-05-12 21:59:32.969919
45403,0,2,0,6,10,18,2022-05-12 21:59:34.016796
45408,0,0,0,0,0,0,2022-05-12 21:59:37.932355
45413,0,0,0,0,0,0,2022-05-12 21:59:44.54072
45414,0,0,0,0,0,0,2022-05-12 21:59:45.612224
45418,0,0,0,0,0,0,2022-05-12 21:59:47.05038
45422,0,0,0,0,0,0,2022-05-12 21:59:48.588886
45424,0,0,0,0,0,0,2022-05-12 21:59:49.554193
45448,21,36,5,35,86,183,2022-05-12 21:59:59.615647
45468,0,0,0,0,0,0,2022-05-12 22:00:06.334448
45485,0,0,0,0,0,0,2022-05-12 22:00:12.312674
45492,0,0,0,0,0,0,2022-05-12 22:00:14.848918
45495,0,0,0,0,0,0,2022-05-12 22:00:15.993969
45516,0,0,0,0,0,0,2022-05-12 22:00:23.214599
45519,1,9,1,13,23,47,2022-05-12 22:00:24.415709
45523,1,9,1,15,20,46,2022-05-12 22:00:27.116129
45524,1,7,0,13,20,41,2022-05-12 22:00:27.955207
45528,1,10,1,17,18,47,2022-05-12 22:00:29.298688
45530,1,10,1,17,18,47,2022-05-12 22:00:30.519405
45532,2,19,1,12,19,53,2022-05-12 22:00:32.269414
45533,1,6,0,13,21,41,2022-05-12 22:00:33.239303
45535,1,14,0,12,21,48,2022-05-12 22:00:35.225499
45538,1,12,0,12,19,44,2022-05-12 22:00:39.526441
45539,1,12,0,18,23,54,2022-05-12 22:00:40.546967
45552,0,0,0,0,0,0,2022-05-12 22:00:48.536104
45556,1920,22630,401,254,9332,34537,2022-05-12 22:00:51.611417
47927,0,0,0,0,0,0,2022-05-12 22:18:01.181041
45558,76,860,18,52,401,1407,2022-05-12 22:00:54.355123
45560,14343,19064,1606,8383,26582,69978,2022-05-12 22:00:54.573702
45562,4,35,4,12,33,88,2022-05-12 22:00:55.879513
45567,299,1688,191,249,2890,5317,2022-05-12 22:00:56.051392
45571,4,52,2,8,47,113,2022-05-12 22:00:57.429445
45572,12559,35839,2856,6435,51993,109682,2022-05-12 22:00:57.616982
45574,68,2047,19,44,406,2584,2022-05-12 22:01:03.655255
45576,74032,383371,5236,3123,108563,574325,2022-05-12 22:01:03.827031
45577,1567,4847,325,380,7885,15004,2022-05-12 22:01:04.092668
45582,4,86,3,7,29,129,2022-05-12 22:01:05.457452
45584,8,74,3,15,105,205,2022-05-12 22:01:08.741705
45585,66,460,45,98,809,1478,2022-05-12 22:01:09.1167
45587,791,3181,173,689,1668,6502,2022-05-12 22:01:11.878637
45596,46,140,19,100,307,612,2022-05-12 22:01:15.707536
45599,154,936,26,71,313,1500,2022-05-12 22:01:21.378663
45600,113,187,29,84,231,644,2022-05-12 22:01:22.838521
45604,988,22331,331,139,9129,32918,2022-05-12 22:01:26.006621
45605,108,214,29,10,536,897,2022-05-12 22:01:27.79937
45611,7,109,2,30,54,202,2022-05-12 22:01:29.654193
45612,38,66,10,43,117,274,2022-05-12 22:01:30.817098
45613,162345,1,3432,12084,116445,294307,2022-05-12 22:01:30.988997
45615,2,125,1,12,25,165,2022-05-12 22:01:32.699308
45618,120,170,44,146,1400,1880,2022-05-12 22:01:36.924859
45620,132,232,81,27,3654,4126,2022-05-12 22:01:38.296428
45645,2,42,5,25,63,137,2022-05-12 22:01:47.422372
45649,0,0,0,0,6508,6508,2022-05-12 22:01:50.096696
45653,1,0,1,0,40002,40004,2022-05-12 22:01:50.419563
45660,1,7,0,13,22,43,2022-05-12 22:01:55.524827
45661,1,6,0,12,22,41,2022-05-12 22:01:56.354716
45662,1,8,0,13,21,43,2022-05-12 22:01:57.503866
45665,2216,3980,630,2776,9450,19052,2022-05-12 22:02:02.421729
45673,0,0,0,0,0,0,2022-05-12 22:02:08.25462
45682,1,6,1,12,19,39,2022-05-12 22:02:12.362398
45683,1,5,0,10,22,38,2022-05-12 22:02:13.239892
45686,0,0,0,0,0,0,2022-05-12 22:02:15.916448
45688,1,7,0,14,22,44,2022-05-12 22:02:17.808937
45697,1,8,0,13,22,44,2022-05-12 22:02:22.858735
45698,2,11,1,18,27,59,2022-05-12 22:02:23.952404
45703,1,7,1,16,18,43,2022-05-12 22:02:26.567397
45705,1,8,0,15,22,46,2022-05-12 22:02:28.895897
45707,1,5,0,16,17,39,2022-05-12 22:02:31.550915
45709,0,0,0,0,0,0,2022-05-12 22:02:33.949673
45710,0,0,0,0,0,0,2022-05-12 22:02:35.385495
45711,0,0,0,0,0,0,2022-05-12 22:02:36.13548
45717,0,0,0,0,0,0,2022-05-12 22:02:39.365502
45731,0,0,0,0,1267,1267,2022-05-12 22:02:44.223342
45733,0,0,0,0,0,0,2022-05-12 22:02:45.082639
45734,0,0,0,0,0,0,2022-05-12 22:02:45.881092
45735,0,0,0,0,0,0,2022-05-12 22:02:46.649256
45740,0,0,0,0,0,0,2022-05-12 22:02:50.345028
45748,0,0,0,0,0,0,2022-05-12 22:02:53.997938
45750,0,0,0,0,0,0,2022-05-12 22:02:55.046741
45754,0,0,0,0,0,0,2022-05-12 22:02:56.140747
45763,1,4,0,13,22,40,2022-05-12 22:02:59.629484
45764,1,8,0,13,23,45,2022-05-12 22:03:00.551584
45765,2,8,0,16,28,54,2022-05-12 22:03:01.442513
47966,0,0,0,0,0,0,2022-05-12 22:18:31.34731
47967,0,0,0,0,0,0,2022-05-12 22:18:32.269107
45766,1,5,0,13,21,40,2022-05-12 22:03:02.549109
45770,1,4,0,14,20,39,2022-05-12 22:03:04.711402
45790,1,7,0,12,19,39,2022-05-12 22:03:10.784962
45795,0,0,0,0,0,0,2022-05-12 22:03:13.000404
45812,2,6,0,14,23,45,2022-05-12 22:03:19.131692
45821,0,3,0,6,9,18,2022-05-12 22:03:21.868501
45850,0,0,0,0,0,0,2022-05-12 22:03:28.576992
45862,1,6,0,16,20,43,2022-05-12 22:03:32.917011
45863,0,0,0,0,0,0,2022-05-12 22:03:33.729428
45865,0,0,0,0,0,0,2022-05-12 22:03:34.671609
45869,1,5,0,14,19,39,2022-05-12 22:03:37.903895
45915,1,8,0,11,22,42,2022-05-12 22:03:54.695838
45916,2,3,0,14,23,42,2022-05-12 22:03:55.685389
45919,0,0,0,0,0,0,2022-05-12 22:03:56.387095
45935,9,12,0,19,109,149,2022-05-12 22:04:01.401633
45938,0,0,0,0,0,0,2022-05-12 22:04:02.161212
45968,0,0,0,0,0,0,2022-05-12 22:04:12.100071
45976,0,3,0,5,9,17,2022-05-12 22:04:15.595216
45980,0,3,0,6,8,17,2022-05-12 22:04:17.947879
45983,0,3,0,6,8,17,2022-05-12 22:04:19.702787
45985,0,3,0,6,8,17,2022-05-12 22:04:21.563488
45988,0,3,0,6,8,17,2022-05-12 22:04:22.721291
45991,0,0,0,0,0,0,2022-05-12 22:04:23.768384
45998,0,3,0,6,8,17,2022-05-12 22:04:25.022069
46005,0,3,0,6,8,17,2022-05-12 22:04:28.204456
46015,0,0,0,0,0,0,2022-05-12 22:04:33.385407
46019,0,0,0,0,0,0,2022-05-12 22:04:34.902546
46027,0,0,0,0,0,0,2022-05-12 22:04:37.346278
46031,0,0,0,0,0,0,2022-05-12 22:04:39.408115
46039,0,0,0,0,0,0,2022-05-12 22:04:41.812186
46045,0,0,0,0,0,0,2022-05-12 22:04:45.721353
46095,54985,193936,12909,9207,143461,414498,2022-05-12 22:04:57.482374
46126,1,7,0,13,21,42,2022-05-12 22:05:19.262548
46136,0,0,0,0,0,0,2022-05-12 22:05:22.70952
46138,0,0,0,0,0,0,2022-05-12 22:05:23.872823
46141,0,0,0,0,0,0,2022-05-12 22:05:25.317028
46154,2,9,0,14,20,45,2022-05-12 22:05:34.813274
46172,1,6,0,13,18,38,2022-05-12 22:05:41.408329
46175,0,0,0,0,0,0,2022-05-12 22:05:43.807386
46183,0,0,0,0,0,0,2022-05-12 22:05:46.82287
46186,0,0,0,0,0,0,2022-05-12 22:05:47.946166
46195,0,0,0,0,0,0,2022-05-12 22:05:51.48407
46224,0,0,0,0,0,0,2022-05-12 22:05:58.813853
46227,0,0,0,0,0,0,2022-05-12 22:05:59.940117
46247,0,0,0,0,0,0,2022-05-12 22:06:05.950611
46256,1,4,0,12,22,39,2022-05-12 22:06:08.843152
46269,0,0,0,0,0,0,2022-05-12 22:06:14.505439
46278,0,0,0,0,0,0,2022-05-12 22:06:18.016018
46293,1,3,0,14,22,40,2022-05-12 22:06:25.334758
46298,0,0,0,0,0,0,2022-05-12 22:06:29.112678
46299,1,9,0,13,24,47,2022-05-12 22:06:30.440093
46303,0,0,0,0,0,0,2022-05-12 22:06:32.588638
46319,0,0,0,0,0,0,2022-05-12 22:06:37.449616
46329,0,0,0,0,0,0,2022-05-12 22:06:42.11078
46330,0,0,0,0,0,0,2022-05-12 22:06:42.936764
46339,0,0,0,0,0,0,2022-05-12 22:06:48.125446
46342,0,0,0,0,0,0,2022-05-12 22:06:49.266388
46349,0,0,0,0,0,0,2022-05-12 22:06:53.107807
46353,0,0,0,0,0,0,2022-05-12 22:06:55.140281
46357,0,0,0,0,0,0,2022-05-12 22:06:56.562238
46371,0,0,0,0,0,0,2022-05-12 22:07:04.786578
46374,0,0,0,0,0,0,2022-05-12 22:07:06.052204
46471,51835,90481,11653,39125,102242,295336,2022-05-12 22:07:43.758877
46480,0,0,0,0,0,0,2022-05-12 22:07:47.20821
46481,0,0,0,0,0,0,2022-05-12 22:07:48.010889
46485,0,0,0,0,0,0,2022-05-12 22:07:49.232451
46504,0,0,0,0,0,0,2022-05-12 22:07:56.56504
46507,0,0,0,0,0,0,2022-05-12 22:07:57.935352
46519,0,0,0,0,0,0,2022-05-12 22:08:01.414395
46562,0,0,0,0,0,0,2022-05-12 22:08:14.522473
46566,0,0,0,0,0,0,2022-05-12 22:08:16.883928
46577,0,0,0,0,0,0,2022-05-12 22:08:20.389245
46581,0,0,0,0,0,0,2022-05-12 22:08:21.610471
46591,0,0,0,0,0,0,2022-05-12 22:08:24.074187
46598,0,0,0,0,0,0,2022-05-12 22:08:26.413821
46623,0,0,0,0,0,0,2022-05-12 22:08:31.349053
46636,0,0,0,0,0,0,2022-05-12 22:08:35.447353
46645,0,0,0,0,0,0,2022-05-12 22:08:38.563733
46652,68,40,21,110,399,638,2022-05-12 22:08:42.879131
46655,0,0,0,0,0,0,2022-05-12 22:08:44.890434
46656,0,0,0,0,0,0,2022-05-12 22:08:46.03101
46657,0,0,0,0,0,0,2022-05-12 22:08:46.955267
46658,0,0,0,0,0,0,2022-05-12 22:08:47.791281
46665,0,0,0,0,0,0,2022-05-12 22:08:54.437092
46682,0,0,0,0,0,0,2022-05-12 22:09:00.096352
46688,0,0,0,0,0,0,2022-05-12 22:09:01.500405
46690,0,0,0,0,0,0,2022-05-12 22:09:02.46135
46698,1,5,0,12,20,38,2022-05-12 22:09:05.03821
46703,0,0,0,0,0,0,2022-05-12 22:09:10.033671
46704,1,5,0,14,21,41,2022-05-12 22:09:11.004716
46706,1,14,1,22,23,61,2022-05-12 22:09:13.097626
46709,0,0,0,0,0,0,2022-05-12 22:09:15.826585
46712,0,0,0,0,0,0,2022-05-12 22:09:17.203802
46714,0,0,0,0,0,0,2022-05-12 22:09:18.183325
46717,0,0,0,0,0,0,2022-05-12 22:09:19.251573
46728,1,8,1,19,19,48,2022-05-12 22:09:21.98826
46730,0,0,0,0,0,0,2022-05-12 22:09:23.01945
46735,59,249,22,52,880,1262,2022-05-12 22:09:25.108038
46738,0,0,0,0,0,0,2022-05-12 22:09:27.725881
46751,0,0,0,0,0,0,2022-05-12 22:09:33.764369
46762,0,0,0,0,0,0,2022-05-12 22:09:37.371415
46789,0,0,0,0,0,0,2022-05-12 22:09:45.124915
46797,0,0,0,0,0,0,2022-05-12 22:09:51.418266
46800,0,0,0,0,0,0,2022-05-12 22:09:53.023218
46803,0,0,0,0,0,0,2022-05-12 22:09:54.122849
46827,1,6,0,14,19,40,2022-05-12 22:10:01.483536
46843,0,0,0,0,0,0,2022-05-12 22:10:06.167074
46854,1,3,0,8,12,24,2022-05-12 22:10:10.047202
46858,0,2,0,7,10,19,2022-05-12 22:10:12.219988
46875,0,0,0,0,0,0,2022-05-12 22:10:18.136079
46880,0,0,0,0,0,0,2022-05-12 22:10:19.391708
46895,0,0,0,0,0,0,2022-05-12 22:10:24.248334
46898,0,0,0,0,0,0,2022-05-12 22:10:25.973137
46899,0,0,0,0,0,0,2022-05-12 22:10:26.789417
46901,0,0,0,0,0,0,2022-05-12 22:10:28.305044
46909,0,0,0,0,0,0,2022-05-12 22:10:31.386326
46920,0,0,0,0,0,0,2022-05-12 22:10:35.199987
46924,137,0,25,45,238,445,2022-05-12 22:10:37.893961
46925,0,0,0,0,173,173,2022-05-12 22:10:39.181037
46933,0,0,0,0,0,0,2022-05-12 22:10:42.158316
46937,0,0,0,0,0,0,2022-05-12 22:10:43.36341
46949,1,8,0,13,21,43,2022-05-12 22:10:45.930586
46952,0,0,0,0,0,0,2022-05-12 22:10:47.159264
46955,0,0,0,0,0,0,2022-05-12 22:10:48.245138
47022,2,8,1,14,22,47,2022-05-12 22:11:16.314184
47023,2,13,2,24,26,67,2022-05-12 22:11:17.283169
47025,1,7,0,15,18,41,2022-05-12 22:11:20.102304
47040,0,0,0,0,0,0,2022-05-12 22:11:25.372364
47051,0,0,0,0,0,0,2022-05-12 22:11:27.842216
47061,2,19,1,8,19,49,2022-05-12 22:11:30.375458
47073,0,0,0,0,0,0,2022-05-12 22:11:36.820911
47074,0,0,0,0,0,0,2022-05-12 22:11:37.64406
47093,0,0,0,0,0,0,2022-05-12 22:11:43.968666
47104,0,0,0,0,0,0,2022-05-12 22:11:48.166745
47108,0,0,0,0,0,0,2022-05-12 22:11:49.422659
47116,0,0,0,0,0,0,2022-05-12 22:11:51.871478
47122,1,7,0,14,19,41,2022-05-12 22:11:54.405065
47124,0,0,0,0,0,0,2022-05-12 22:11:55.469158
47131,0,0,0,0,0,0,2022-05-12 22:11:58.49926
47134,0,0,0,0,0,0,2022-05-12 22:12:01.684554
47140,0,0,0,0,0,0,2022-05-12 22:12:05.122312
47153,0,0,0,0,0,0,2022-05-12 22:12:08.78155
47156,0,0,0,0,0,0,2022-05-12 22:12:10.550046
47162,45630,4,1266,3358,34200,84458,2022-05-12 22:12:12.836269
47200,0,0,0,0,0,0,2022-05-12 22:12:25.694046
47203,0,0,0,0,0,0,2022-05-12 22:12:28.131594
47205,0,0,0,0,0,0,2022-05-12 22:12:29.618345
47212,0,0,0,0,0,0,2022-05-12 22:12:31.480075
47216,0,0,0,0,0,0,2022-05-12 22:12:32.746682
47219,0,0,0,0,0,0,2022-05-12 22:12:33.903004
47242,0,0,0,0,0,0,2022-05-12 22:12:41.271023
47244,0,0,0,0,0,0,2022-05-12 22:12:42.609117
47245,0,0,0,0,0,0,2022-05-12 22:12:43.825203
47247,0,0,0,0,0,0,2022-05-12 22:12:45.343313
47248,0,0,0,0,0,0,2022-05-12 22:12:46.848482
47249,0,0,0,0,0,0,2022-05-12 22:12:47.8372
47250,11762,22086,3902,13655,34446,85851,2022-05-12 22:12:50.949556
47251,0,0,0,0,0,0,2022-05-12 22:12:51.996431
47254,6,142,2,5,30,185,2022-05-12 22:12:53.186089
47257,26472,68000,6169,10611,63152,174404,2022-05-12 22:12:53.357968
47260,0,0,0,0,0,0,2022-05-12 22:12:59.748809
47261,0,0,0,0,0,0,2022-05-12 22:13:00.540786
47270,0,11,1,12,19,43,2022-05-12 22:13:05.509017
47274,0,0,0,0,0,0,2022-05-12 22:13:06.920723
47277,0,0,0,0,0,0,2022-05-12 22:13:08.139524
47336,0,0,0,0,0,0,2022-05-12 22:13:30.911954
47398,917,25358,289,301,11228,38093,2022-05-12 22:13:56.955472
47402,81,2962,20,28,793,3884,2022-05-12 22:14:00.253952
47403,74,121,34,64,647,940,2022-05-12 22:14:02.008147
47405,1593,0,141,189,2535,4458,2022-05-12 22:14:02.351897
47409,57,76,26,35,1339,1533,2022-05-12 22:14:04.920433
47410,116,1887,56,70,1375,3504,2022-05-12 22:14:07.366789
47413,273,1547,83,67,3238,5208,2022-05-12 22:14:07.554289
47426,4,90,5,30,52,181,2022-05-12 22:14:11.310986
47456,0,0,0,0,0,0,2022-05-12 22:14:21.397093
47465,0,0,0,0,0,0,2022-05-12 22:14:26.404829
47467,0,0,0,0,0,0,2022-05-12 22:14:27.393701
47487,0,0,0,0,0,0,2022-05-12 22:14:36.087956
47493,0,0,0,0,0,0,2022-05-12 22:14:40.186449
47494,0,0,0,0,0,0,2022-05-12 22:14:40.974631
47507,0,0,0,0,0,0,2022-05-12 22:14:46.606327
47511,0,0,0,0,0,0,2022-05-12 22:14:47.968104
47517,0,0,0,0,0,0,2022-05-12 22:14:51.466306
47532,0,0,0,0,0,0,2022-05-12 22:14:56.281823
47541,1,3,0,8,8,20,2022-05-12 22:14:58.720578
47544,2,3,2,5,5,17,2022-05-12 22:14:59.856491
47548,2,9,0,10,14,35,2022-05-12 22:15:01.542789
47549,1,6,1,9,9,26,2022-05-12 22:15:02.72021
47552,0,3,0,7,8,18,2022-05-12 22:15:04.880029
47554,0,4,0,6,8,18,2022-05-12 22:15:06.164687
47556,1,3,0,6,8,18,2022-05-12 22:15:07.27707
47558,0,3,0,7,8,18,2022-05-12 22:15:08.304084
47566,0,3,0,8,9,20,2022-05-12 22:15:13.005245
47568,0,3,0,6,9,18,2022-05-12 22:15:15.359307
47569,0,3,0,6,8,17,2022-05-12 22:15:16.337847
47570,0,3,0,6,8,17,2022-05-12 22:15:17.182822
47577,0,2,0,8,8,18,2022-05-12 22:15:19.711126
47583,0,4,0,7,8,19,2022-05-12 22:15:21.677823
47589,0,0,0,0,0,0,2022-05-12 22:15:23.961428
47597,0,0,0,0,0,0,2022-05-12 22:15:27.492568
47611,0,5,1,4,9,19,2022-05-12 22:15:32.48078
47620,1,10,1,7,19,38,2022-05-12 22:15:35.365561
47629,0,4,0,6,8,18,2022-05-12 22:15:37.331616
47634,6,28,5,27,57,123,2022-05-12 22:15:38.695501
47635,16,481,12,15,103,627,2022-05-12 22:15:40.437901
47638,1,106,1,12,22,142,2022-05-12 22:15:42.091077
47639,3355,3584,1122,4176,12550,24787,2022-05-12 22:15:42.325504
47643,0,3,0,6,8,17,2022-05-12 22:15:47.592043
47655,0,0,0,0,0,0,2022-05-12 22:15:51.493967
47659,0,0,0,0,0,0,2022-05-12 22:15:52.8331
47662,0,0,0,0,0,0,2022-05-12 22:15:54.065368
47671,0,0,0,0,0,0,2022-05-12 22:16:00.066754
47678,0,0,0,0,0,0,2022-05-12 22:16:02.404884
47682,0,0,0,0,0,0,2022-05-12 22:16:03.750768
47685,0,0,0,0,0,0,2022-05-12 22:16:04.862992
47691,0,0,0,0,0,0,2022-05-12 22:16:07.305278
47698,0,4,0,6,8,18,2022-05-12 22:16:10.2644
47702,0,3,0,6,8,17,2022-05-12 22:16:12.204536
47711,0,0,0,0,0,0,2022-05-12 22:16:16.943797
47714,0,2,0,7,9,18,2022-05-12 22:16:18.122419
47717,0,2,0,7,8,17,2022-05-12 22:16:19.312437
47720,0,2,1,4,9,16,2022-05-12 22:16:20.406913
47729,0,3,0,6,8,17,2022-05-12 22:16:21.705546
47732,0,3,0,5,9,17,2022-05-12 22:16:23.422487
47737,0,0,0,0,0,0,2022-05-12 22:16:25.338039
47740,0,0,0,0,0,0,2022-05-12 22:16:26.592735
47760,0,4,0,12,14,30,2022-05-12 22:16:36.080174
47763,0,5,0,10,18,33,2022-05-12 22:16:37.315692
47766,0,3,0,9,18,30,2022-05-12 22:16:38.73506
47774,0,4,0,13,15,32,2022-05-12 22:16:41.046503
47776,0,6,0,11,15,32,2022-05-12 22:16:42.079397
47787,2,0,2,12,17,33,2022-05-12 22:16:43.260163
47794,832,0,219,74,1647,2772,2022-05-12 22:16:46.066025
47795,96,115,41,47,974,1273,2022-05-12 22:16:47.86581
47797,0,4,1,12,15,32,2022-05-12 22:16:48.862429
47798,0,9,0,10,17,36,2022-05-12 22:16:50.518102
47799,0,12,0,11,16,39,2022-05-12 22:16:51.530599
47800,1,19,1,15,19,55,2022-05-12 22:16:52.517608
47802,0,0,0,0,0,0,2022-05-12 22:16:54.799452
47807,0,0,0,0,0,0,2022-05-12 22:17:01.066985
47811,83,617,46,67,576,1389,2022-05-12 22:17:05.883466
47815,0,5,1,11,11,28,2022-05-12 22:17:09.398154
47819,0,6,1,13,11,31,2022-05-12 22:17:11.028593
47822,0,0,0,0,0,0,2022-05-12 22:17:12.683083
47826,0,0,0,0,0,0,2022-05-12 22:17:16.179259
47829,0,0,0,0,0,0,2022-05-12 22:17:18.014208
47833,0,0,0,0,0,0,2022-05-12 22:17:19.849067
47834,0,0,0,0,0,0,2022-05-12 22:17:21.243923
47836,0,0,0,0,0,0,2022-05-12 22:17:23.039397
47841,0,0,0,0,0,0,2022-05-12 22:17:25.628222
47848,0,0,0,0,0,0,2022-05-12 22:17:27.698099
47855,0,0,0,0,0,0,2022-05-12 22:17:30.156746
47882,0,0,0,0,0,0,2022-05-12 22:17:37.286841
47885,0,0,0,0,0,0,2022-05-12 22:17:39.012402
47893,0,0,0,0,0,0,2022-05-12 22:17:42.251777
47896,0,0,0,0,0,0,2022-05-12 22:17:43.513342
47905,0,0,0,0,0,0,2022-05-12 22:17:46.920764
47911,0,0,0,0,0,0,2022-05-12 22:17:49.84688
47912,1,65,1,6,12,85,2022-05-12 22:17:51.521501
47913,2,50,2,7,14,75,2022-05-12 22:17:53.676047
47944,0,5,0,11,16,32,2022-05-12 22:18:10.486695
47946,0,5,0,12,15,32,2022-05-12 22:18:12.816716
47947,0,5,0,12,15,32,2022-05-12 22:18:14.347287
47948,0,6,0,12,14,32,2022-05-12 22:18:15.18347
47951,0,5,0,12,14,31,2022-05-12 22:18:17.107959
47952,0,9,0,12,17,38,2022-05-12 22:18:18.063564
47959,0,4,0,11,17,32,2022-05-12 22:18:23.598095
47960,0,7,1,17,16,41,2022-05-12 22:18:24.693769
47971,1,12,1,15,22,51,2022-05-12 22:18:35.44923
47972,8,202,4,5,74,293,2022-05-12 22:18:35.86532
47978,1,7,0,13,19,40,2022-05-12 22:18:39.62938
47982,1,6,0,13,22,42,2022-05-12 22:18:43.388096
47990,0,7,0,13,16,36,2022-05-12 22:18:50.706395
47991,0,4,0,13,14,31,2022-05-12 22:18:51.621367
47997,0,7,2,9,19,37,2022-05-12 22:18:53.92258
48002,0,5,1,15,17,38,2022-05-12 22:18:55.190544
48007,0,9,2,19,17,47,2022-05-12 22:18:57.659147
48011,0,5,0,10,16,31,2022-05-12 22:19:01.425777
48012,0,4,0,13,17,34,2022-05-12 22:19:02.472594
48021,0,4,0,11,17,32,2022-05-12 22:19:06.061489
48023,1,15,3,9,18,46,2022-05-12 22:19:07.203436
48025,0,5,0,13,17,35,2022-05-12 22:19:08.408144
48027,0,4,0,11,15,30,2022-05-12 22:19:09.519333
48031,0,5,1,14,15,35,2022-05-12 22:19:12.177838
48038,0,3,0,13,16,32,2022-05-12 22:19:15.507644
48041,0,4,0,11,17,32,2022-05-12 22:19:16.789595
48043,1,5,0,15,21,42,2022-05-12 22:19:18.053164
48045,5,13,1,15,33,67,2022-05-12 22:19:19.185022
48047,0,6,0,11,15,32,2022-05-12 22:19:20.222982
48048,0,5,0,15,16,36,2022-05-12 22:19:21.539446
48051,0,5,0,14,16,35,2022-05-12 22:19:22.793471
48054,0,4,0,13,16,33,2022-05-12 22:19:23.949367
48057,1,5,0,11,19,36,2022-05-12 22:19:25.279724
48059,1,11,0,11,18,41,2022-05-12 22:19:26.343881
48063,0,0,0,0,0,0,2022-05-12 22:19:27.459163
48067,2,8,0,13,13,36,2022-05-12 22:19:30.596637
48068,1,4,0,14,20,39,2022-05-12 22:19:32.112505
48070,0,5,0,10,17,32,2022-05-12 22:19:34.174595
48075,0,0,0,0,0,0,2022-05-12 22:19:35.931111
48078,0,6,0,12,16,34,2022-05-12 22:19:37.266268
48080,0,5,0,12,17,34,2022-05-12 22:19:38.558467
48090,1,5,0,14,20,40,2022-05-12 22:19:42.139739
48091,0,5,0,13,15,33,2022-05-12 22:19:43.756759
48092,0,3,0,13,15,31,2022-05-12 22:19:44.697401
48093,1,6,0,10,19,36,2022-05-12 22:19:45.603608
48096,0,6,0,12,17,35,2022-05-12 22:19:46.757276
48099,0,0,0,0,0,0,2022-05-12 22:19:47.856174
48118,1,5,0,14,23,43,2022-05-12 22:19:54.012263
48121,2,8,2,22,35,69,2022-05-12 22:19:55.248785
48125,15,727,2,31,112,887,2022-05-12 22:19:57.394611
48126,3,22,2,25,35,87,2022-05-12 22:19:58.564996
48130,3,13,1,25,34,76,2022-05-12 22:20:03.64143
48136,0,0,0,0,0,0,2022-05-12 22:20:07.867282
48138,0,0,0,0,0,0,2022-05-12 22:20:09.353512
48139,0,0,0,0,0,0,2022-05-12 22:20:10.119194
48140,0,0,0,0,0,0,2022-05-12 22:20:10.934181
48148,0,0,0,0,0,0,2022-05-12 22:20:13.184061
48158,0,0,0,0,0,0,2022-05-12 22:20:17.538459
48163,0,2,0,5,7,14,2022-05-12 22:20:20.558533
48165,0,0,0,0,0,0,2022-05-12 22:20:21.527285
48171,1568,11573,458,78,25673,39350,2022-05-12 22:20:22.430741
48177,61,1005,9,38,421,1534,2022-05-12 22:20:25.282729
48211,0,0,0,0,0,0,2022-05-12 22:20:34.897536
48230,0,0,0,0,0,0,2022-05-12 22:20:40.749584
48234,0,0,0,0,0,0,2022-05-12 22:20:42.125224
48236,0,0,0,0,0,0,2022-05-12 22:20:43.124487
48246,0,0,0,0,0,0,2022-05-12 22:20:45.588854
48252,2712,5971,591,1191,5557,16022,2022-05-12 22:20:51.135152
48256,3,14,3,19,34,73,2022-05-12 22:20:55.691144
48258,1,3,0,14,21,39,2022-05-12 22:20:57.810658
48260,2,9,1,21,27,60,2022-05-12 22:21:00.261837
48262,8,19,8,32,58,125,2022-05-12 22:21:01.544688
48264,0,0,0,0,0,0,2022-05-12 22:21:03.609027
48267,0,0,0,0,0,0,2022-05-12 22:21:06.510591
48276,2,6,3,28,26,65,2022-05-12 22:21:11.528321
48277,0,0,0,0,0,0,2022-05-12 22:21:12.403398
48289,1,9,1,14,24,49,2022-05-12 22:21:16.297206
48290,7,21,4,30,60,122,2022-05-12 22:21:17.487257
48292,1,19,1,17,27,65,2022-05-12 22:21:18.456075
48305,12,401,5,25,150,593,2022-05-12 22:21:22.477983
48312,2,94,4,10,23,133,2022-05-12 22:21:24.354554
48316,4,0,1,0,36266,36271,2022-05-12 22:21:24.782153
48324,1,9,1,13,21,45,2022-05-12 22:21:26.532179
48328,1,8,1,16,19,45,2022-05-12 22:21:29.58923
48333,5,10,4,20,28,67,2022-05-12 22:21:34.83942
48334,3,16,2,17,21,59,2022-05-12 22:21:35.776838
48339,4,18,1,17,31,71,2022-05-12 22:21:37.496806
48341,1,13,2,20,26,62,2022-05-12 22:21:38.593061
48345,1,9,3,23,22,58,2022-05-12 22:21:41.097829
48346,1,12,1,19,32,65,2022-05-12 22:21:42.156808
48350,5,18,4,27,38,92,2022-05-12 22:21:44.078744
48363,12590,0,390,2076,10308,25364,2022-05-12 22:21:45.898652
48375,1534,25009,399,189,35938,63069,2022-05-12 22:21:51.590456
48377,5,548,5,14,59,631,2022-05-12 22:21:53.213495
48386,2,7,8,20,103,140,2022-05-12 22:21:54.825321
48391,250,52,87,294,669,1352,2022-05-12 22:21:56.750011
48405,653,2897,202,36,16241,20029,2022-05-12 22:21:57.487529
48406,14886,38228,3423,5390,36249,98176,2022-05-12 22:21:57.690746
48411,98,134,85,29,3187,3533,2022-05-12 22:22:00.261092
48413,3,1,4,3,216092,216103,2022-05-12 22:22:00.448591
48414,45073,54967,4006,7441,62996,174483,2022-05-12 22:22:00.622604
48432,13,257,3,23,71,367,2022-05-12 22:22:04.504946
48438,9208,5,2184,200,35916,47513,2022-05-12 22:22:05.904275
48453,3728,22628,874,1289,14178,42697,2022-05-12 22:22:06.718587
48481,307,404,104,126,3240,4181,2022-05-12 22:22:10.90246
48483,62309,160778,10132,15695,107688,356602,2022-05-12 22:22:11.105586
48486,10,26,8,59,134,237,2022-05-12 22:22:15.631025
48488,8788,36759,1826,1839,38864,88076,2022-05-12 22:22:18.286067
48491,0,0,0,0,5140,5140,2022-05-12 22:22:19.64518
48492,17034,10682,4103,14532,30296,76647,2022-05-12 22:22:19.832584
48505,6643,7127,767,772,16928,32237,2022-05-12 22:22:20.983298
48524,0,0,0,0,0,0,2022-05-12 22:22:23.636554
48525,0,0,0,0,0,0,2022-05-12 22:22:23.917805
48536,0,0,0,0,650,650,2022-05-12 22:22:28.125968
48537,419,1016,102,72,1867,3476,2022-05-12 22:22:30.676283
48538,0,0,0,0,0,0,2022-05-12 22:22:31.49037
48539,5,9,6,36,45,101,2022-05-12 22:22:33.113468
48542,0,0,0,0,9438,9438,2022-05-12 22:22:39.157607
48543,166,78,26,53,190,513,2022-05-12 22:22:40.352438
48548,2,3,4,1,107016,107026,2022-05-12 22:22:41.931596
48549,1,1,4,1,96656,96663,2022-05-12 22:22:42.119096
48553,25648,38985,3394,6056,49297,123380,2022-05-12 22:22:43.340345
48560,0,0,0,0,0,0,2022-05-12 22:22:46.878313
48561,5861,88797,2171,184,271157,368170,2022-05-12 22:22:47.096856
48570,34,64,18,27,215,358,2022-05-12 22:22:49.234822
48573,0,0,0,0,3223,3223,2022-05-12 22:22:49.72677
48580,63305,158503,12220,12501,127353,373882,2022-05-12 22:22:50.510685
48606,13,423,7,17,110,570,2022-05-12 22:22:55.559792
48612,480,3254,129,105,5535,9503,2022-05-12 22:22:59.56672
48614,1358,83032,540,755,36825,122510,2022-05-12 22:23:02.520427
48615,291,1369,180,155,1742,3737,2022-05-12 22:23:02.707843
48616,38,165,27,40,328,598,2022-05-12 22:23:06.843799
48617,4,259,4,17,67,351,2022-05-12 22:23:08.303172
48624,155,0,74,18,9531,9778,2022-05-12 22:23:08.475048
48627,54,1325,39,41,2038,3497,2022-05-12 22:23:11.201378
48628,11,32,4,32,69,148,2022-05-12 22:23:12.405198
48631,474,3644,65,99,694,4976,2022-05-12 22:23:14.815161
48641,8167,8842,1465,1605,12608,32687,2022-05-12 22:23:20.392211
48643,55998,12,1104,1822,40427,99363,2022-05-12 22:23:20.566336
48649,1,0,1,0,5414,5416,2022-05-12 22:23:24.139972
48653,376,10804,46,67,1086,12379,2022-05-12 22:23:26.696669
48661,120139,70311,15865,1181,112941,320437,2022-05-12 22:23:26.884172
48673,3,53,1,4,18,79,2022-05-12 22:23:29.127606
48675,47648,18,792,815,73416,122689,2022-05-12 22:23:29.346346
48680,2214,2967,518,4765,9910,20374,2022-05-12 22:23:31.391313
48694,166,239,57,42,794,1298,2022-05-12 22:23:33.684859
48701,0,0,0,0,351,351,2022-05-12 22:23:36.744529
48702,21554,1,464,835,20003,42857,2022-05-12 22:23:36.916405
48721,0,0,0,0,0,0,2022-05-12 22:23:38.556656
48742,13303,1,383,3406,11680,28773,2022-05-12 22:23:40.213758
48760,77953,2,1074,2126,49095,130250,2022-05-12 22:23:41.402695
48776,6174,9804,1336,4657,19129,41100,2022-05-12 22:23:49.256828
48777,4090,2,183,298,7533,12106,2022-05-12 22:23:52.217611
48779,28312,1,558,1066,16440,46377,2022-05-12 22:23:52.431031
48780,714,1321,306,76,22165,24582,2022-05-12 22:23:52.935607
48814,2,121,4,7,42,176,2022-05-12 22:23:57.436796
48829,35,410,27,46,401,919,2022-05-12 22:24:00.209937
48830,157,118,151,21,20083,20530,2022-05-12 22:24:00.413521
48844,19,28,10,41,74,172,2022-05-12 22:24:03.580407
48845,105,132,44,55,588,924,2022-05-12 22:24:05.81643
48847,1,59,0,3,16,79,2022-05-12 22:24:07.533808
48849,36608,71426,9314,11488,94316,223152,2022-05-12 22:24:07.955528
48862,611,1408,123,304,2387,4833,2022-05-12 22:24:12.846942
48874,0,0,0,0,156,156,2022-05-12 22:24:17.740712
48875,73,66,29,34,1267,1469,2022-05-12 22:24:20.383532
48876,13,1378,6,13,134,1544,2022-05-12 22:24:22.578091
48881,0,0,0,0,0,0,2022-05-12 22:24:24.923573
48884,1,7,1,17,32,58,2022-05-12 22:24:27.596639
48891,0,0,0,0,0,0,2022-05-12 22:24:30.737909
48894,3,58,1,4,16,82,2022-05-12 22:24:34.490246
48895,1,1,1,0,183827,183830,2022-05-12 22:24:34.679199
48896,0,0,0,0,14695,14695,2022-05-12 22:24:37.62515
48899,14,23,6,28,61,132,2022-05-12 22:24:40.938669
48903,0,0,2,0,37192,37194,2022-05-12 22:24:41.11062
48904,3,24,2,24,54,107,2022-05-12 22:24:42.854001
48906,1,18,1,8,19,47,2022-05-12 22:24:44.428509
48909,2,19,4,26,33,84,2022-05-12 22:24:46.892901
48910,6,22,2,17,42,89,2022-05-12 22:24:48.112907
48916,9923,0,242,245,12600,23010,2022-05-12 22:24:50.431346
48920,4,75,1,5,43,128,2022-05-12 22:24:52.058668
48940,0,0,0,0,0,0,2022-05-12 22:24:55.897533
48944,0,0,0,0,0,0,2022-05-12 22:24:59.792542
48947,2,23,1,11,49,86,2022-05-12 22:25:02.518258
48951,21,32,20,28,512,613,2022-05-12 22:25:04.021977
48952,22,394,9,20,265,710,2022-05-12 22:25:05.781214
48953,95,1153,39,43,1108,2438,2022-05-12 22:25:08.150461
48954,23,97,14,24,957,1115,2022-05-12 22:25:09.914287
48956,846,1,53,67,290,1257,2022-05-12 22:25:11.620207
48960,6,111,2,12,55,186,2022-05-12 22:25:12.057629
48961,3,149,2,5,29,188,2022-05-12 22:25:13.184623
48962,354,578,73,62,1935,3002,2022-05-12 22:25:16.140157
48963,2,74,1,4,16,97,2022-05-12 22:25:17.205558
48964,0,0,0,0,443,443,2022-05-12 22:25:18.929289
48966,2,115,3,6,27,153,2022-05-12 22:25:21.292105
48968,3,85,3,11,22,124,2022-05-12 22:25:22.776934
48969,6,118,2,13,35,174,2022-05-12 22:25:23.980059
48970,3,86,1,11,34,135,2022-05-12 22:25:25.122791
48971,5,149,2,12,39,207,2022-05-12 22:25:26.294043
48976,15,127,13,17,79,251,2022-05-12 22:25:31.308803
48979,0,40,2,14,16,72,2022-05-12 22:25:32.498595
48981,0,0,0,0,2886,2886,2022-05-12 22:25:35.021607
48992,7,219,9,21,139,395,2022-05-12 22:25:37.96223
48997,25452,43129,2334,4657,30526,106098,2022-05-12 22:25:39.248913
49005,6,171,3,14,24,218,2022-05-12 22:25:40.787581
49036,0,0,0,0,0,0,2022-05-12 22:25:44.078203
49052,38279,0,602,753,25349,64983,2022-05-12 22:25:44.579908
49065,1,18,0,16,25,60,2022-05-12 22:25:46.546247
49073,0,0,0,0,2183,2183,2022-05-12 22:25:50.740597
49079,42,0,7,65,163,277,2022-05-12 22:25:52.430447
49090,8,246,6,5,115,380,2022-05-12 22:25:54.229927
49091,3,63,1,5,17,89,2022-05-12 22:25:55.366304
49103,7,537,3,6,37,590,2022-05-12 22:26:01.420231
49109,0,0,1,0,30493,30494,2022-05-12 22:26:05.433925
49110,777,3993,184,251,4035,9240,2022-05-12 22:26:05.637125
49112,126,0,85,39,239,489,2022-05-12 22:26:05.793375
49116,1,9,0,14,19,43,2022-05-12 22:26:07.148855
49117,5,88,2,8,35,138,2022-05-12 22:26:09.573901
49118,47,8,16,36,217,324,2022-05-12 22:26:10.935881
49119,0,0,0,0,931,931,2022-05-12 22:26:11.092187
49120,0,0,0,0,583,583,2022-05-12 22:26:13.374212
49121,2,16,1,20,35,74,2022-05-12 22:26:14.89277
49122,1,43,3,8,11,66,2022-05-12 22:26:16.003733
49123,920,1345,71,71,1276,3683,2022-05-12 22:26:16.191145
49127,2,63,0,4,10,79,2022-05-12 22:26:26.002583
49133,1,18,2,26,24,71,2022-05-12 22:26:27.938728
49138,117,907,95,41,3572,4732,2022-05-12 22:26:30.296131
49139,1,22,1,8,19,51,2022-05-12 22:26:33.519038
49144,1,13,1,21,44,80,2022-05-12 22:26:34.881051
49145,163,3091,144,114,1968,5480,2022-05-12 22:26:38.030273
49146,9,122,14,29,588,762,2022-05-12 22:26:39.685423
49148,3,49,1,2,7,62,2022-05-12 22:26:41.285504
49154,0,0,0,0,2139,2139,2022-05-12 22:26:46.324265
49160,10674,0,370,1260,8685,20989,2022-05-12 22:26:46.684572
49164,0,0,0,0,1152,1152,2022-05-12 22:26:48.514313
49165,143,1683,50,125,2196,4197,2022-05-12 22:26:51.292242
49170,186,191,42,70,253,742,2022-05-12 22:26:53.946189
49179,0,0,0,0,945,945,2022-05-12 22:26:54.149313
49184,67,37,19,113,267,503,2022-05-12 22:26:56.51168
49194,2,16,3,18,38,77,2022-05-12 22:26:59.523721
49195,0,11,4,13,19,47,2022-05-12 22:27:00.42473
49196,0,18,4,17,37,76,2022-05-12 22:27:01.398274
49197,9,138,8,16,205,376,2022-05-12 22:27:02.900275
49198,3,26,6,16,45,96,2022-05-12 22:27:04.741226
49200,481,15554,141,73,4800,21049,2022-05-12 22:27:09.278791
49202,39,430,6,8,270,753,2022-05-12 22:27:09.62254
49204,333,0,76,183,2061,2653,2022-05-12 22:27:11.078007
49208,112,113,44,44,934,1247,2022-05-12 22:27:14.29909
49211,266,1522,53,87,1183,3111,2022-05-12 22:27:14.926734
49214,188,622,77,101,1385,2373,2022-05-12 22:27:18.433156
49220,1,0,1,0,11870,11872,2022-05-12 22:27:23.510133
49221,17,70,6,59,115,267,2022-05-12 22:27:24.768213
49233,2,0,0,0,84697,84699,2022-05-12 22:27:27.046336
49236,1712,28118,369,134,13071,43404,2022-05-12 22:27:28.185289
49258,0,0,0,0,0,0,2022-05-12 22:27:34.631991
49275,68,404,9,26,207,714,2022-05-12 22:27:37.790301
49276,29,16,13,32,144,234,2022-05-12 22:27:39.081246
49277,17,0,9,22,88,136,2022-05-12 22:27:40.706695
49283,0,0,1,0,12432,12433,2022-05-12 22:27:40.87861
49285,1206,0,160,432,1871,3669,2022-05-12 22:27:42.527057
49290,277,843,124,129,2172,3545,2022-05-12 22:27:45.225712
49291,1125,6779,149,94,11602,19749,2022-05-12 22:27:45.65855
49297,673,14461,169,180,6066,21549,2022-05-12 22:27:46.850784
49314,8,123,2,5,39,177,2022-05-12 22:27:49.024244
49316,1770,4,319,66,18727,20886,2022-05-12 22:27:50.432926
49332,0,46,0,4,11,61,2022-05-12 22:27:54.282695
49341,17,62,6,22,140,247,2022-05-12 22:27:56.068886
49342,1553,1,201,98,10558,12411,2022-05-12 22:27:56.272009
49345,147,62,109,20,8153,8491,2022-05-12 22:27:59.132632
49354,3,11,8,27,44,93,2022-05-12 22:28:03.333353
49357,6785,39773,2360,1941,18559,69418,2022-05-12 22:28:04.982079
49361,938,10918,200,49,5471,17576,2022-05-12 22:28:05.200829
49380,94,173,29,41,463,800,2022-05-12 22:28:12.417657
49385,8564,9822,1142,4023,15347,38898,2022-05-12 22:28:13.959137
49386,133,905,18,44,315,1415,2022-05-12 22:28:17.0699
49387,1,1,9,3,99752,99766,2022-05-12 22:28:17.382398
49391,3,31,2,18,30,84,2022-05-12 22:28:18.398024
49392,864,659,270,332,457,2582,2022-05-12 22:28:20.724726
49395,51,1240,19,27,407,1744,2022-05-12 22:28:23.193642
49398,359,1,37,53,395,845,2022-05-12 22:28:27.379892
49402,136,260,85,42,2953,3476,2022-05-12 22:28:29.132629
49409,77,1414,25,43,632,2191,2022-05-12 22:28:32.732137
49410,320,369,133,98,2156,3076,2022-05-12 22:28:35.012832
49413,0,0,0,0,25683,25683,2022-05-12 22:28:38.025667
49420,6,382,1,8,27,424,2022-05-12 22:28:42.639576
49426,30,487,23,34,788,1362,2022-05-12 22:28:46.095539
49429,0,73,0,7,17,97,2022-05-12 22:28:47.22828
49431,93,72,31,56,2683,2935,2022-05-12 22:28:51.626149
49432,0,0,0,0,324,324,2022-05-12 22:28:53.081077
49433,64,79,19,39,149,350,2022-05-12 22:28:54.331765
49438,4,1,3,1,10773,10782,2022-05-12 22:28:56.993189
49445,9,28,7,25,63,132,2022-05-12 22:29:02.428553
49448,587,0,45,68,287,987,2022-05-12 22:29:04.118553
49450,3,34,1,16,30,84,2022-05-12 22:29:05.212353
49457,402,7898,180,89,9271,17840,2022-05-12 22:29:07.959369
49470,6,0,7,1,31685,31699,2022-05-12 22:29:09.07119
49483,9208,7648,3344,409,10381,30990,2022-05-12 22:29:10.140076
49505,2377,9019,578,1098,14204,27276,2022-05-12 22:29:15.652816
49507,409,379,93,103,2503,3487,2022-05-12 22:29:18.892795
49510,34,217,17,29,242,539,2022-05-12 22:29:21.351012
49514,2545,2219,430,2995,7773,15962,2022-05-12 22:29:22.931092
49515,7924,0,778,1194,5910,15806,2022-05-12 22:29:24.833491
49518,164,129,78,45,3126,3542,2022-05-12 22:29:27.372591
49519,7794,14570,1180,3137,12667,39348,2022-05-12 22:29:27.560162
49520,105327,17,2192,5362,67054,179952,2022-05-12 22:29:30.848483
49522,0,0,0,0,847,847,2022-05-12 22:29:33.116233
49523,0,0,0,0,1401,1401,2022-05-12 22:29:35.072686
49525,0,0,0,0,0,0,2022-05-12 22:29:35.86956
49527,3,100,3,3,15,124,2022-05-12 22:29:38.59516
49528,4,107,3,3,17,134,2022-05-12 22:29:39.722434
49529,7,109,3,7,32,158,2022-05-12 22:29:41.099494
49532,124,100,61,32,2711,3028,2022-05-12 22:29:44.433423
49549,5,20,7,13,35,80,2022-05-12 22:29:50.949987
49551,0,0,0,0,304,304,2022-05-12 22:29:54.909527
49556,10647,1,278,1059,12306,24291,2022-05-12 22:29:57.772089
49559,0,0,0,0,20942,20942,2022-05-12 22:30:02.297461
49565,0,0,0,0,609,609,2022-05-12 22:30:05.50153
49566,0,0,0,0,1426,1426,2022-05-12 22:30:07.124095
49569,433,0,29,34,411,907,2022-05-12 22:30:07.893519
49570,276,0,16,22,918,1232,2022-05-12 22:30:08.096636
49573,0,0,0,0,562,562,2022-05-12 22:30:09.983802
49574,0,0,0,0,1585,1585,2022-05-12 22:30:12.299155
49581,8,165,1,15,41,230,2022-05-12 22:30:14.451641
49587,446,872,33,37,1419,2807,2022-05-12 22:30:18.253411
49590,0,0,0,0,14270,14270,2022-05-12 22:30:22.085694
49592,252,431,71,59,1424,2237,2022-05-12 22:30:24.311369
49596,5,0,2,1,60289,60297,2022-05-12 22:30:28.060365
49598,14,0,6,21,83,124,2022-05-12 22:30:29.667663
49599,0,0,0,0,5150,5150,2022-05-12 22:30:31.716549
49600,4,173,2,8,20,207,2022-05-12 22:30:32.984751
49603,0,24,0,4,6,34,2022-05-12 22:30:35.440553
49605,10706,41230,1764,2274,23488,79462,2022-05-12 22:30:38.156125
49611,0,6,3,6,22,37,2022-05-12 22:30:42.333473
49612,0,0,0,0,3503,3503,2022-05-12 22:30:43.257214
49614,1,87,2,9,49,148,2022-05-12 22:30:47.947539
49615,1,25,2,18,33,79,2022-05-12 22:30:48.981321
49618,0,0,0,1,7506,7507,2022-05-12 22:30:50.188773
49627,556,1088,164,60,3463,5331,2022-05-12 22:30:53.490315
49637,1336,3418,268,271,3245,8538,2022-05-12 22:30:55.193739
49638,553,2303,42,64,550,3512,2022-05-12 22:30:56.789835
49644,3,66,1,4,7,81,2022-05-12 22:30:58.924355
49645,3,64,2,3,10,82,2022-05-12 22:31:00.158729
49651,0,0,0,0,0,0,2022-05-12 22:31:02.239155
49654,7,150,4,16,49,226,2022-05-12 22:31:03.741729
49665,127,51,90,20,6576,6864,2022-05-12 22:31:09.428625
49666,0,0,0,0,0,0,2022-05-12 22:31:10.230664
49668,4,160,5,20,54,243,2022-05-12 22:31:10.643749
49678,0,42,0,5,13,60,2022-05-12 22:31:14.85728
49682,3,101,1,4,17,126,2022-05-12 22:31:17.451016
49684,7,111,2,6,17,143,2022-05-12 22:31:19.958756
49690,331,1222,191,37,2061,3842,2022-05-12 22:31:24.960436
49691,6402,1,263,1510,9292,17468,2022-05-12 22:31:25.192837
49692,15968,0,393,936,16580,33877,2022-05-12 22:31:25.422711
49700,36,371,30,38,222,697,2022-05-12 22:31:28.301859
49701,575,1607,57,91,964,3294,2022-05-12 22:31:28.532307
49721,22950,46124,2098,1023,51845,124040,2022-05-12 22:31:30.204246
49738,9348,18404,2535,3094,27378,60759,2022-05-12 22:31:31.478312
49806,23,62,13,21,268,387,2022-05-12 22:31:38.732158
49814,11,42,5,18,51,127,2022-05-12 22:31:41.26369
49817,0,0,0,0,0,0,2022-05-12 22:31:43.078124
49819,0,0,0,0,1229,1229,2022-05-12 22:31:43.442735
49843,0,0,0,0,70,70,2022-05-12 22:31:46.900794
49845,1,0,0,0,1246,1247,2022-05-12 22:31:50.851971
49847,415,1064,86,65,1995,3625,2022-05-12 22:31:51.086336
49854,5807,25405,966,1058,14230,47466,2022-05-12 22:31:52.204729
49866,285,2883,158,65,4893,8284,2022-05-12 22:31:53.950184
49869,291,2206,160,69,7284,10010,2022-05-12 22:31:56.604524
49871,14,68,5,5,109,201,2022-05-12 22:31:57.971593
49877,2,0,1,0,78860,78863,2022-05-12 22:32:01.004441
49880,8,672,11,17,152,860,2022-05-12 22:32:03.035528
49882,1,106,3,3,11,124,2022-05-12 22:32:05.210067
49891,3,1,0,0,12697,12701,2022-05-12 22:32:06.403226
49902,1,35,0,3,10,49,2022-05-12 22:32:09.5776
49907,2,28,1,15,26,72,2022-05-12 22:32:10.830351
49909,8721,35860,593,423,12213,57810,2022-05-12 22:32:11.174099
49952,384,1,39,72,238,734,2022-05-12 22:32:15.751131
49969,6157,6720,924,3759,15738,33298,2022-05-12 22:32:18.352519
49978,9,225,1,16,45,296,2022-05-12 22:32:20.553389
49979,1,0,0,0,5937,5938,2022-05-12 22:32:22.919055
49980,0,0,0,0,733,733,2022-05-12 22:32:24.643174
49981,0,0,2,1,24123,24126,2022-05-12 22:32:24.908724
49982,108,28,43,22,1592,1793,2022-05-12 22:32:25.319842
49985,10,46,5,11,64,136,2022-05-12 22:32:27.702704
49988,0,0,0,0,0,0,2022-05-12 22:32:28.51848
49995,1,58,0,4,12,75,2022-05-12 22:32:31.268897
49996,2,59,0,3,14,78,2022-05-12 22:32:32.189188
50007,5,118,0,4,15,142,2022-05-12 22:32:34.820424
50009,2,45,3,6,14,70,2022-05-12 22:32:36.123573
50010,0,0,0,0,914,914,2022-05-12 22:32:36.326774
50021,399,627,103,408,1082,2619,2022-05-12 22:32:39.458001
50022,4,118,1,4,20,147,2022-05-12 22:32:40.569994
50025,0,0,0,0,380,380,2022-05-12 22:32:42.63025
50027,3,71,0,5,12,91,2022-05-12 22:32:43.895755
50028,0,70,1,11,11,93,2022-05-12 22:32:45.038772
50029,17,412,8,19,103,559,2022-05-12 22:32:46.393388
50030,17,926,4,7,78,1032,2022-05-12 22:32:48.096056
50033,3,131,2,6,19,161,2022-05-12 22:32:49.972544
50036,5,224,2,7,79,317,2022-05-12 22:32:51.255842
50037,7,374,0,5,45,431,2022-05-12 22:32:52.667871
50038,7,128,1,3,25,164,2022-05-12 22:32:53.713614
50039,9,376,1,6,23,415,2022-05-12 22:32:54.879284
50041,6,335,1,6,59,407,2022-05-12 22:32:57.414682
50042,3,111,0,5,24,143,2022-05-12 22:32:58.611066
50046,26,670,29,21,316,1062,2022-05-12 22:33:01.921319
50048,17,472,7,25,171,692,2022-05-12 22:33:03.346192
50049,1,15,2,16,21,55,2022-05-12 22:33:04.540628
50054,5,156,0,4,27,192,2022-05-12 22:33:09.397368
50056,3,114,1,4,15,137,2022-05-12 22:33:11.30609
50057,2,98,2,5,14,121,2022-05-12 22:33:11.748509
50062,7,135,0,4,31,177,2022-05-12 22:33:13.577904
50074,6,125,1,8,49,189,2022-05-12 22:33:15.884147
50077,2,90,0,3,23,118,2022-05-12 22:33:18.45835
50078,4,193,0,7,22,226,2022-05-12 22:33:19.68496
50088,1,66,0,4,16,87,2022-05-12 22:33:21.038433
50099,0,0,0,0,3664,3664,2022-05-12 22:33:22.226021
50111,5,90,10,10,53,168,2022-05-12 22:33:23.479303
50120,22,50,6,9,149,236,2022-05-12 22:33:25.704517
50124,3,52,0,3,10,68,2022-05-12 22:33:28.369554
50125,3,54,1,2,10,70,2022-05-12 22:33:29.50624
50136,24,313,9,23,159,528,2022-05-12 22:33:31.726907
50137,2,22,1,4,9,38,2022-05-12 22:33:32.651039
50141,12,53,9,56,77,207,2022-05-12 22:33:37.204197
50142,5,7,3,36,34,85,2022-05-12 22:33:38.347341
50145,0,45,1,3,8,57,2022-05-12 22:33:40.097613
50146,0,44,0,2,6,52,2022-05-12 22:33:41.028605
50147,0,46,0,3,8,57,2022-05-12 22:33:41.966104
50150,4,79,1,2,20,106,2022-05-12 22:33:43.80006
50159,0,0,1,0,21565,21566,2022-05-12 22:33:49.126307
50160,8591,1,226,120,13545,22483,2022-05-12 22:33:49.310484
50168,0,7,0,9,17,33,2022-05-12 22:33:51.198695
50169,50,346,12,6,225,639,2022-05-12 22:33:52.697127
50172,5,0,1,0,175237,175243,2022-05-12 22:33:53.134661
50202,7,80,6,10,47,150,2022-05-12 22:33:56.864785
50203,2,0,0,0,10446,10448,2022-05-12 22:33:57.09916
50215,1,36,1,1,5,44,2022-05-12 22:34:00.018944
50216,3,47,0,1,6,57,2022-05-12 22:34:01.033927
50221,0,0,0,0,1749,1749,2022-05-12 22:34:04.193115
50227,1,47,1,2,6,57,2022-05-12 22:34:07.543372
50229,2,32,1,1,6,42,2022-05-12 22:34:08.717876
50231,2,39,1,1,7,50,2022-05-12 22:34:09.806288
50234,0,0,0,0,38,38,2022-05-12 22:34:11.095115
50242,0,48,1,1,7,57,2022-05-12 22:34:13.3938
50275,3,1,2,1,36454,36461,2022-05-12 22:34:17.447739
50288,14,938,8,21,120,1101,2022-05-12 22:34:23.835286
50290,17,202,8,17,181,425,2022-05-12 22:34:26.33273
50292,2,11,2,9,21,45,2022-05-12 22:34:28.792835
50293,0,11,0,10,12,33,2022-05-12 22:34:29.786854
50295,12,0,3,15,18,48,2022-05-12 22:34:31.683145
50296,0,6,1,14,11,32,2022-05-12 22:34:32.607512
50297,4,0,1,16,17,38,2022-05-12 22:34:33.470021
50300,1,8,1,10,21,41,2022-05-12 22:34:34.971986
50302,0,100,2,5,29,136,2022-05-12 22:34:36.368898
50306,3,0,1,1,48993,48998,2022-05-12 22:34:37.7709
50316,4,86,4,4,27,125,2022-05-12 22:34:40.217664
50318,2,59,1,2,10,74,2022-05-12 22:34:41.975303
50324,27,1385,9,13,130,1564,2022-05-12 22:34:45.729399
50325,1421,23982,242,96,9941,35682,2022-05-12 22:34:45.916899
50326,7,10,4,15,121,157,2022-05-12 22:34:49.893075
50337,2,65,2,2,12,83,2022-05-12 22:34:55.30553
50338,16500,0,432,1874,13190,31996,2022-05-12 22:34:55.512248
50339,0,0,0,0,14399,14399,2022-05-12 22:34:55.848304
50343,25,0,4,15,34,78,2022-05-12 22:34:56.246906
50364,688,1551,38,63,577,2917,2022-05-12 22:34:58.400074
50380,73141,16,1100,881,39898,115036,2022-05-12 22:35:00.689716
50403,0,0,0,0,956,956,2022-05-12 22:35:03.192453
50414,68,100,29,21,3160,3378,2022-05-12 22:35:06.899293
50415,22,142,12,14,189,379,2022-05-12 22:35:08.236752
50416,0,0,0,0,2352,2352,2022-05-12 22:35:10.32308
50418,427,0,69,248,945,1689,2022-05-12 22:35:10.500552
50419,37,0,26,20,189,272,2022-05-12 22:35:12.029273
50425,0,0,0,0,5998,5998,2022-05-12 22:35:17.815399
50429,0,0,0,0,437,437,2022-05-12 22:35:19.892589
50432,0,0,0,0,116,116,2022-05-12 22:35:23.370637
50433,101,0,12,20,154,287,2022-05-12 22:35:24.33946
50438,2687,0,64,91,2843,5685,2022-05-12 22:35:24.523012
50443,262,1,23,43,265,594,2022-05-12 22:35:26.603936
50459,0,0,0,0,0,0,2022-05-12 22:35:30.669514
50469,0,0,0,0,1644,1644,2022-05-12 22:35:36.816098
50470,0,0,0,0,2439,2439,2022-05-12 22:35:39.260059
50473,3,36,4,4,19,66,2022-05-12 22:35:40.431265
50474,526,5934,87,223,2439,9209,2022-05-12 22:35:42.936306
50475,614,8460,147,212,3357,12790,2022-05-12 22:35:43.186304
50481,1,0,0,0,5090,5091,2022-05-12 22:35:47.232312
50484,0,34,0,5,7,46,2022-05-12 22:35:49.423443
50485,0,39,0,2,6,47,2022-05-12 22:35:50.519268
50495,91,57,20,80,715,963,2022-05-12 22:35:53.011121
50499,0,53,0,3,8,64,2022-05-12 22:35:55.679142
50503,25,225,4,20,161,435,2022-05-12 22:36:00.33745
50512,4,102,1,2,18,127,2022-05-12 22:36:06.785672
50513,4,181,3,3,15,206,2022-05-12 22:36:08.370902
50515,103,189,21,21,407,741,2022-05-12 22:36:10.091399
50517,0,48,1,6,16,71,2022-05-12 22:36:11.309066
50518,0,49,2,5,23,79,2022-05-12 22:36:12.299308
50521,215,0,16,39,154,424,2022-05-12 22:36:15.115832
50523,2,29,0,0,7,38,2022-05-12 22:36:18.110623
50526,2,17,4,5,15,43,2022-05-12 22:36:19.721333
50528,0,0,0,0,24158,24158,2022-05-12 22:36:19.893209
50532,984,6515,311,87,8995,16892,2022-05-12 22:36:21.076913
50538,0,0,0,0,0,0,2022-05-12 22:36:25.333773
50546,0,0,0,0,0,0,2022-05-12 22:36:27.954424
50552,0,0,0,0,6675,6675,2022-05-12 22:36:28.421042
50569,0,0,0,0,0,0,2022-05-12 22:36:32.67038
50572,27,15,7,27,166,242,2022-05-12 22:36:34.249219
50582,0,0,0,0,2880,2880,2022-05-12 22:36:38.94216
50583,0,0,0,0,1770,1770,2022-05-12 22:36:41.550185
50586,0,0,0,0,389,389,2022-05-12 22:36:43.512729
50588,175,0,17,27,118,337,2022-05-12 22:36:47.43412
50590,1,0,0,0,4315,4316,2022-05-12 22:36:47.730919
50593,5,0,0,0,8703,8708,2022-05-12 22:36:49.517299
50594,2,0,0,0,36807,36809,2022-05-12 22:36:49.954798
50600,61,0,2,34,158,255,2022-05-12 22:36:53.612093
50602,4,0,0,0,49695,49699,2022-05-12 22:36:53.815218
50612,0,0,3,0,60293,60296,2022-05-12 22:36:54.865027
50639,4,59,2,4,12,81,2022-05-12 22:36:58.631916
50644,20,64,5,24,64,177,2022-05-12 22:37:01.299857
50647,224,73,12,40,244,593,2022-05-12 22:37:02.346733
50663,0,0,0,1,11143,11144,2022-05-12 22:37:03.398238
50673,363,2254,98,52,1719,4486,2022-05-12 22:37:08.278469
50678,3207,0,65,118,3521,6911,2022-05-12 22:37:13.072219
50680,0,0,0,0,0,0,2022-05-12 22:37:15.277311
50681,35,12,12,51,63,173,2022-05-12 22:37:16.629045
50685,3434,0,93,80,3933,7540,2022-05-12 22:37:20.095439
50709,1,0,0,0,4322,4323,2022-05-12 22:37:26.796825
50710,0,0,0,0,10997,10997,2022-05-12 22:37:27.767261
50711,1,27,0,2,5,35,2022-05-12 22:37:28.697644
50712,0,0,0,0,0,0,2022-05-12 22:37:29.494518
50735,56,582,15,8,383,1044,2022-05-12 22:37:32.484895
50737,6,210,2,2,58,278,2022-05-12 22:37:34.711772
50738,2,0,0,0,34969,34971,2022-05-12 22:37:35.149285
50739,0,0,2,0,10134,10136,2022-05-12 22:37:37.55643
50740,15,866,4,3,120,1008,2022-05-12 22:37:39.582276
50746,4,35,3,15,25,82,2022-05-12 22:37:40.928215
50747,4,96,5,3,34,142,2022-05-12 22:37:42.240648
50748,8,139,2,6,54,209,2022-05-12 22:37:43.810688
50760,0,0,0,0,1843,1843,2022-05-12 22:37:46.976271
50768,873,8057,154,164,5511,14759,2022-05-12 22:37:47.888466
50789,2555,1,55,263,1323,4197,2022-05-12 22:37:50.019623
50841,10,18,9,11,75,123,2022-05-12 22:37:58.946064
50842,18,20,8,12,107,165,2022-05-12 22:38:00.234586
50845,21,73,6,18,184,302,2022-05-12 22:38:02.124307
50846,219,498,55,48,2575,3395,2022-05-12 22:38:05.236056
50850,0,0,0,0,0,0,2022-05-12 22:38:07.730431
50854,0,0,0,0,913,913,2022-05-12 22:38:11.933647
50862,2275,0,127,750,3493,6645,2022-05-12 22:38:14.395601
50863,0,0,0,0,438,438,2022-05-12 22:38:15.990842
50864,1,0,0,0,2066,2067,2022-05-12 22:38:18.519124
50869,0,0,0,1,1975,1976,2022-05-12 22:38:21.29716
50876,3,83,1,3,16,106,2022-05-12 22:38:25.366129
50880,1,18,0,5,7,31,2022-05-12 22:38:27.165718
50882,2,16,0,5,12,35,2022-05-12 22:38:29.057788
50891,1,0,0,0,7660,7661,2022-05-12 22:38:32.655225
50905,287,1,65,29,1481,1863,2022-05-12 22:38:33.537873
50916,785,10365,178,71,9700,21099,2022-05-12 22:38:34.790078
50917,0,0,0,0,3291,3291,2022-05-12 22:38:39.94695
50918,0,0,0,0,0,0,2022-05-12 22:38:40.698945
50919,86,191,63,19,1808,2167,2022-05-12 22:38:42.51418
50920,0,0,0,0,0,0,2022-05-12 22:38:42.904805
50921,0,0,0,0,0,0,2022-05-12 22:38:43.295431
50923,0,0,0,0,2094,2094,2022-05-12 22:38:45.760292
50924,0,29,0,2,7,38,2022-05-12 22:38:46.679818
50925,232,0,18,33,150,433,2022-05-12 22:38:47.840934
50930,105,0,24,27,370,526,2022-05-12 22:38:49.097438
50932,0,0,0,0,1109,1109,2022-05-12 22:38:51.677824
50934,458,0,41,39,145,683,2022-05-12 22:38:51.849656
50955,3571,0,144,629,5450,9794,2022-05-12 22:38:54.759772
51000,57,37,13,21,157,285,2022-05-12 22:39:03.390636
51005,3,63,0,2,13,81,2022-05-12 22:39:05.267869
51009,1,1,3,0,39940,39945,2022-05-12 22:39:07.044329
51019,1,0,1,0,58744,58746,2022-05-12 22:39:07.950603
51058,1,44,1,2,7,55,2022-05-12 22:39:16.04764
51059,4,48,1,1,9,63,2022-05-12 22:39:17.598143
51061,0,0,0,0,0,0,2022-05-12 22:39:20.771881
51076,3,38,0,1,6,48,2022-05-12 22:39:24.850833
51077,68,638,10,4,337,1057,2022-05-12 22:39:26.869224
51080,2,17,2,4,7,32,2022-05-12 22:39:30.047423
51084,69,684,10,4,315,1082,2022-05-12 22:39:31.971507
51086,0,9,1,10,27,47,2022-05-12 22:39:34.390555
51087,6,160,3,4,24,197,2022-05-12 22:39:35.592129
51089,6,93,1,3,19,122,2022-05-12 22:39:36.829158
51090,4,50,2,2,10,68,2022-05-12 22:39:37.923074
51091,7,247,2,4,25,285,2022-05-12 22:39:39.179849
51092,0,0,0,0,1813,1813,2022-05-12 22:39:41.332776
51096,1,0,0,0,64233,64234,2022-05-12 22:39:42.301525
51123,1,24,2,7,13,47,2022-05-12 22:39:47.741724
51125,0,27,2,8,11,48,2022-05-12 22:39:49.752769
51128,0,0,0,0,1679,1679,2022-05-12 22:39:52.413805
51131,139,0,15,36,110,300,2022-05-12 22:39:54.119455
51145,1,0,0,0,7799,7800,2022-05-12 22:40:02.288107
51147,0,0,0,0,410,410,2022-05-12 22:40:03.640899
51149,60,244,29,15,415,763,2022-05-12 22:40:05.331032
51150,6,107,6,9,33,161,2022-05-12 22:40:06.315406
51151,3,42,1,9,9,64,2022-05-12 22:40:07.411223
51152,1,19,2,6,10,38,2022-05-12 22:40:08.451089
51153,0,10,0,8,12,30,2022-05-12 22:40:09.281486
51154,2,10,6,22,62,102,2022-05-12 22:40:10.395947
51155,111,0,13,40,181,345,2022-05-12 22:40:10.569996
51156,0,25,2,9,14,50,2022-05-12 22:40:11.554372
51163,14,288,10,9,128,449,2022-05-12 22:40:12.842945
51179,5,3,6,1,52770,52785,2022-05-12 22:40:15.234928
51195,171,323,31,17,964,1506,2022-05-12 22:40:22.161735
51196,19,57,10,12,78,176,2022-05-12 22:40:23.976385
51197,44,0,14,20,109,187,2022-05-12 22:40:25.196763
51198,18,49,7,21,72,167,2022-05-12 22:40:27.343145
51202,2,56,1,2,8,69,2022-05-12 22:40:30.690766
51205,0,0,0,0,0,0,2022-05-12 22:40:32.33627
51207,0,0,0,0,0,0,2022-05-12 22:40:33.48599
51219,0,0,2,0,1695,1697,2022-05-12 22:40:37.918745
51221,3,44,3,15,30,95,2022-05-12 22:40:39.874419
51233,4,64,1,2,12,83,2022-05-12 22:40:48.339841
51234,11,102,4,13,59,189,2022-05-12 22:40:49.649599
51236,11,57,3,15,64,150,2022-05-12 22:40:51.517712
51238,5,46,2,13,24,90,2022-05-12 22:40:53.535237
51243,243,0,60,28,646,977,2022-05-12 22:40:56.265335
51250,0,0,0,0,0,0,2022-05-12 22:40:57.983064
51262,3,11,1,11,14,40,2022-05-12 22:41:00.592047
51265,0,0,0,0,3061,3061,2022-05-12 22:41:03.781847
51267,2,37,0,1,10,50,2022-05-12 22:41:06.019149
51268,1,37,2,2,8,50,2022-05-12 22:41:06.456647
51275,0,0,0,0,0,0,2022-05-12 22:41:10.098185
51278,0,0,0,0,0,0,2022-05-12 22:41:11.262946
51281,0,0,0,0,0,0,2022-05-12 22:41:12.450446
51289,0,0,0,0,0,0,2022-05-12 22:41:16.455967
51299,6,63,1,14,28,112,2022-05-12 22:41:20.050882
51300,18,87,9,12,217,343,2022-05-12 22:41:21.296784
51306,0,0,0,0,807,807,2022-05-12 22:41:28.065387
51307,0,0,0,0,667,667,2022-05-12 22:41:30.084236
51308,12,520,3,1,100,636,2022-05-12 22:41:32.066587
51309,67,1,33,13,149,263,2022-05-12 22:41:33.615485
51311,0,45,1,2,7,55,2022-05-12 22:41:35.986037
51312,0,0,0,0,0,0,2022-05-12 22:41:37.446071
51316,1,37,1,1,4,44,2022-05-12 22:41:42.468462
51318,0,0,0,0,11984,11984,2022-05-12 22:41:43.654088
51319,0,0,0,0,0,0,2022-05-12 22:41:45.121698
51321,8,161,2,1,30,202,2022-05-12 22:41:46.235873
51331,0,0,0,0,0,0,2022-05-12 22:41:50.085812
51356,0,4,0,8,13,25,2022-05-12 22:41:55.647589
51360,0,0,0,0,0,0,2022-05-12 22:41:59.897724
51361,0,0,0,0,0,0,2022-05-12 22:42:01.296527
51362,0,0,0,0,0,0,2022-05-12 22:42:02.71464
51364,0,0,0,0,0,0,2022-05-12 22:42:04.919391
51366,0,0,0,0,1536,1536,2022-05-12 22:42:07.728249
51367,4,1,1,0,52952,52958,2022-05-12 22:42:10.600256
51368,0,0,0,0,10476,10476,2022-05-12 22:42:10.772132
51369,0,0,0,0,6355,6355,2022-05-12 22:42:11.02213
51377,3,55,0,1,11,70,2022-05-12 22:42:13.033751
51379,0,0,0,0,0,0,2022-05-12 22:42:15.880364
51380,0,36,0,0,8,44,2022-05-12 22:42:17.102027
51381,0,0,1,0,9661,9662,2022-05-12 22:42:19.815655
51383,0,0,0,0,0,0,2022-05-12 22:42:21.019008
51385,34,0,3,15,91,143,2022-05-12 22:42:22.546426
51390,0,0,0,0,0,0,2022-05-12 22:42:24.636864
51407,39,464,12,11,275,801,2022-05-12 22:42:53.002401
51410,0,0,0,0,0,0,2022-05-12 22:42:54.971364
51412,0,0,0,0,133,133,2022-05-12 22:42:56.252614
51413,0,0,0,0,68,68,2022-05-12 22:42:57.208347
51414,0,0,0,0,92,92,2022-05-12 22:42:58.2743
51417,1,0,2,0,14954,14957,2022-05-12 22:42:59.768715
51424,13,119,5,9,58,204,2022-05-12 22:43:01.077187
51427,6,182,2,2,23,215,2022-05-12 22:43:04.375538
51428,5,106,1,1,15,128,2022-05-12 22:43:05.437828
51429,8,110,1,2,19,140,2022-05-12 22:43:06.49731
51436,0,0,0,0,0,0,2022-05-12 22:43:09.363966
51439,35,87,7,20,129,278,2022-05-12 22:43:11.177829
51440,1,0,0,0,12525,12526,2022-05-12 22:43:11.630952
51446,2,33,1,1,6,43,2022-05-12 22:43:13.321083
51449,3,95,4,6,18,126,2022-05-12 22:43:15.198581
51450,4,82,3,2,14,105,2022-05-12 22:43:16.218532
51451,4,107,3,2,21,137,2022-05-12 22:43:17.839349
51510,0,0,0,0,0,0,2022-05-12 22:43:50.752195
51453,2,48,1,1,7,59,2022-05-12 22:43:19.90978
51459,0,7,1,8,16,32,2022-05-12 22:43:22.725322
51462,0,0,1,0,775,776,2022-05-12 22:43:24.650628
51469,6,0,2,10,13,31,2022-05-12 22:43:27.637565
51474,0,0,0,0,0,0,2022-05-12 22:43:29.40063
51476,7,101,2,2,16,128,2022-05-12 22:43:29.838131
51496,6,0,2,9,32,49,2022-05-12 22:43:34.000168
51498,0,0,0,0,30924,30924,2022-05-12 22:43:37.245182
51499,0,0,0,0,0,0,2022-05-12 22:43:38.020059
51501,2,44,1,2,8,57,2022-05-12 22:43:42.398162
51503,0,0,0,0,0,0,2022-05-12 22:43:45.819947
51505,0,0,0,0,0,0,2022-05-12 22:43:47.944577
51511,5,45,1,1,10,62,2022-05-12 22:43:51.85601
51513,3,79,3,1,17,103,2022-05-12 22:43:53.932744
51515,7,112,2,1,35,157,2022-05-12 22:43:56.699486
51516,6,121,2,2,28,159,2022-05-12 22:43:58.432034
51517,0,0,0,0,0,0,2022-05-12 22:43:59.250789
51519,0,0,0,0,0,0,2022-05-12 22:44:00.68401
51520,70,0,7,31,118,226,2022-05-12 22:44:02.027761
51521,0,0,0,0,0,0,2022-05-12 22:44:03.6637
51522,0,0,0,0,0,0,2022-05-12 22:44:04.457914
51523,0,0,0,0,0,0,2022-05-12 22:44:05.273014
51526,0,0,0,0,0,0,2022-05-12 22:44:06.343006
51531,1,40,1,3,9,54,2022-05-12 22:44:07.875989
51532,18,0,0,13,39,70,2022-05-12 22:44:09.751735
51533,2,2,0,1,29407,29412,2022-05-12 22:44:09.92361
51535,1,1,4,1,124948,124955,2022-05-12 22:44:10.567192
51546,0,0,0,0,0,0,2022-05-12 22:44:13.635924
51549,0,0,0,0,0,0,2022-05-12 22:44:15.107258
51557,0,0,0,0,0,0,2022-05-12 22:44:17.138146
51561,10,150,5,2,107,274,2022-05-12 22:44:19.034613
51562,0,0,0,1,4505,4506,2022-05-12 22:44:21.392657
51564,9,135,2,1,17,164,2022-05-12 22:44:22.001952
51572,0,0,0,0,0,0,2022-05-12 22:44:25.693998
51575,0,0,0,0,0,0,2022-05-12 22:44:26.807629
51580,3,77,1,2,12,95,2022-05-12 22:44:28.292527
51585,0,0,0,0,1946,1946,2022-05-12 22:44:30.507802
51586,0,0,0,0,610,610,2022-05-12 22:44:30.726626
51598,2,8,4,3,12,29,2022-05-12 22:44:32.872146
51601,1,2,1,7,10,21,2022-05-12 22:44:34.188651
51608,12,711,7,5,171,906,2022-05-12 22:44:37.903949
51614,0,0,0,0,843,843,2022-05-12 22:44:38.252425
51618,0,0,0,0,0,0,2022-05-12 22:44:41.386954
51623,64,0,9,16,38,127,2022-05-12 22:44:41.824455
51638,50,1145,4,5,250,1454,2022-05-12 22:44:43.029706
51648,0,0,0,0,1018,1018,2022-05-12 22:44:46.058076
51649,0,0,0,0,0,0,2022-05-12 22:44:47.138073
51652,0,0,0,0,0,0,2022-05-12 22:44:47.466163
51655,0,0,0,0,0,0,2022-05-12 22:44:48.391099
51673,0,0,0,0,8682,8682,2022-05-12 22:44:50.677694
51686,0,5,0,6,11,22,2022-05-12 22:44:53.378139
51700,0,0,0,0,0,0,2022-05-12 22:44:55.540146
51706,0,0,0,0,1089,1089,2022-05-12 22:44:57.824388
51710,103,2128,13,11,436,2691,2022-05-12 22:44:58.027438
51725,0,0,0,0,0,0,2022-05-12 22:44:59.830917
51727,0,0,0,0,0,0,2022-05-12 22:45:01.513229
51730,0,0,0,0,0,0,2022-05-12 22:45:02.983807
51735,62,0,7,16,108,193,2022-05-12 22:45:04.573563
51738,46,0,17,8,52,123,2022-05-12 22:45:04.776596
51764,0,0,0,0,0,0,2022-05-12 22:45:07.159538
51781,0,0,0,0,0,0,2022-05-12 22:45:08.23025
